ID,Флаг дозвона,Флаг продажи,Расходы,PV,NPV
0,1,1,1485,1226,-259
1,1,1,243,1309,1066
2,1,0,3,0,-3
3,1,1,189,1463,1274
4,1,0,22,0,-22
5,1,0,53,0,-53
6,1,1,261,1245,984
7,0,0,24,0,-24
8,1,1,195,1323,1128
9,0,0,42,0,-42
10,0,0,21,0,-21
11,0,0,90,0,-90
12,0,0,6,0,-6
13,1,0,22,0,-22
14,0,0,15,0,-15
15,1,1,153,1655,1502
16,1,1,73,1343,1270
17,0,0,15,0,-15
18,1,0,77,0,-77
19,1,1,2181,1440,-741
20,1,0,71,0,-71
21,0,0,41,0,-41
22,1,0,8,0,-8
23,1,1,1062,3898,2836
24,1,1,217,3220,3003
25,1,1,118,4414,4296
26,1,0,1,0,-1
27,1,0,16,0,-16
28,1,1,967,1242,275
29,0,0,28,0,-28
30,0,0,72,0,-72
31,0,0,15,0,-15
32,1,1,2406,1325,-1081
33,0,0,36,0,-36
34,1,0,11,0,-11
35,0,0,10,0,-10
36,0,0,58,0,-58
37,1,1,1324,1340,16
38,1,0,84,0,-84
39,0,0,29,0,-29
40,1,1,348,1444,1096
41,1,0,77,0,-77
42,0,0,8,0,-8
43,1,0,36,0,-36
44,1,0,12,0,-12
45,1,0,27,0,-27
46,1,1,59,1302,1243
47,0,0,27,0,-27
48,1,1,713,1895,1182
49,1,1,114,2085,1971
50,1,1,979,1275,296
51,0,0,20,0,-20
52,0,0,35,0,-35
53,0,0,66,0,-66
54,0,0,203,0,-203
55,1,1,527,1984,1457
56,1,1,335,1254,919
57,0,0,36,0,-36
58,0,0,100,0,-100
59,0,0,6,0,-6
60,1,0,37,0,-37
61,1,1,120,1598,1478
62,1,0,41,0,-41
63,0,0,75,0,-75
64,1,1,245,1233,988
65,1,1,931,2393,1462
66,1,1,333,2063,1730
67,1,1,409,3019,2610
68,1,1,1179,1358,179
69,0,0,39,0,-39
70,0,0,23,0,-23
71,1,0,94,0,-94
72,1,1,667,1446,779
73,0,0,51,0,-51
74,1,1,300,3047,2747
75,1,1,20,2468,2448
76,1,1,72,2239,2167
77,0,0,41,0,-41
78,1,1,92,1304,1212
79,0,0,16,0,-16
80,1,1,18,1249,1231
81,1,1,114,1201,1087
82,1,0,0,0,0
83,0,0,21,0,-21
84,1,1,504,2416,1912
85,1,1,759,2036,1277
86,0,0,152,0,-152
87,1,1,398,1441,1043
88,0,0,32,0,-32
89,1,1,581,1980,1399
90,1,0,28,0,-28
91,1,1,66,1211,1145
92,0,0,35,0,-35
93,0,0,173,0,-173
94,1,0,12,0,-12
95,0,0,1,0,-1
96,1,1,637,1687,1050
97,0,0,32,0,-32
98,1,0,32,0,-32
99,1,0,30,0,-30
100,1,0,31,0,-31
101,1,1,304,1447,1143
102,1,1,1253,1606,353
103,0,0,32,0,-32
104,0,0,60,0,-60
105,1,0,58,0,-58
106,0,0,101,0,-101
107,1,1,771,1494,723
108,1,0,126,0,-126
109,1,0,53,0,-53
110,1,0,30,0,-30
111,0,0,133,0,-133
112,0,0,60,0,-60
113,0,0,116,0,-116
114,1,0,83,0,-83
115,1,0,38,0,-38
116,0,0,17,0,-17
117,0,0,23,0,-23
118,1,1,536,1287,751
119,1,0,22,0,-22
120,1,1,145,1252,1107
121,1,1,135,1464,1329
122,1,0,18,0,-18
123,0,0,79,0,-79
124,1,0,90,0,-90
125,1,1,795,1215,420
126,1,1,172,1218,1046
127,1,0,4,0,-4
128,1,0,6,0,-6
129,1,1,149,1218,1069
130,0,0,11,0,-11
131,1,0,18,0,-18
132,1,1,275,1742,1467
133,1,1,203,1393,1190
134,1,1,325,1338,1013
135,0,0,16,0,-16
136,1,1,324,1490,1166
137,1,0,8,0,-8
138,1,0,66,0,-66
139,1,0,203,0,-203
140,0,0,49,0,-49
141,1,1,726,1801,1075
142,1,1,657,1677,1020
143,1,1,544,1261,717
144,1,1,98,1346,1248
145,1,1,34,1357,1323
146,1,1,278,1793,1515
147,0,0,61,0,-61
148,0,0,52,0,-52
149,1,0,112,0,-112
150,0,0,5,0,-5
151,1,0,1,0,-1
152,0,0,14,0,-14
153,0,0,38,0,-38
154,1,1,139,1377,1238
155,1,1,117,1210,1093
156,0,0,56,0,-56
157,1,1,2266,1667,-599
158,1,1,569,1280,711
159,0,0,85,0,-85
160,1,1,130,1270,1140
161,0,0,26,0,-26
162,0,0,39,0,-39
163,1,0,34,0,-34
164,0,0,32,0,-32
165,0,0,8,0,-8
166,1,0,43,0,-43
167,1,1,92,1479,1387
168,0,0,138,0,-138
169,1,0,16,0,-16
170,1,1,140,1639,1499
171,0,0,119,0,-119
172,1,0,44,0,-44
173,1,1,185,1353,1168
174,1,1,276,1761,1485
175,1,1,418,1460,1042
176,0,0,35,0,-35
177,0,0,35,0,-35
178,1,1,136,1234,1098
179,1,1,604,1223,619
180,0,0,144,0,-144
181,1,1,151,2087,1936
182,0,0,96,0,-96
183,1,1,39,1681,1642
184,1,0,53,0,-53
185,1,0,21,0,-21
186,0,0,34,0,-34
187,1,1,454,1559,1105
188,1,1,135,1217,1082
189,0,0,152,0,-152
190,1,0,7,0,-7
191,1,1,839,1246,407
192,0,0,41,0,-41
193,1,0,77,0,-77
194,0,0,39,0,-39
195,1,0,14,0,-14
196,1,0,3,0,-3
197,1,1,410,2127,1717
198,1,0,97,0,-97
199,1,0,24,0,-24
200,0,0,2,0,-2
201,1,1,379,1909,1530
202,0,0,17,0,-17
203,0,0,121,0,-121
204,0,0,0,0,0
205,0,0,42,0,-42
206,1,1,1321,1341,20
207,1,0,7,0,-7
208,0,0,72,0,-72
209,1,1,499,1442,943
210,1,1,676,1582,906
211,1,0,21,0,-21
212,0,0,5,0,-5
213,0,0,231,0,-231
214,1,1,340,1221,881
215,1,0,13,0,-13
216,0,0,30,0,-30
217,0,0,72,0,-72
218,0,0,64,0,-64
219,1,0,153,0,-153
220,1,0,3,0,-3
221,1,0,18,0,-18
222,0,0,38,0,-38
223,1,0,25,0,-25
224,0,0,13,0,-13
225,1,0,37,0,-37
226,1,1,623,1473,850
227,1,0,14,0,-14
228,1,1,1011,1403,392
229,1,0,55,0,-55
230,1,1,923,1301,378
231,0,0,68,0,-68
232,1,1,779,1768,989
233,1,1,89,1211,1122
234,0,0,47,0,-47
235,1,1,252,1363,1111
236,1,0,40,0,-40
237,1,1,569,1701,1132
238,1,1,152,1799,1647
239,1,1,10,1321,1311
240,0,0,84,0,-84
241,0,0,25,0,-25
242,1,1,741,1361,620
243,0,0,9,0,-9
244,1,0,90,0,-90
245,1,0,79,0,-79
246,1,0,111,0,-111
247,1,0,129,0,-129
248,1,1,74,1935,1861
249,1,1,975,1551,576
250,1,1,22,1215,1193
251,0,0,19,0,-19
252,1,1,1784,1483,-301
253,1,0,21,0,-21
254,1,0,131,0,-131
255,1,1,1157,1263,106
256,1,1,1601,1535,-66
257,0,0,87,0,-87
258,1,0,33,0,-33
259,1,0,84,0,-84
260,0,0,38,0,-38
261,0,0,60,0,-60
262,1,1,194,1469,1275
263,1,0,5,0,-5
264,0,0,19,0,-19
265,1,0,28,0,-28
266,0,0,192,0,-192
267,1,0,31,0,-31
268,1,1,564,1507,943
269,0,0,18,0,-18
270,1,0,14,0,-14
271,1,1,427,1437,1010
272,1,1,845,1297,452
273,1,1,380,1414,1034
274,0,0,2,0,-2
275,0,0,63,0,-63
276,1,1,240,1866,1626
277,1,1,263,1226,963
278,1,1,488,1481,993
279,1,0,24,0,-24
280,1,1,45,1388,1343
281,0,0,101,0,-101
282,1,1,613,1305,692
283,1,1,403,3976,3573
284,1,1,72,1394,1322
285,1,0,58,0,-58
286,1,0,6,0,-6
287,0,0,36,0,-36
288,1,0,105,0,-105
289,0,0,18,0,-18
290,0,0,51,0,-51
291,1,1,321,1388,1067
292,1,1,292,1422,1130
293,0,0,130,0,-130
294,1,0,14,0,-14
295,1,1,307,1502,1195
296,1,1,482,1218,736
297,1,0,9,0,-9
298,1,1,62,1302,1240
299,1,0,48,0,-48
300,0,0,209,0,-209
301,1,1,176,1292,1116
302,0,0,27,0,-27
303,1,1,661,1588,927
304,0,0,42,0,-42
305,1,0,24,0,-24
306,1,1,401,1872,1471
307,0,0,81,0,-81
308,0,0,13,0,-13
309,1,1,72,1202,1130
310,1,1,233,1940,1707
311,1,1,263,1406,1143
312,1,0,10,0,-10
313,1,0,171,0,-171
314,0,0,4,0,-4
315,1,1,1043,1503,460
316,0,0,121,0,-121
317,1,1,468,1806,1338
318,1,0,10,0,-10
319,1,1,516,1998,1482
320,0,0,138,0,-138
321,0,0,92,0,-92
322,1,1,1656,1314,-342
323,1,0,36,0,-36
324,1,0,147,0,-147
325,0,0,5,0,-5
326,1,0,55,0,-55
327,0,0,0,0,0
328,1,1,58,1270,1212
329,1,0,30,0,-30
330,1,0,3,0,-3
331,0,0,37,0,-37
332,0,0,112,0,-112
333,1,1,82,1406,1324
334,0,0,60,0,-60
335,1,1,36,1525,1489
336,1,1,1068,1206,138
337,1,0,18,0,-18
338,1,1,104,1200,1096
339,1,0,81,0,-81
340,1,1,311,1764,1453
341,1,1,2389,1955,-434
342,1,1,1109,2520,1411
343,0,0,51,0,-51
344,1,1,1452,1240,-212
345,1,0,44,0,-44
346,1,1,283,1609,1326
347,0,0,6,0,-6
348,1,0,18,0,-18
349,1,1,119,1538,1419
350,0,0,48,0,-48
351,1,1,231,1314,1083
352,1,1,752,1224,472
353,0,0,141,0,-141
354,1,0,144,0,-144
355,0,0,90,0,-90
356,0,0,3,0,-3
357,0,0,143,0,-143
358,0,0,59,0,-59
359,1,0,274,0,-274
360,1,0,11,0,-11
361,1,1,386,1246,860
362,0,0,23,0,-23
363,1,0,21,0,-21
364,0,0,29,0,-29
365,1,0,4,0,-4
366,1,0,17,0,-17
367,0,0,7,0,-7
368,1,1,162,1900,1738
369,1,0,41,0,-41
370,0,0,33,0,-33
371,0,0,63,0,-63
372,1,1,152,1202,1050
373,0,0,106,0,-106
374,1,1,376,1308,932
375,0,0,105,0,-105
376,0,0,6,0,-6
377,0,0,3,0,-3
378,1,0,125,0,-125
379,1,1,848,1425,577
380,0,0,123,0,-123
381,1,0,26,0,-26
382,1,1,174,1488,1314
383,1,0,13,0,-13
384,0,0,12,0,-12
385,0,0,27,0,-27
386,1,0,15,0,-15
387,1,0,5,0,-5
388,0,0,51,0,-51
389,1,1,156,1521,1365
390,0,0,144,0,-144
391,1,1,47,1298,1251
392,0,0,27,0,-27
393,0,0,27,0,-27
394,1,1,62,1845,1783
395,1,1,1088,1366,278
396,1,0,6,0,-6
397,0,0,9,0,-9
398,1,1,642,1598,956
399,0,0,165,0,-165
400,0,0,25,0,-25
401,0,0,25,0,-25
402,1,0,14,0,-14
403,0,0,32,0,-32
404,1,1,512,1252,740
405,0,0,41,0,-41
406,1,1,326,1253,927
407,0,0,72,0,-72
408,1,0,120,0,-120
409,1,1,301,1367,1066
410,0,0,7,0,-7
411,1,1,615,1331,716
412,0,0,24,0,-24
413,1,0,69,0,-69
414,0,0,57,0,-57
415,1,0,119,0,-119
416,0,0,74,0,-74
417,0,0,38,0,-38
418,0,0,17,0,-17
419,1,1,206,3554,3348
420,1,0,104,0,-104
421,1,0,86,0,-86
422,1,0,75,0,-75
423,1,0,118,0,-118
424,1,0,12,0,-12
425,1,0,79,0,-79
426,1,0,176,0,-176
427,1,0,26,0,-26
428,1,1,669,1690,1021
429,1,0,21,0,-21
430,1,0,99,0,-99
431,1,0,32,0,-32
432,0,0,30,0,-30
433,0,0,11,0,-11
434,0,0,25,0,-25
435,1,1,388,2963,2575
436,1,1,527,1460,933
437,1,1,140,1411,1271
438,1,0,3,0,-3
439,0,0,40,0,-40
440,1,0,13,0,-13
441,0,0,98,0,-98
442,1,1,204,1489,1285
443,1,1,741,1311,570
444,1,0,204,0,-204
445,0,0,174,0,-174
446,0,0,79,0,-79
447,0,0,13,0,-13
448,1,1,523,1236,713
449,0,0,69,0,-69
450,0,0,56,0,-56
451,1,1,583,1312,729
452,1,0,68,0,-68
453,1,0,99,0,-99
454,1,1,373,1218,845
455,0,0,66,0,-66
456,1,1,334,1841,1507
457,1,1,288,1359,1071
458,0,0,1,0,-1
459,1,1,225,2640,2415
460,1,1,443,1381,938
461,0,0,26,0,-26
462,1,1,80,1489,1409
463,1,1,117,2882,2765
464,1,1,220,1534,1314
465,0,0,12,0,-12
466,1,0,73,0,-73
467,0,0,59,0,-59
468,1,0,114,0,-114
469,1,0,15,0,-15
470,1,0,46,0,-46
471,1,1,701,1395,694
472,0,0,50,0,-50
473,1,0,18,0,-18
474,0,0,25,0,-25
475,0,0,9,0,-9
476,0,0,77,0,-77
477,1,1,557,1229,672
478,0,0,65,0,-65
479,0,0,247,0,-247
480,1,1,30,1546,1516
481,0,0,1,0,-1
482,0,0,12,0,-12
483,1,0,53,0,-53
484,0,0,48,0,-48
485,1,0,45,0,-45
486,1,1,255,1570,1315
487,0,0,51,0,-51
488,0,0,71,0,-71
489,0,0,16,0,-16
490,0,0,42,0,-42
491,1,0,12,0,-12
492,0,0,28,0,-28
493,0,0,15,0,-15
494,0,0,63,0,-63
495,0,0,70,0,-70
496,0,0,0,0,0
497,0,0,12,0,-12
498,0,0,5,0,-5
499,0,0,115,0,-115
500,1,0,44,0,-44
501,0,0,39,0,-39
502,0,0,8,0,-8
503,0,0,32,0,-32
504,0,0,16,0,-16
505,0,0,9,0,-9
506,1,0,13,0,-13
507,1,0,55,0,-55
508,1,1,770,1354,584
509,0,0,77,0,-77
510,0,0,136,0,-136
511,1,1,188,2152,1964
512,1,0,8,0,-8
513,0,0,27,0,-27
514,0,0,17,0,-17
515,0,0,22,0,-22
516,0,0,40,0,-40
517,1,1,354,1666,1312
518,1,0,44,0,-44
519,1,1,816,1377,561
520,0,0,62,0,-62
521,1,0,46,0,-46
522,0,0,37,0,-37
523,1,0,7,0,-7
524,1,1,537,1513,976
525,1,0,118,0,-118
526,0,0,15,0,-15
527,1,0,38,0,-38
528,1,0,22,0,-22
529,0,0,6,0,-6
530,0,0,27,0,-27
531,1,1,1576,1387,-189
532,0,0,215,0,-215
533,0,0,33,0,-33
534,1,1,752,2228,1476
535,1,1,467,1752,1285
536,1,0,40,0,-40
537,0,0,13,0,-13
538,0,0,138,0,-138
539,1,1,117,1834,1717
540,1,1,124,1520,1396
541,0,0,11,0,-11
542,1,0,0,0,0
543,1,0,95,0,-95
544,1,0,21,0,-21
545,1,1,79,1291,1212
546,0,0,28,0,-28
547,0,0,199,0,-199
548,1,0,8,0,-8
549,1,0,4,0,-4
550,1,1,423,1219,796
551,0,0,132,0,-132
552,1,1,571,1234,663
553,1,0,18,0,-18
554,1,1,1207,2368,1161
555,0,0,29,0,-29
556,1,1,1483,1870,387
557,0,0,28,0,-28
558,0,0,102,0,-102
559,1,1,66,1302,1236
560,1,0,77,0,-77
561,1,1,79,1776,1697
562,1,1,260,7617,7357
563,1,0,60,0,-60
564,1,1,1261,1222,-39
565,1,0,97,0,-97
566,0,0,50,0,-50
567,0,0,12,0,-12
568,1,0,28,0,-28
569,1,0,6,0,-6
570,0,0,203,0,-203
571,1,0,129,0,-129
572,0,0,1,0,-1
573,1,0,58,0,-58
574,1,0,77,0,-77
575,1,1,301,1413,1112
576,1,1,380,1229,849
577,0,0,94,0,-94
578,1,1,231,1323,1092
579,1,1,195,1418,1223
580,0,0,210,0,-210
581,0,0,32,0,-32
582,0,0,202,0,-202
583,1,1,37,2916,2879
584,1,0,94,0,-94
585,1,1,172,1220,1048
586,1,1,89,1620,1531
587,1,0,6,0,-6
588,1,1,537,1266,729
589,0,0,115,0,-115
590,0,0,58,0,-58
591,1,1,197,1227,1030
592,1,0,28,0,-28
593,1,1,318,1938,1620
594,1,1,212,1213,1001
595,1,0,35,0,-35
596,0,0,67,0,-67
597,1,0,16,0,-16
598,0,0,46,0,-46
599,0,0,21,0,-21
600,0,0,18,0,-18
601,1,0,17,0,-17
602,0,0,17,0,-17
603,1,0,5,0,-5
604,0,0,4,0,-4
605,0,0,75,0,-75
606,1,0,65,0,-65
607,0,0,6,0,-6
608,0,0,115,0,-115
609,0,0,7,0,-7
610,1,1,334,1252,918
611,0,0,65,0,-65
612,1,1,168,1230,1062
613,1,1,1425,1336,-89
614,0,0,49,0,-49
615,1,0,14,0,-14
616,1,1,840,1280,440
617,1,0,63,0,-63
618,0,0,33,0,-33
619,1,0,2,0,-2
620,0,0,68,0,-68
621,0,0,61,0,-61
622,0,0,7,0,-7
623,0,0,127,0,-127
624,0,0,9,0,-9
625,0,0,70,0,-70
626,0,0,12,0,-12
627,0,0,12,0,-12
628,0,0,12,0,-12
629,0,0,103,0,-103
630,0,0,86,0,-86
631,0,0,51,0,-51
632,1,0,18,0,-18
633,1,1,951,1475,524
634,0,0,52,0,-52
635,1,0,16,0,-16
636,1,0,22,0,-22
637,0,0,11,0,-11
638,0,0,81,0,-81
639,0,0,18,0,-18
640,1,1,861,1313,452
641,1,0,40,0,-40
642,0,0,67,0,-67
643,1,1,2096,1367,-729
644,0,0,6,0,-6
645,0,0,5,0,-5
646,1,1,569,1271,702
647,0,0,4,0,-4
648,1,1,78,1515,1437
649,1,1,587,1231,644
650,0,0,76,0,-76
651,0,0,0,0,0
652,0,0,70,0,-70
653,1,0,69,0,-69
654,0,0,27,0,-27
655,1,0,17,0,-17
656,1,1,318,1237,919
657,1,1,206,1334,1128
658,0,0,2,0,-2
659,1,1,41,2330,2289
660,1,0,11,0,-11
661,1,0,41,0,-41
662,1,0,139,0,-139
663,0,0,16,0,-16
664,1,1,649,1336,687
665,1,0,55,0,-55
666,0,0,28,0,-28
667,1,1,203,1603,1400
668,1,1,169,1200,1031
669,1,0,8,0,-8
670,1,1,788,1401,613
671,1,1,131,1875,1744
672,0,0,8,0,-8
673,1,1,884,2021,1137
674,0,0,57,0,-57
675,1,0,22,0,-22
676,1,1,2524,1400,-1124
677,1,0,53,0,-53
678,0,0,38,0,-38
679,0,0,2,0,-2
680,1,1,236,1769,1533
681,1,1,76,1328,1252
682,1,0,38,0,-38
683,0,0,61,0,-61
684,1,0,9,0,-9
685,1,1,397,1531,1134
686,0,0,5,0,-5
687,1,1,1536,1362,-174
688,1,0,106,0,-106
689,1,0,11,0,-11
690,1,1,125,1206,1081
691,0,0,7,0,-7
692,0,0,212,0,-212
693,1,0,110,0,-110
694,1,0,51,0,-51
695,0,0,82,0,-82
696,1,1,172,1200,1028
697,1,0,82,0,-82
698,0,0,47,0,-47
699,1,0,23,0,-23
700,0,0,43,0,-43
701,1,0,126,0,-126
702,1,0,12,0,-12
703,1,0,65,0,-65
704,0,0,60,0,-60
705,0,0,104,0,-104
706,0,0,46,0,-46
707,1,0,31,0,-31
708,1,1,943,1336,393
709,1,1,319,1277,958
710,0,0,65,0,-65
711,1,1,426,1421,995
712,1,0,45,0,-45
713,1,0,87,0,-87
714,1,0,4,0,-4
715,1,1,1375,1286,-89
716,1,1,330,1226,896
717,1,0,58,0,-58
718,0,0,66,0,-66
719,1,1,262,1833,1571
720,0,0,38,0,-38
721,1,1,150,1431,1281
722,0,0,47,0,-47
723,0,0,45,0,-45
724,0,0,35,0,-35
725,0,0,112,0,-112
726,0,0,38,0,-38
727,1,0,68,0,-68
728,0,0,40,0,-40
729,1,1,24,1555,1531
730,0,0,5,0,-5
731,1,1,854,2064,1210
732,1,1,326,1442,1116
733,1,1,527,2127,1600
734,0,0,18,0,-18
735,0,0,45,0,-45
736,0,0,9,0,-9
737,1,0,71,0,-71
738,1,0,79,0,-79
739,0,0,7,0,-7
740,1,1,224,1264,1040
741,0,0,4,0,-4
742,0,0,5,0,-5
743,1,1,563,1230,667
744,1,1,18,1464,1446
745,1,1,515,1491,976
746,1,1,312,1249,937
747,1,0,64,0,-64
748,0,0,6,0,-6
749,0,0,67,0,-67
750,0,0,3,0,-3
751,1,0,91,0,-91
752,0,0,194,0,-194
753,1,0,34,0,-34
754,1,1,302,1608,1306
755,0,0,74,0,-74
756,1,0,12,0,-12
757,0,0,80,0,-80
758,0,0,100,0,-100
759,0,0,26,0,-26
760,1,1,265,1822,1557
761,1,1,117,1373,1256
762,0,0,49,0,-49
763,0,0,22,0,-22
764,1,1,620,1981,1361
765,0,0,30,0,-30
766,1,0,71,0,-71
767,0,0,7,0,-7
768,1,0,50,0,-50
769,1,0,48,0,-48
770,0,0,26,0,-26
771,1,0,30,0,-30
772,1,0,73,0,-73
773,1,0,50,0,-50
774,1,0,0,0,0
775,1,0,28,0,-28
776,1,1,2114,1216,-898
777,1,0,58,0,-58
778,0,0,114,0,-114
779,1,0,36,0,-36
780,0,0,32,0,-32
781,0,0,227,0,-227
782,0,0,10,0,-10
783,0,0,60,0,-60
784,0,0,12,0,-12
785,0,0,4,0,-4
786,1,1,1074,1485,411
787,1,1,1177,1285,108
788,0,0,173,0,-173
789,1,0,63,0,-63
790,1,0,32,0,-32
791,1,0,23,0,-23
792,1,1,398,1412,1014
793,1,1,1026,1617,591
794,0,0,10,0,-10
795,0,0,14,0,-14
796,1,1,87,1214,1127
797,1,0,62,0,-62
798,1,1,1091,1630,539
799,0,0,52,0,-52
800,1,0,3,0,-3
801,1,0,6,0,-6
802,1,0,200,0,-200
803,1,0,25,0,-25
804,1,0,11,0,-11
805,0,0,16,0,-16
806,1,0,11,0,-11
807,0,0,21,0,-21
808,0,0,65,0,-65
809,1,1,813,1359,546
810,0,0,17,0,-17
811,1,0,17,0,-17
812,0,0,5,0,-5
813,1,1,1206,1527,321
814,1,0,13,0,-13
815,1,0,14,0,-14
816,1,0,84,0,-84
817,1,1,701,1455,754
818,1,1,817,1242,425
819,1,0,137,0,-137
820,1,0,179,0,-179
821,0,0,144,0,-144
822,1,1,627,1201,574
823,1,0,61,0,-61
824,0,0,17,0,-17
825,0,0,17,0,-17
826,1,0,62,0,-62
827,0,0,47,0,-47
828,0,0,51,0,-51
829,1,1,637,1596,959
830,1,1,740,1367,627
831,0,0,36,0,-36
832,0,0,51,0,-51
833,1,0,85,0,-85
834,0,0,29,0,-29
835,1,0,163,0,-163
836,1,0,21,0,-21
837,1,0,23,0,-23
838,0,0,44,0,-44
839,1,0,2,0,-2
840,1,1,216,1430,1214
841,0,0,10,0,-10
842,1,1,1288,1322,34
843,1,1,57,1312,1255
844,1,1,695,5205,4510
845,0,0,23,0,-23
846,0,0,14,0,-14
847,0,0,168,0,-168
848,1,1,306,1716,1410
849,1,1,836,1568,732
850,1,0,154,0,-154
851,0,0,13,0,-13
852,0,0,29,0,-29
853,0,0,68,0,-68
854,0,0,70,0,-70
855,0,0,88,0,-88
856,0,0,7,0,-7
857,1,0,14,0,-14
858,0,0,22,0,-22
859,1,1,304,1410,1106
860,1,1,339,1607,1268
861,1,0,99,0,-99
862,1,0,38,0,-38
863,1,1,538,1445,907
864,1,1,398,1505,1107
865,1,1,228,1281,1053
866,0,0,176,0,-176
867,0,0,64,0,-64
868,0,0,11,0,-11
869,0,0,11,0,-11
870,1,1,469,1220,751
871,1,0,43,0,-43
872,1,0,41,0,-41
873,1,0,284,0,-284
874,1,0,6,0,-6
875,0,0,19,0,-19
876,1,0,59,0,-59
877,1,0,43,0,-43
878,0,0,12,0,-12
879,1,1,41,1229,1188
880,1,1,205,1317,1112
881,1,0,0,0,0
882,0,0,3,0,-3
883,1,1,194,1523,1329
884,0,0,140,0,-140
885,1,0,31,0,-31
886,1,0,14,0,-14
887,0,0,35,0,-35
888,0,0,28,0,-28
889,0,0,3,0,-3
890,1,1,252,1255,1003
891,1,0,3,0,-3
892,0,0,4,0,-4
893,1,1,82,2957,2875
894,1,0,30,0,-30
895,1,0,135,0,-135
896,1,1,985,1227,242
897,1,1,350,1306,956
898,0,0,4,0,-4
899,0,0,39,0,-39
900,0,0,23,0,-23
901,1,1,237,3092,2855
902,1,0,24,0,-24
903,1,1,801,1322,521
904,0,0,92,0,-92
905,1,0,3,0,-3
906,1,1,409,1232,823
907,1,1,285,1512,1227
908,1,0,2,0,-2
909,1,0,19,0,-19
910,1,0,58,0,-58
911,1,0,118,0,-118
912,1,0,38,0,-38
913,0,0,131,0,-131
914,0,0,17,0,-17
915,0,0,22,0,-22
916,0,0,32,0,-32
917,0,0,118,0,-118
918,1,1,753,1383,630
919,1,1,106,2031,1925
920,1,1,312,1381,1069
921,1,1,415,1404,989
922,0,0,95,0,-95
923,0,0,27,0,-27
924,0,0,22,0,-22
925,1,1,1367,1328,-39
926,1,0,108,0,-108
927,0,0,16,0,-16
928,0,0,7,0,-7
929,1,1,269,1248,979
930,1,1,279,1279,1000
931,1,0,139,0,-139
932,0,0,30,0,-30
933,1,1,136,1829,1693
934,0,0,243,0,-243
935,1,1,108,1575,1467
936,1,1,426,1433,1007
937,0,0,37,0,-37
938,0,0,35,0,-35
939,1,0,1,0,-1
940,1,0,138,0,-138
941,1,1,301,1643,1342
942,1,1,297,1225,928
943,0,0,17,0,-17
944,0,0,69,0,-69
945,1,0,110,0,-110
946,1,1,170,1293,1123
947,1,1,883,1489,606
948,0,0,52,0,-52
949,0,0,4,0,-4
950,1,1,249,2473,2224
951,1,1,671,1586,915
952,1,0,13,0,-13
953,1,0,47,0,-47
954,1,1,622,1440,818
955,1,0,6,0,-6
956,1,1,177,1211,1034
957,1,1,23,1289,1266
958,1,1,545,1943,1398
959,1,1,257,1713,1456
960,1,0,8,0,-8
961,1,1,643,1239,596
962,0,0,49,0,-49
963,1,0,32,0,-32
964,1,1,147,1614,1467
965,1,1,690,1252,562
966,1,0,20,0,-20
967,1,1,658,2141,1483
968,0,0,64,0,-64
969,1,1,304,1488,1184
970,0,0,45,0,-45
971,1,0,23,0,-23
972,1,0,38,0,-38
973,1,0,12,0,-12
974,0,0,63,0,-63
975,1,1,382,1388,1006
976,0,0,40,0,-40
977,1,1,637,1662,1025
978,0,0,41,0,-41
979,1,0,88,0,-88
980,0,0,89,0,-89
981,0,0,21,0,-21
982,1,1,757,1307,550
983,1,0,58,0,-58
984,0,0,6,0,-6
985,1,1,134,1487,1353
986,1,1,148,1301,1153
987,0,0,20,0,-20
988,1,1,114,1412,1298
989,1,1,342,1712,1370
990,0,0,101,0,-101
991,1,0,38,0,-38
992,1,1,569,1211,642
993,0,0,56,0,-56
994,0,0,9,0,-9
995,1,1,938,1361,423
996,0,0,64,0,-64
997,1,0,20,0,-20
998,1,1,240,2224,1984
999,1,0,2,0,-2
1000,0,0,59,0,-59
1001,1,1,353,1278,925
1002,1,1,416,1393,977
1003,1,1,828,1536,708
1004,1,0,38,0,-38
1005,1,0,0,0,0
1006,0,0,120,0,-120
1007,1,0,2,0,-2
1008,0,0,39,0,-39
1009,1,0,7,0,-7
1010,1,1,355,1271,916
1011,1,1,778,1474,696
1012,0,0,16,0,-16
1013,0,0,27,0,-27
1014,1,1,586,1388,802
1015,1,0,20,0,-20
1016,1,0,16,0,-16
1017,0,0,2,0,-2
1018,1,1,463,1247,784
1019,1,1,110,1815,1705
1020,0,0,12,0,-12
1021,1,0,58,0,-58
1022,1,1,1099,1236,137
1023,0,0,9,0,-9
1024,0,0,62,0,-62
1025,0,0,34,0,-34
1026,0,0,6,0,-6
1027,0,0,315,0,-315
1028,1,1,486,1725,1239
1029,1,0,62,0,-62
1030,1,1,664,1243,579
1031,1,0,17,0,-17
1032,0,0,81,0,-81
1033,1,1,523,1778,1255
1034,0,0,13,0,-13
1035,0,0,48,0,-48
1036,1,0,4,0,-4
1037,1,0,5,0,-5
1038,1,1,185,1377,1192
1039,1,1,197,1447,1250
1040,0,0,22,0,-22
1041,0,0,42,0,-42
1042,1,0,105,0,-105
1043,1,0,96,0,-96
1044,1,0,26,0,-26
1045,0,0,14,0,-14
1046,1,0,53,0,-53
1047,1,1,558,2193,1635
1048,1,0,91,0,-91
1049,0,0,64,0,-64
1050,1,0,9,0,-9
1051,0,0,17,0,-17
1052,1,1,22,1362,1340
1053,1,0,88,0,-88
1054,0,0,17,0,-17
1055,0,0,12,0,-12
1056,0,0,56,0,-56
1057,1,0,75,0,-75
1058,0,0,82,0,-82
1059,0,0,49,0,-49
1060,0,0,69,0,-69
1061,1,0,38,0,-38
1062,0,0,69,0,-69
1063,0,0,86,0,-86
1064,1,0,34,0,-34
1065,1,0,25,0,-25
1066,1,1,284,1753,1469
1067,1,1,246,2025,1779
1068,1,1,23,1726,1703
1069,1,0,11,0,-11
1070,1,0,105,0,-105
1071,1,1,59,1868,1809
1072,1,0,90,0,-90
1073,1,0,20,0,-20
1074,1,0,1,0,-1
1075,1,1,296,1583,1287
1076,0,0,20,0,-20
1077,0,0,10,0,-10
1078,0,0,16,0,-16
1079,1,0,105,0,-105
1080,1,1,259,1352,1093
1081,1,0,72,0,-72
1082,0,0,41,0,-41
1083,0,0,88,0,-88
1084,1,0,25,0,-25
1085,0,0,131,0,-131
1086,1,1,611,2150,1539
1087,0,0,49,0,-49
1088,1,1,425,1651,1226
1089,0,0,13,0,-13
1090,0,0,13,0,-13
1091,1,0,2,0,-2
1092,0,0,0,0,0
1093,1,0,3,0,-3
1094,0,0,1,0,-1
1095,1,1,353,1475,1122
1096,1,0,129,0,-129
1097,1,0,14,0,-14
1098,0,0,45,0,-45
1099,0,0,7,0,-7
1100,1,0,10,0,-10
1101,0,0,31,0,-31
1102,1,1,152,1731,1579
1103,0,0,33,0,-33
1104,0,0,121,0,-121
1105,1,1,57,1445,1388
1106,1,0,26,0,-26
1107,1,1,1203,1728,525
1108,1,1,779,1462,683
1109,1,0,12,0,-12
1110,1,0,53,0,-53
1111,0,0,84,0,-84
1112,1,1,209,1425,1216
1113,1,1,587,1383,796
1114,1,0,27,0,-27
1115,0,0,61,0,-61
1116,1,0,28,0,-28
1117,1,1,823,3377,2554
1118,0,0,67,0,-67
1119,1,1,101,1311,1210
1120,1,1,72,1319,1247
1121,0,0,0,0,0
1122,1,1,2530,1326,-1204
1123,1,0,59,0,-59
1124,1,1,802,4953,4151
1125,0,0,104,0,-104
1126,1,0,141,0,-141
1127,0,0,205,0,-205
1128,0,0,38,0,-38
1129,1,1,111,1839,1728
1130,1,1,657,1979,1322
1131,1,0,28,0,-28
1132,1,0,10,0,-10
1133,1,0,39,0,-39
1134,1,1,118,1430,1312
1135,1,1,151,1317,1166
1136,0,0,0,0,0
1137,1,1,266,1209,943
1138,0,0,22,0,-22
1139,0,0,53,0,-53
1140,1,1,736,1613,877
1141,1,1,732,2882,2150
1142,1,0,34,0,-34
1143,1,0,58,0,-58
1144,1,0,82,0,-82
1145,1,1,556,1354,798
1146,1,1,184,1569,1385
1147,1,1,169,1203,1034
1148,1,1,580,1926,1346
1149,0,0,124,0,-124
1150,1,0,128,0,-128
1151,1,0,140,0,-140
1152,1,0,30,0,-30
1153,1,1,972,1416,444
1154,0,0,15,0,-15
1155,0,0,90,0,-90
1156,1,1,1264,4190,2926
1157,1,0,30,0,-30
1158,1,1,224,1674,1450
1159,0,0,3,0,-3
1160,1,0,71,0,-71
1161,1,1,487,1723,1236
1162,1,0,167,0,-167
1163,1,1,755,1262,507
1164,1,0,46,0,-46
1165,1,0,129,0,-129
1166,0,0,13,0,-13
1167,0,0,71,0,-71
1168,0,0,11,0,-11
1169,0,0,106,0,-106
1170,0,0,2,0,-2
1171,1,0,29,0,-29
1172,0,0,21,0,-21
1173,0,0,26,0,-26
1174,0,0,69,0,-69
1175,1,0,36,0,-36
1176,1,1,667,1840,1173
1177,1,1,3158,1267,-1891
1178,0,0,25,0,-25
1179,1,0,6,0,-6
1180,0,0,31,0,-31
1181,1,1,260,1582,1322
1182,0,0,69,0,-69
1183,0,0,114,0,-114
1184,0,0,25,0,-25
1185,1,1,101,1314,1213
1186,1,0,14,0,-14
1187,1,0,137,0,-137
1188,1,1,2074,1574,-500
1189,1,1,233,1221,988
1190,0,0,31,0,-31
1191,0,0,43,0,-43
1192,1,0,26,0,-26
1193,0,0,53,0,-53
1194,1,0,198,0,-198
1195,0,0,187,0,-187
1196,1,0,10,0,-10
1197,1,1,1142,1431,289
1198,1,0,20,0,-20
1199,1,0,110,0,-110
1200,0,0,35,0,-35
1201,1,0,22,0,-22
1202,0,0,13,0,-13
1203,0,0,78,0,-78
1204,1,0,10,0,-10
1205,1,0,16,0,-16
1206,1,0,61,0,-61
1207,1,1,549,1344,795
1208,1,0,5,0,-5
1209,0,0,2,0,-2
1210,0,0,7,0,-7
1211,0,0,12,0,-12
1212,1,0,79,0,-79
1213,1,0,40,0,-40
1214,0,0,41,0,-41
1215,1,0,12,0,-12
1216,0,0,44,0,-44
1217,0,0,21,0,-21
1218,0,0,4,0,-4
1219,0,0,39,0,-39
1220,1,0,28,0,-28
1221,0,0,26,0,-26
1222,1,1,204,1349,1145
1223,0,0,109,0,-109
1224,1,0,39,0,-39
1225,0,0,192,0,-192
1226,1,0,65,0,-65
1227,1,0,64,0,-64
1228,1,0,74,0,-74
1229,0,0,35,0,-35
1230,1,0,67,0,-67
1231,1,1,907,1539,632
1232,1,1,248,1552,1304
1233,0,0,57,0,-57
1234,1,1,1052,1502,450
1235,1,0,88,0,-88
1236,1,0,56,0,-56
1237,0,0,70,0,-70
1238,1,0,45,0,-45
1239,1,1,804,2041,1237
1240,0,0,38,0,-38
1241,0,0,129,0,-129
1242,0,0,88,0,-88
1243,1,1,380,1260,880
1244,0,0,13,0,-13
1245,1,0,63,0,-63
1246,1,0,5,0,-5
1247,0,0,67,0,-67
1248,0,0,8,0,-8
1249,0,0,1,0,-1
1250,0,0,22,0,-22
1251,0,0,36,0,-36
1252,1,1,84,2616,2532
1253,1,1,294,1853,1559
1254,0,0,25,0,-25
1255,1,1,207,1884,1677
1256,0,0,18,0,-18
1257,1,0,13,0,-13
1258,0,0,208,0,-208
1259,1,1,607,1401,794
1260,0,0,169,0,-169
1261,0,0,19,0,-19
1262,1,1,246,1260,1014
1263,0,0,75,0,-75
1264,0,0,31,0,-31
1265,0,0,5,0,-5
1266,1,1,80,1501,1421
1267,0,0,33,0,-33
1268,1,1,576,1273,697
1269,0,0,335,0,-335
1270,0,0,1,0,-1
1271,1,1,731,1407,676
1272,0,0,40,0,-40
1273,1,0,79,0,-79
1274,1,1,331,1353,1022
1275,1,1,493,1390,897
1276,1,0,27,0,-27
1277,0,0,93,0,-93
1278,0,0,47,0,-47
1279,1,1,259,1827,1568
1280,1,0,27,0,-27
1281,1,1,339,1432,1093
1282,1,0,21,0,-21
1283,0,0,14,0,-14
1284,1,0,30,0,-30
1285,1,0,12,0,-12
1286,0,0,87,0,-87
1287,0,0,44,0,-44
1288,1,0,11,0,-11
1289,1,0,92,0,-92
1290,1,1,1189,1410,221
1291,0,0,96,0,-96
1292,0,0,50,0,-50
1293,1,0,180,0,-180
1294,0,0,45,0,-45
1295,1,0,118,0,-118
1296,1,0,72,0,-72
1297,1,0,25,0,-25
1298,0,0,56,0,-56
1299,1,0,33,0,-33
1300,1,1,1257,1245,-12
1301,1,0,9,0,-9
1302,1,1,510,1527,1017
1303,0,0,33,0,-33
1304,1,0,124,0,-124
1305,1,1,855,1287,432
1306,1,0,26,0,-26
1307,0,0,34,0,-34
1308,1,1,407,1415,1008
1309,1,1,1095,1224,129
1310,1,1,17,1321,1304
1311,1,1,203,1606,1403
1312,1,1,75,1385,1310
1313,0,0,6,0,-6
1314,1,1,92,2066,1974
1315,1,1,27,2782,2755
1316,1,1,119,2164,2045
1317,1,0,194,0,-194
1318,1,1,546,1898,1352
1319,0,0,27,0,-27
1320,1,1,167,1494,1327
1321,0,0,85,0,-85
1322,1,0,10,0,-10
1323,1,1,1298,1260,-38
1324,0,0,61,0,-61
1325,1,1,206,1483,1277
1326,0,0,20,0,-20
1327,0,0,26,0,-26
1328,1,1,253,1860,1607
1329,1,0,19,0,-19
1330,1,0,88,0,-88
1331,1,0,15,0,-15
1332,0,0,80,0,-80
1333,1,0,20,0,-20
1334,0,0,6,0,-6
1335,1,1,169,1437,1268
1336,1,1,230,1452,1222
1337,1,0,19,0,-19
1338,1,0,4,0,-4
1339,1,1,1702,1333,-369
1340,1,1,259,1799,1540
1341,0,0,16,0,-16
1342,0,0,14,0,-14
1343,0,0,49,0,-49
1344,1,0,170,0,-170
1345,0,0,30,0,-30
1346,0,0,126,0,-126
1347,1,1,576,1287,711
1348,0,0,4,0,-4
1349,0,0,29,0,-29
1350,0,0,32,0,-32
1351,0,0,64,0,-64
1352,1,0,123,0,-123
1353,1,1,117,1441,1324
1354,0,0,13,0,-13
1355,0,0,80,0,-80
1356,1,1,173,1290,1117
1357,1,0,17,0,-17
1358,1,0,0,0,0
1359,1,1,807,1308,501
1360,0,0,20,0,-20
1361,1,0,1,0,-1
1362,1,0,73,0,-73
1363,1,1,951,1996,1045
1364,1,1,1126,1387,261
1365,0,0,19,0,-19
1366,0,0,231,0,-231
1367,1,1,547,1430,883
1368,1,0,210,0,-210
1369,1,1,138,1446,1308
1370,0,0,176,0,-176
1371,0,0,48,0,-48
1372,1,0,65,0,-65
1373,0,0,25,0,-25
1374,0,0,12,0,-12
1375,0,0,30,0,-30
1376,1,1,295,1602,1307
1377,0,0,19,0,-19
1378,1,0,8,0,-8
1379,1,0,30,0,-30
1380,1,1,460,1323,863
1381,0,0,67,0,-67
1382,1,1,461,1434,973
1383,1,0,79,0,-79
1384,1,0,35,0,-35
1385,0,0,7,0,-7
1386,1,1,536,1266,730
1387,1,0,17,0,-17
1388,0,0,34,0,-34
1389,0,0,85,0,-85
1390,1,1,234,2318,2084
1391,1,1,117,1313,1196
1392,1,1,596,1347,751
1393,1,0,55,0,-55
1394,0,0,4,0,-4
1395,1,0,51,0,-51
1396,1,0,26,0,-26
1397,1,0,0,0,0
1398,0,0,8,0,-8
1399,0,0,70,0,-70
1400,1,1,540,2415,1875
1401,1,0,69,0,-69
1402,1,0,33,0,-33
1403,1,0,16,0,-16
1404,1,1,189,1269,1080
1405,0,0,41,0,-41
1406,0,0,6,0,-6
1407,1,0,6,0,-6
1408,1,0,58,0,-58
1409,0,0,17,0,-17
1410,0,0,46,0,-46
1411,1,1,307,1532,1225
1412,0,0,55,0,-55
1413,0,0,56,0,-56
1414,1,1,35,1309,1274
1415,1,1,368,1409,1041
1416,1,0,108,0,-108
1417,0,0,55,0,-55
1418,1,0,81,0,-81
1419,1,1,168,1585,1417
1420,1,0,25,0,-25
1421,1,1,169,1438,1269
1422,1,1,160,1936,1776
1423,1,1,366,1353,987
1424,0,0,14,0,-14
1425,0,0,14,0,-14
1426,0,0,14,0,-14
1427,0,0,189,0,-189
1428,1,1,8,1237,1229
1429,1,0,69,0,-69
1430,1,1,410,2018,1608
1431,0,0,2,0,-2
1432,0,0,77,0,-77
1433,1,0,101,0,-101
1434,0,0,55,0,-55
1435,1,0,34,0,-34
1436,0,0,41,0,-41
1437,0,0,5,0,-5
1438,1,1,141,1226,1085
1439,1,0,18,0,-18
1440,1,0,131,0,-131
1441,1,1,198,2215,2017
1442,0,0,90,0,-90
1443,1,0,18,0,-18
1444,0,0,12,0,-12
1445,0,0,2,0,-2
1446,1,1,175,2995,2820
1447,1,0,59,0,-59
1448,1,0,41,0,-41
1449,1,0,30,0,-30
1450,1,0,31,0,-31
1451,0,0,14,0,-14
1452,1,0,19,0,-19
1453,1,1,614,1280,666
1454,1,0,23,0,-23
1455,0,0,55,0,-55
1456,1,1,246,1867,1621
1457,1,0,114,0,-114
1458,1,1,1372,2448,1076
1459,0,0,39,0,-39
1460,0,0,69,0,-69
1461,0,0,115,0,-115
1462,1,1,284,1271,987
1463,1,1,827,3118,2291
1464,1,1,560,1600,1040
1465,1,0,60,0,-60
1466,1,1,1114,1519,405
1467,1,1,371,1349,978
1468,1,0,29,0,-29
1469,0,0,9,0,-9
1470,0,0,117,0,-117
1471,0,0,39,0,-39
1472,1,0,8,0,-8
1473,0,0,85,0,-85
1474,0,0,41,0,-41
1475,0,0,56,0,-56
1476,1,1,388,1451,1063
1477,1,0,48,0,-48
1478,0,0,0,0,0
1479,0,0,127,0,-127
1480,1,0,56,0,-56
1481,0,0,6,0,-6
1482,1,0,38,0,-38
1483,0,0,61,0,-61
1484,0,0,48,0,-48
1485,1,0,48,0,-48
1486,1,0,28,0,-28
1487,1,0,47,0,-47
1488,1,1,50,3027,2977
1489,1,1,499,1250,751
1490,0,0,6,0,-6
1491,1,0,0,0,0
1492,0,0,14,0,-14
1493,0,0,23,0,-23
1494,1,0,74,0,-74
1495,0,0,8,0,-8
1496,1,1,34,1403,1369
1497,1,1,43,1369,1326
1498,0,0,22,0,-22
1499,1,1,545,1207,662
1500,1,1,453,2331,1878
1501,0,0,23,0,-23
1502,1,0,82,0,-82
1503,1,0,2,0,-2
1504,0,0,19,0,-19
1505,0,0,166,0,-166
1506,1,0,42,0,-42
1507,1,1,333,1687,1354
1508,0,0,107,0,-107
1509,1,0,71,0,-71
1510,1,0,28,0,-28
1511,1,0,84,0,-84
1512,1,0,43,0,-43
1513,1,0,42,0,-42
1514,1,0,4,0,-4
1515,1,1,327,2409,2082
1516,1,0,80,0,-80
1517,0,0,151,0,-151
1518,1,0,95,0,-95
1519,0,0,67,0,-67
1520,1,0,16,0,-16
1521,0,0,78,0,-78
1522,0,0,20,0,-20
1523,0,0,25,0,-25
1524,1,1,306,1743,1437
1525,1,0,63,0,-63
1526,1,0,49,0,-49
1527,0,0,20,0,-20
1528,1,1,27,1268,1241
1529,0,0,4,0,-4
1530,1,0,47,0,-47
1531,1,1,114,1938,1824
1532,0,0,22,0,-22
1533,0,0,28,0,-28
1534,1,1,604,1413,809
1535,1,1,554,1519,965
1536,0,0,12,0,-12
1537,1,1,139,1845,1706
1538,0,0,29,0,-29
1539,1,1,118,1225,1107
1540,1,1,272,1351,1079
1541,0,0,4,0,-4
1542,1,0,5,0,-5
1543,0,0,48,0,-48
1544,1,0,12,0,-12
1545,0,0,90,0,-90
1546,0,0,69,0,-69
1547,0,0,31,0,-31
1548,0,0,16,0,-16
1549,0,0,18,0,-18
1550,1,1,745,1435,690
1551,0,0,27,0,-27
1552,1,0,65,0,-65
1553,0,0,15,0,-15
1554,0,0,16,0,-16
1555,1,0,12,0,-12
1556,0,0,30,0,-30
1557,1,1,722,1452,730
1558,1,0,23,0,-23
1559,1,0,26,0,-26
1560,0,0,46,0,-46
1561,0,0,39,0,-39
1562,0,0,22,0,-22
1563,1,1,247,1553,1306
1564,0,0,8,0,-8
1565,1,0,87,0,-87
1566,0,0,23,0,-23
1567,0,0,0,0,0
1568,1,1,153,1217,1064
1569,1,1,945,1218,273
1570,1,1,536,1225,689
1571,0,0,46,0,-46
1572,1,1,43,1989,1946
1573,1,0,7,0,-7
1574,1,1,1036,1553,517
1575,0,0,241,0,-241
1576,1,1,1449,2820,1371
1577,0,0,93,0,-93
1578,1,1,489,2526,2037
1579,1,1,525,1729,1204
1580,1,1,230,1314,1084
1581,1,1,236,1918,1682
1582,1,0,16,0,-16
1583,0,0,50,0,-50
1584,1,0,50,0,-50
1585,0,0,193,0,-193
1586,1,0,17,0,-17
1587,1,0,58,0,-58
1588,1,0,43,0,-43
1589,1,1,293,2060,1767
1590,0,0,5,0,-5
1591,1,0,13,0,-13
1592,1,1,66,1339,1273
1593,1,1,311,1360,1049
1594,1,1,174,1624,1450
1595,0,0,16,0,-16
1596,1,0,90,0,-90
1597,0,0,73,0,-73
1598,0,0,8,0,-8
1599,1,1,342,1559,1217
1600,1,0,98,0,-98
1601,0,0,91,0,-91
1602,0,0,121,0,-121
1603,0,0,122,0,-122
1604,0,0,38,0,-38
1605,1,0,19,0,-19
1606,0,0,21,0,-21
1607,1,0,144,0,-144
1608,0,0,20,0,-20
1609,0,0,0,0,0
1610,0,0,176,0,-176
1611,1,1,415,1310,895
1612,1,1,1449,1456,7
1613,1,1,128,1346,1218
1614,1,1,79,1544,1465
1615,0,0,41,0,-41
1616,0,0,19,0,-19
1617,1,1,623,1707,1084
1618,1,0,27,0,-27
1619,0,0,171,0,-171
1620,1,0,106,0,-106
1621,1,1,838,2544,1706
1622,0,0,54,0,-54
1623,1,1,1471,1221,-250
1624,1,1,1114,1219,105
1625,0,0,53,0,-53
1626,1,1,340,1541,1201
1627,1,1,2458,4006,1548
1628,1,1,90,2301,2211
1629,1,1,356,1302,946
1630,0,0,82,0,-82
1631,1,1,1452,1371,-81
1632,0,0,274,0,-274
1633,0,0,39,0,-39
1634,1,1,361,2166,1805
1635,0,0,81,0,-81
1636,1,0,40,0,-40
1637,1,0,193,0,-193
1638,1,0,181,0,-181
1639,1,1,995,2009,1014
1640,1,0,47,0,-47
1641,0,0,4,0,-4
1642,1,0,24,0,-24
1643,1,0,34,0,-34
1644,1,1,1029,1546,517
1645,0,0,41,0,-41
1646,0,0,4,0,-4
1647,1,0,54,0,-54
1648,0,0,78,0,-78
1649,0,0,60,0,-60
1650,0,0,8,0,-8
1651,1,0,22,0,-22
1652,1,0,1,0,-1
1653,1,1,288,1450,1162
1654,1,1,454,1993,1539
1655,1,1,532,1250,718
1656,1,0,104,0,-104
1657,1,0,15,0,-15
1658,1,0,103,0,-103
1659,0,0,26,0,-26
1660,0,0,92,0,-92
1661,1,0,57,0,-57
1662,1,0,113,0,-113
1663,1,1,227,1284,1057
1664,1,0,55,0,-55
1665,1,1,227,1395,1168
1666,1,1,186,1433,1247
1667,1,1,509,1577,1068
1668,1,1,666,1448,782
1669,1,0,49,0,-49
1670,1,0,92,0,-92
1671,1,0,67,0,-67
1672,1,0,20,0,-20
1673,0,0,19,0,-19
1674,0,0,66,0,-66
1675,1,0,33,0,-33
1676,1,1,728,1845,1117
1677,0,0,16,0,-16
1678,0,0,31,0,-31
1679,1,0,104,0,-104
1680,1,0,2,0,-2
1681,1,0,11,0,-11
1682,1,1,816,1453,637
1683,1,0,66,0,-66
1684,0,0,110,0,-110
1685,0,0,36,0,-36
1686,0,0,7,0,-7
1687,1,1,242,1294,1052
1688,1,0,30,0,-30
1689,1,1,103,2373,2270
1690,1,1,557,1207,650
1691,0,0,87,0,-87
1692,0,0,37,0,-37
1693,0,0,8,0,-8
1694,1,1,1013,1267,254
1695,1,1,246,2361,2115
1696,0,0,47,0,-47
1697,1,1,191,2093,1902
1698,1,0,4,0,-4
1699,0,0,2,0,-2
1700,1,1,789,3853,3064
1701,1,0,64,0,-64
1702,1,1,1250,1202,-48
1703,1,1,85,1325,1240
1704,0,0,40,0,-40
1705,0,0,32,0,-32
1706,0,0,58,0,-58
1707,1,1,109,1221,1112
1708,1,1,221,2285,2064
1709,0,0,28,0,-28
1710,0,0,18,0,-18
1711,0,0,16,0,-16
1712,0,0,255,0,-255
1713,0,0,46,0,-46
1714,0,0,35,0,-35
1715,1,1,209,2518,2309
1716,1,1,88,1355,1267
1717,0,0,150,0,-150
1718,1,1,30,1366,1336
1719,1,0,23,0,-23
1720,0,0,17,0,-17
1721,1,1,207,2229,2022
1722,0,0,213,0,-213
1723,1,0,23,0,-23
1724,1,1,1112,1414,302
1725,0,0,45,0,-45
1726,0,0,14,0,-14
1727,0,0,139,0,-139
1728,0,0,26,0,-26
1729,0,0,11,0,-11
1730,1,0,13,0,-13
1731,0,0,8,0,-8
1732,0,0,12,0,-12
1733,1,1,346,1462,1116
1734,1,1,32,1496,1464
1735,1,0,167,0,-167
1736,1,1,400,1207,807
1737,1,0,3,0,-3
1738,1,0,153,0,-153
1739,0,0,36,0,-36
1740,1,0,86,0,-86
1741,1,0,2,0,-2
1742,0,0,38,0,-38
1743,1,1,1706,1349,-357
1744,0,0,6,0,-6
1745,1,0,18,0,-18
1746,1,1,205,1347,1142
1747,1,1,212,2549,2337
1748,1,1,496,1275,779
1749,1,1,1020,1207,187
1750,0,0,18,0,-18
1751,1,0,160,0,-160
1752,1,0,47,0,-47
1753,1,0,58,0,-58
1754,0,0,33,0,-33
1755,0,0,55,0,-55
1756,1,1,658,1452,794
1757,1,1,632,1653,1021
1758,0,0,264,0,-264
1759,0,0,31,0,-31
1760,1,1,464,1730,1266
1761,0,0,9,0,-9
1762,0,0,112,0,-112
1763,0,0,5,0,-5
1764,1,1,244,2685,2441
1765,1,0,45,0,-45
1766,0,0,21,0,-21
1767,0,0,92,0,-92
1768,0,0,45,0,-45
1769,1,0,44,0,-44
1770,0,0,128,0,-128
1771,1,0,8,0,-8
1772,1,1,456,1246,790
1773,0,0,20,0,-20
1774,1,1,157,1497,1340
1775,0,0,60,0,-60
1776,1,1,313,2352,2039
1777,1,1,209,1441,1232
1778,1,0,50,0,-50
1779,1,0,32,0,-32
1780,1,1,774,1218,444
1781,0,0,41,0,-41
1782,1,1,1319,1299,-20
1783,1,0,14,0,-14
1784,1,1,210,1798,1588
1785,1,1,137,1220,1083
1786,0,0,144,0,-144
1787,0,0,25,0,-25
1788,1,1,647,1998,1351
1789,0,0,21,0,-21
1790,1,0,81,0,-81
1791,1,0,26,0,-26
1792,1,0,29,0,-29
1793,1,0,11,0,-11
1794,1,0,119,0,-119
1795,1,0,90,0,-90
1796,1,1,621,1316,695
1797,0,0,12,0,-12
1798,1,1,456,1861,1405
1799,1,0,31,0,-31
1800,1,1,1892,1282,-610
1801,1,0,19,0,-19
1802,1,1,85,1660,1575
1803,1,0,83,0,-83
1804,1,1,769,2347,1578
1805,1,0,64,0,-64
1806,1,0,22,0,-22
1807,0,0,16,0,-16
1808,1,1,903,1363,460
1809,1,0,65,0,-65
1810,1,0,44,0,-44
1811,0,0,32,0,-32
1812,0,0,160,0,-160
1813,1,0,10,0,-10
1814,0,0,13,0,-13
1815,1,0,13,0,-13
1816,1,0,95,0,-95
1817,1,1,690,1463,773
1818,1,0,9,0,-9
1819,1,0,21,0,-21
1820,1,0,30,0,-30
1821,1,1,169,1201,1032
1822,0,0,42,0,-42
1823,0,0,4,0,-4
1824,0,0,4,0,-4
1825,0,0,43,0,-43
1826,0,0,69,0,-69
1827,1,0,10,0,-10
1828,1,1,189,1341,1152
1829,1,1,663,1282,619
1830,1,0,133,0,-133
1831,0,0,66,0,-66
1832,1,1,533,3779,3246
1833,0,0,13,0,-13
1834,1,1,211,1259,1048
1835,1,0,49,0,-49
1836,0,0,18,0,-18
1837,0,0,40,0,-40
1838,1,0,23,0,-23
1839,1,1,1239,1512,273
1840,1,1,175,1434,1259
1841,0,0,6,0,-6
1842,1,0,23,0,-23
1843,1,1,392,1326,934
1844,1,1,496,1774,1278
1845,0,0,11,0,-11
1846,1,1,742,1661,919
1847,1,0,56,0,-56
1848,0,0,11,0,-11
1849,0,0,32,0,-32
1850,0,0,42,0,-42
1851,1,0,14,0,-14
1852,1,1,524,1458,934
1853,0,0,0,0,0
1854,1,0,13,0,-13
1855,1,1,61,1355,1294
1856,1,0,7,0,-7
1857,1,1,79,1209,1130
1858,1,1,386,1491,1105
1859,0,0,12,0,-12
1860,1,1,234,2926,2692
1861,1,1,325,1249,924
1862,0,0,35,0,-35
1863,0,0,67,0,-67
1864,1,1,346,1210,864
1865,1,0,29,0,-29
1866,1,1,1142,2355,1213
1867,0,0,4,0,-4
1868,0,0,195,0,-195
1869,0,0,9,0,-9
1870,1,1,1302,1319,17
1871,1,1,487,1466,979
1872,1,0,39,0,-39
1873,0,0,2,0,-2
1874,1,0,9,0,-9
1875,0,0,49,0,-49
1876,0,0,14,0,-14
1877,0,0,26,0,-26
1878,0,0,43,0,-43
1879,0,0,77,0,-77
1880,0,0,3,0,-3
1881,1,1,23,1331,1308
1882,1,1,945,3234,2289
1883,1,1,277,1473,1196
1884,0,0,43,0,-43
1885,0,0,22,0,-22
1886,0,0,76,0,-76
1887,1,0,33,0,-33
1888,1,1,487,1577,1090
1889,1,0,33,0,-33
1890,0,0,103,0,-103
1891,0,0,19,0,-19
1892,1,1,247,1242,995
1893,0,0,27,0,-27
1894,0,0,63,0,-63
1895,0,0,6,0,-6
1896,1,1,102,1570,1468
1897,1,1,1321,1224,-97
1898,1,1,402,1480,1078
1899,1,1,250,1698,1448
1900,1,0,80,0,-80
1901,0,0,96,0,-96
1902,1,0,31,0,-31
1903,1,1,262,1402,1140
1904,1,1,153,1723,1570
1905,1,1,183,1317,1134
1906,1,0,45,0,-45
1907,1,0,7,0,-7
1908,1,0,44,0,-44
1909,0,0,114,0,-114
1910,0,0,18,0,-18
1911,1,0,26,0,-26
1912,1,1,682,2463,1781
1913,1,1,449,1219,770
1914,0,0,30,0,-30
1915,0,0,160,0,-160
1916,1,1,284,1220,936
1917,0,0,22,0,-22
1918,1,1,1168,1939,771
1919,1,1,305,1213,908
1920,0,0,43,0,-43
1921,0,0,32,0,-32
1922,0,0,63,0,-63
1923,1,0,123,0,-123
1924,1,0,55,0,-55
1925,1,0,28,0,-28
1926,1,1,145,1270,1125
1927,1,1,457,1328,871
1928,0,0,79,0,-79
1929,1,0,16,0,-16
1930,0,0,12,0,-12
1931,1,1,899,1256,357
1932,1,1,224,1888,1664
1933,1,1,1283,1933,650
1934,0,0,14,0,-14
1935,1,0,22,0,-22
1936,0,0,19,0,-19
1937,0,0,8,0,-8
1938,1,1,1390,1620,230
1939,0,0,14,0,-14
1940,0,0,30,0,-30
1941,1,1,272,1340,1068
1942,1,0,20,0,-20
1943,1,0,108,0,-108
1944,1,1,131,1386,1255
1945,0,0,60,0,-60
1946,1,1,522,1536,1014
1947,1,0,21,0,-21
1948,0,0,30,0,-30
1949,0,0,36,0,-36
1950,1,0,10,0,-10
1951,0,0,41,0,-41
1952,1,0,3,0,-3
1953,1,0,0,0,0
1954,0,0,14,0,-14
1955,1,1,528,1606,1078
1956,0,0,89,0,-89
1957,0,0,78,0,-78
1958,1,1,187,1444,1257
1959,1,0,95,0,-95
1960,0,0,3,0,-3
1961,0,0,15,0,-15
1962,1,1,286,1202,916
1963,1,0,3,0,-3
1964,0,0,21,0,-21
1965,1,1,260,1472,1212
1966,1,1,288,1311,1023
1967,1,0,36,0,-36
1968,0,0,0,0,0
1969,0,0,17,0,-17
1970,1,0,5,0,-5
1971,1,0,12,0,-12
1972,1,0,19,0,-19
1973,0,0,12,0,-12
1974,0,0,10,0,-10
1975,1,0,274,0,-274
1976,0,0,94,0,-94
1977,0,0,99,0,-99
1978,0,0,7,0,-7
1979,1,1,114,2965,2851
1980,0,0,1,0,-1
1981,1,1,1079,1205,126
1982,0,0,101,0,-101
1983,0,0,53,0,-53
1984,1,0,10,0,-10
1985,1,1,70,2820,2750
1986,1,0,32,0,-32
1987,0,0,59,0,-59
1988,1,0,32,0,-32
1989,1,1,872,1261,389
1990,1,0,9,0,-9
1991,0,0,2,0,-2
1992,1,0,1,0,-1
1993,1,0,43,0,-43
1994,1,1,1464,2963,1499
1995,0,0,17,0,-17
1996,0,0,121,0,-121
1997,1,0,10,0,-10
1998,1,0,108,0,-108
1999,1,0,0,0,0
2000,1,0,6,0,-6
2001,1,1,32,1907,1875
2002,1,0,125,0,-125
2003,0,0,54,0,-54
2004,1,0,19,0,-19
2005,1,0,3,0,-3
2006,0,0,120,0,-120
2007,1,0,13,0,-13
2008,1,1,245,1372,1127
2009,1,1,270,1208,938
2010,1,0,86,0,-86
2011,1,0,11,0,-11
2012,1,1,1387,1324,-63
2013,1,0,91,0,-91
2014,1,1,390,1661,1271
2015,0,0,92,0,-92
2016,1,1,862,1220,358
2017,1,1,299,1383,1084
2018,0,0,19,0,-19
2019,0,0,4,0,-4
2020,1,1,123,1477,1354
2021,1,1,319,1485,1166
2022,0,0,38,0,-38
2023,0,0,16,0,-16
2024,0,0,113,0,-113
2025,1,1,514,1679,1165
2026,1,0,29,0,-29
2027,1,1,166,1287,1121
2028,1,0,105,0,-105
2029,1,0,39,0,-39
2030,0,0,0,0,0
2031,1,1,419,1664,1245
2032,1,0,53,0,-53
2033,1,1,767,1221,454
2034,1,1,709,2833,2124
2035,1,0,50,0,-50
2036,1,1,1123,1600,477
2037,0,0,20,0,-20
2038,0,0,0,0,0
2039,1,0,29,0,-29
2040,1,0,9,0,-9
2041,0,0,95,0,-95
2042,1,1,148,1585,1437
2043,1,1,650,1715,1065
2044,1,1,442,2336,1894
2045,0,0,20,0,-20
2046,1,0,8,0,-8
2047,1,1,2335,1270,-1065
2048,0,0,1,0,-1
2049,1,1,38,1376,1338
2050,1,0,30,0,-30
2051,0,0,4,0,-4
2052,0,0,73,0,-73
2053,1,1,447,1228,781
2054,0,0,67,0,-67
2055,1,0,111,0,-111
2056,0,0,7,0,-7
2057,0,0,2,0,-2
2058,1,1,504,1537,1033
2059,1,0,27,0,-27
2060,1,0,2,0,-2
2061,0,0,164,0,-164
2062,0,0,63,0,-63
2063,0,0,103,0,-103
2064,1,0,35,0,-35
2065,1,0,32,0,-32
2066,1,0,62,0,-62
2067,0,0,51,0,-51
2068,0,0,4,0,-4
2069,1,1,62,1349,1287
2070,0,0,37,0,-37
2071,0,0,56,0,-56
2072,1,0,32,0,-32
2073,1,1,390,1314,924
2074,1,1,1266,1670,404
2075,0,0,90,0,-90
2076,0,0,51,0,-51
2077,1,0,10,0,-10
2078,0,0,38,0,-38
2079,0,0,34,0,-34
2080,1,0,44,0,-44
2081,1,1,348,1372,1024
2082,1,0,54,0,-54
2083,1,0,11,0,-11
2084,0,0,4,0,-4
2085,1,1,758,1479,721
2086,0,0,36,0,-36
2087,1,1,389,1459,1070
2088,0,0,24,0,-24
2089,1,0,53,0,-53
2090,1,1,320,3289,2969
2091,0,0,15,0,-15
2092,1,1,135,1331,1196
2093,0,0,10,0,-10
2094,1,0,46,0,-46
2095,1,1,1013,1924,911
2096,0,0,8,0,-8
2097,1,0,12,0,-12
2098,1,1,118,1454,1336
2099,1,0,16,0,-16
2100,1,0,4,0,-4
2101,1,0,43,0,-43
2102,0,0,110,0,-110
2103,1,1,175,1851,1676
2104,0,0,59,0,-59
2105,1,0,20,0,-20
2106,1,1,1223,1570,347
2107,1,0,12,0,-12
2108,0,0,4,0,-4
2109,1,0,81,0,-81
2110,1,1,159,1398,1239
2111,1,1,527,1530,1003
2112,1,0,9,0,-9
2113,0,0,46,0,-46
2114,1,0,98,0,-98
2115,0,0,44,0,-44
2116,0,0,0,0,0
2117,1,0,102,0,-102
2118,0,0,68,0,-68
2119,0,0,84,0,-84
2120,1,0,4,0,-4
2121,1,1,265,1351,1086
2122,1,0,63,0,-63
2123,0,0,27,0,-27
2124,0,0,6,0,-6
2125,0,0,23,0,-23
2126,1,0,26,0,-26
2127,1,0,78,0,-78
2128,0,0,68,0,-68
2129,0,0,114,0,-114
2130,1,0,126,0,-126
2131,1,0,114,0,-114
2132,1,0,18,0,-18
2133,1,1,1874,1662,-212
2134,1,0,35,0,-35
2135,1,0,52,0,-52
2136,1,1,333,1504,1171
2137,0,0,25,0,-25
2138,0,0,89,0,-89
2139,0,0,56,0,-56
2140,0,0,1,0,-1
2141,1,1,1004,1379,375
2142,1,1,619,1386,767
2143,1,1,28,2252,2224
2144,0,0,161,0,-161
2145,0,0,13,0,-13
2146,0,0,14,0,-14
2147,1,1,90,1830,1740
2148,1,1,501,1281,780
2149,1,1,1133,1226,93
2150,1,1,194,1769,1575
2151,1,1,954,1223,269
2152,0,0,29,0,-29
2153,0,0,2,0,-2
2154,1,1,875,4112,3237
2155,0,0,80,0,-80
2156,0,0,29,0,-29
2157,1,1,339,1337,998
2158,0,0,27,0,-27
2159,1,1,236,1224,988
2160,0,0,6,0,-6
2161,1,0,98,0,-98
2162,1,0,6,0,-6
2163,1,1,74,1215,1141
2164,0,0,33,0,-33
2165,1,1,686,1242,556
2166,1,0,18,0,-18
2167,0,0,53,0,-53
2168,0,0,61,0,-61
2169,1,1,236,3324,3088
2170,0,0,32,0,-32
2171,1,1,674,1250,576
2172,0,0,55,0,-55
2173,0,0,96,0,-96
2174,1,0,4,0,-4
2175,1,1,245,1938,1693
2176,0,0,86,0,-86
2177,1,0,76,0,-76
2178,1,1,171,4452,4281
2179,1,0,41,0,-41
2180,1,1,2904,1217,-1687
2181,0,0,37,0,-37
2182,1,1,509,1579,1070
2183,1,0,8,0,-8
2184,1,0,109,0,-109
2185,0,0,33,0,-33
2186,0,0,216,0,-216
2187,0,0,12,0,-12
2188,0,0,27,0,-27
2189,1,1,503,2532,2029
2190,1,0,22,0,-22
2191,1,0,188,0,-188
2192,1,0,3,0,-3
2193,1,1,1079,1757,678
2194,1,0,58,0,-58
2195,1,0,117,0,-117
2196,0,0,47,0,-47
2197,0,0,89,0,-89
2198,0,0,37,0,-37
2199,0,0,16,0,-16
2200,1,0,142,0,-142
2201,0,0,74,0,-74
2202,0,0,73,0,-73
2203,0,0,50,0,-50
2204,0,0,44,0,-44
2205,0,0,23,0,-23
2206,0,0,94,0,-94
2207,0,0,68,0,-68
2208,1,1,728,1212,484
2209,0,0,54,0,-54
2210,1,0,73,0,-73
2211,0,0,108,0,-108
2212,0,0,21,0,-21
2213,0,0,214,0,-214
2214,0,0,5,0,-5
2215,1,0,17,0,-17
2216,0,0,74,0,-74
2217,1,0,77,0,-77
2218,0,0,17,0,-17
2219,1,1,71,1399,1328
2220,1,0,24,0,-24
2221,0,0,20,0,-20
2222,1,0,119,0,-119
2223,1,1,745,1264,519
2224,1,0,31,0,-31
2225,1,1,192,1226,1034
2226,1,0,19,0,-19
2227,1,0,69,0,-69
2228,1,0,0,0,0
2229,0,0,25,0,-25
2230,0,0,18,0,-18
2231,1,1,1296,1225,-71
2232,0,0,99,0,-99
2233,0,0,9,0,-9
2234,0,0,46,0,-46
2235,1,1,166,1321,1155
2236,0,0,1,0,-1
2237,1,0,38,0,-38
2238,1,1,837,1475,638
2239,1,0,76,0,-76
2240,0,0,10,0,-10
2241,0,0,7,0,-7
2242,0,0,111,0,-111
2243,1,1,32,1418,1386
2244,1,0,118,0,-118
2245,0,0,137,0,-137
2246,1,0,33,0,-33
2247,1,1,1178,2295,1117
2248,1,0,2,0,-2
2249,1,0,84,0,-84
2250,1,0,119,0,-119
2251,0,0,28,0,-28
2252,1,1,89,1205,1116
2253,1,0,63,0,-63
2254,1,0,60,0,-60
2255,0,0,32,0,-32
2256,1,1,305,1299,994
2257,0,0,69,0,-69
2258,1,1,846,1267,421
2259,0,0,7,0,-7
2260,0,0,37,0,-37
2261,1,1,346,1254,908
2262,1,0,23,0,-23
2263,0,0,21,0,-21
2264,0,0,32,0,-32
2265,1,1,237,1406,1169
2266,1,1,556,1240,684
2267,0,0,57,0,-57
2268,0,0,5,0,-5
2269,0,0,1,0,-1
2270,1,1,1296,1555,259
2271,1,0,40,0,-40
2272,0,0,19,0,-19
2273,1,1,241,1348,1107
2274,0,0,66,0,-66
2275,1,0,183,0,-183
2276,1,1,636,1285,649
2277,0,0,8,0,-8
2278,0,0,12,0,-12
2279,1,0,73,0,-73
2280,0,0,114,0,-114
2281,1,0,63,0,-63
2282,1,1,205,1466,1261
2283,0,0,88,0,-88
2284,1,0,10,0,-10
2285,1,1,1098,1383,285
2286,1,0,22,0,-22
2287,0,0,164,0,-164
2288,1,1,444,1904,1460
2289,0,0,38,0,-38
2290,1,0,102,0,-102
2291,0,0,5,0,-5
2292,1,0,13,0,-13
2293,0,0,13,0,-13
2294,1,1,216,1203,987
2295,0,0,15,0,-15
2296,0,0,26,0,-26
2297,0,0,188,0,-188
2298,1,0,9,0,-9
2299,0,0,48,0,-48
2300,1,0,29,0,-29
2301,0,0,81,0,-81
2302,1,1,318,1430,1112
2303,1,1,293,1242,949
2304,0,0,34,0,-34
2305,1,0,17,0,-17
2306,1,1,1115,1282,167
2307,0,0,40,0,-40
2308,0,0,7,0,-7
2309,0,0,19,0,-19
2310,1,1,352,1749,1397
2311,1,0,83,0,-83
2312,0,0,50,0,-50
2313,0,0,19,0,-19
2314,0,0,33,0,-33
2315,1,1,469,1250,781
2316,0,0,8,0,-8
2317,1,0,265,0,-265
2318,1,0,34,0,-34
2319,0,0,78,0,-78
2320,1,0,2,0,-2
2321,0,0,79,0,-79
2322,1,1,582,1528,946
2323,1,0,72,0,-72
2324,0,0,11,0,-11
2325,0,0,34,0,-34
2326,1,0,45,0,-45
2327,1,1,181,1316,1135
2328,1,1,284,1262,978
2329,1,0,146,0,-146
2330,1,0,11,0,-11
2331,1,1,191,1213,1022
2332,1,0,38,0,-38
2333,0,0,20,0,-20
2334,1,0,8,0,-8
2335,1,1,220,1263,1043
2336,1,0,54,0,-54
2337,0,0,35,0,-35
2338,0,0,18,0,-18
2339,0,0,71,0,-71
2340,1,0,3,0,-3
2341,0,0,45,0,-45
2342,0,0,4,0,-4
2343,0,0,78,0,-78
2344,0,0,73,0,-73
2345,0,0,13,0,-13
2346,1,1,513,1295,782
2347,1,1,423,1510,1087
2348,1,1,2637,1889,-748
2349,0,0,35,0,-35
2350,1,1,840,1978,1138
2351,1,1,218,1262,1044
2352,0,0,71,0,-71
2353,0,0,52,0,-52
2354,1,0,131,0,-131
2355,0,0,56,0,-56
2356,1,1,528,1201,673
2357,1,0,15,0,-15
2358,1,1,966,1204,238
2359,1,1,394,1774,1380
2360,0,0,15,0,-15
2361,0,0,10,0,-10
2362,1,1,377,1770,1393
2363,0,0,14,0,-14
2364,1,1,1099,1251,152
2365,1,1,357,1224,867
2366,1,1,487,1330,843
2367,1,1,476,1306,830
2368,1,0,78,0,-78
2369,1,0,46,0,-46
2370,1,0,68,0,-68
2371,0,0,139,0,-139
2372,1,1,267,2402,2135
2373,0,0,34,0,-34
2374,0,0,12,0,-12
2375,1,0,109,0,-109
2376,1,1,367,1561,1194
2377,1,0,27,0,-27
2378,1,0,27,0,-27
2379,0,0,46,0,-46
2380,0,0,2,0,-2
2381,0,0,6,0,-6
2382,0,0,25,0,-25
2383,0,0,8,0,-8
2384,1,1,158,1378,1220
2385,1,0,55,0,-55
2386,1,0,18,0,-18
2387,1,0,25,0,-25
2388,1,0,56,0,-56
2389,1,0,42,0,-42
2390,1,1,133,1431,1298
2391,1,1,23,1349,1326
2392,1,1,91,1544,1453
2393,1,1,624,1533,909
2394,1,1,607,1250,643
2395,0,0,103,0,-103
2396,1,0,8,0,-8
2397,1,1,2270,1297,-973
2398,1,1,209,1321,1112
2399,1,0,29,0,-29
2400,1,0,97,0,-97
2401,1,0,56,0,-56
2402,0,0,20,0,-20
2403,1,0,30,0,-30
2404,1,0,43,0,-43
2405,1,1,48,4045,3997
2406,0,0,12,0,-12
2407,1,1,208,1390,1182
2408,1,0,37,0,-37
2409,0,0,79,0,-79
2410,1,1,896,3155,2259
2411,0,0,20,0,-20
2412,0,0,20,0,-20
2413,0,0,11,0,-11
2414,1,1,713,1432,719
2415,0,0,42,0,-42
2416,1,0,3,0,-3
2417,0,0,37,0,-37
2418,1,1,261,2832,2571
2419,0,0,10,0,-10
2420,0,0,53,0,-53
2421,1,1,363,1212,849
2422,1,1,616,1258,642
2423,1,1,368,2471,2103
2424,1,1,89,1413,1324
2425,0,0,205,0,-205
2426,0,0,67,0,-67
2427,0,0,11,0,-11
2428,0,0,85,0,-85
2429,1,1,739,1380,641
2430,0,0,48,0,-48
2431,1,0,45,0,-45
2432,0,0,76,0,-76
2433,0,0,69,0,-69
2434,1,0,23,0,-23
2435,1,0,28,0,-28
2436,0,0,16,0,-16
2437,0,0,48,0,-48
2438,0,0,7,0,-7
2439,1,1,1363,1277,-86
2440,1,1,100,1350,1250
2441,0,0,176,0,-176
2442,1,0,16,0,-16
2443,1,0,35,0,-35
2444,1,1,399,1387,988
2445,0,0,122,0,-122
2446,1,0,62,0,-62
2447,0,0,118,0,-118
2448,0,0,139,0,-139
2449,1,0,50,0,-50
2450,0,0,1,0,-1
2451,0,0,23,0,-23
2452,1,0,109,0,-109
2453,0,0,58,0,-58
2454,1,1,1059,1208,149
2455,0,0,1,0,-1
2456,0,0,70,0,-70
2457,1,0,48,0,-48
2458,1,0,89,0,-89
2459,1,1,334,1603,1269
2460,1,1,1174,2360,1186
2461,1,0,10,0,-10
2462,0,0,84,0,-84
2463,0,0,10,0,-10
2464,1,1,76,1210,1134
2465,1,1,867,1692,825
2466,1,1,68,2365,2297
2467,1,0,43,0,-43
2468,1,0,0,0,0
2469,1,0,33,0,-33
2470,1,1,469,1565,1096
2471,1,0,3,0,-3
2472,1,1,650,1611,961
2473,0,0,9,0,-9
2474,1,0,41,0,-41
2475,1,0,12,0,-12
2476,0,0,30,0,-30
2477,0,0,26,0,-26
2478,1,1,1105,1381,276
2479,0,0,0,0,0
2480,0,0,32,0,-32
2481,0,0,113,0,-113
2482,1,1,544,1374,830
2483,0,0,63,0,-63
2484,0,0,67,0,-67
2485,1,1,88,1389,1301
2486,1,0,298,0,-298
2487,1,0,1,0,-1
2488,1,1,976,1848,872
2489,0,0,13,0,-13
2490,0,0,90,0,-90
2491,1,1,374,1313,939
2492,0,0,23,0,-23
2493,1,0,138,0,-138
2494,0,0,0,0,0
2495,0,0,1,0,-1
2496,0,0,48,0,-48
2497,1,0,42,0,-42
2498,0,0,24,0,-24
2499,1,1,47,1633,1586
2500,1,1,465,1267,802
2501,1,0,74,0,-74
2502,1,0,85,0,-85
2503,0,0,23,0,-23
2504,1,1,461,1237,776
2505,1,1,218,2208,1990
2506,1,1,312,2334,2022
2507,1,1,477,1599,1122
2508,0,0,11,0,-11
2509,1,1,966,1484,518
2510,0,0,63,0,-63
2511,1,1,438,1367,929
2512,1,1,392,1318,926
2513,1,0,90,0,-90
2514,0,0,52,0,-52
2515,1,0,3,0,-3
2516,0,0,13,0,-13
2517,1,1,707,1579,872
2518,1,1,409,1241,832
2519,1,1,347,1990,1643
2520,0,0,50,0,-50
2521,0,0,45,0,-45
2522,1,1,746,2727,1981
2523,1,1,581,1274,693
2524,1,1,700,1324,624
2525,1,1,394,1273,879
2526,0,0,54,0,-54
2527,0,0,64,0,-64
2528,1,1,335,1502,1167
2529,1,0,36,0,-36
2530,1,1,1437,1940,503
2531,1,1,91,1283,1192
2532,0,0,6,0,-6
2533,1,0,4,0,-4
2534,1,0,37,0,-37
2535,1,1,947,1330,383
2536,1,1,79,1385,1306
2537,1,1,139,1233,1094
2538,1,0,4,0,-4
2539,0,0,10,0,-10
2540,1,0,4,0,-4
2541,1,0,25,0,-25
2542,1,1,868,1957,1089
2543,1,1,1093,1832,739
2544,1,0,148,0,-148
2545,1,0,7,0,-7
2546,0,0,32,0,-32
2547,1,1,15,2352,2337
2548,0,0,170,0,-170
2549,1,1,488,1423,935
2550,1,1,571,1743,1172
2551,1,0,108,0,-108
2552,0,0,25,0,-25
2553,1,1,99,2688,2589
2554,1,1,31,1325,1294
2555,1,0,72,0,-72
2556,0,0,49,0,-49
2557,1,0,117,0,-117
2558,0,0,51,0,-51
2559,0,0,2,0,-2
2560,0,0,10,0,-10
2561,0,0,168,0,-168
2562,0,0,12,0,-12
2563,1,1,408,1251,843
2564,0,0,0,0,0
2565,1,1,480,1830,1350
2566,1,0,1,0,-1
2567,0,0,31,0,-31
2568,0,0,79,0,-79
2569,1,1,558,1267,709
2570,0,0,48,0,-48
2571,0,0,34,0,-34
2572,0,0,10,0,-10
2573,1,0,80,0,-80
2574,0,0,40,0,-40
2575,1,1,119,1243,1124
2576,1,0,7,0,-7
2577,0,0,43,0,-43
2578,0,0,65,0,-65
2579,1,0,36,0,-36
2580,1,0,50,0,-50
2581,0,0,44,0,-44
2582,0,0,2,0,-2
2583,1,1,1769,2512,743
2584,1,1,361,1342,981
2585,1,0,6,0,-6
2586,1,1,195,1395,1200
2587,1,0,42,0,-42
2588,1,1,423,2519,2096
2589,0,0,3,0,-3
2590,1,0,16,0,-16
2591,1,0,11,0,-11
2592,1,0,74,0,-74
2593,0,0,7,0,-7
2594,1,0,105,0,-105
2595,1,1,424,1597,1173
2596,1,0,7,0,-7
2597,1,0,12,0,-12
2598,1,0,14,0,-14
2599,1,0,205,0,-205
2600,0,0,98,0,-98
2601,0,0,148,0,-148
2602,1,1,891,1444,553
2603,0,0,183,0,-183
2604,0,0,37,0,-37
2605,1,1,173,1423,1250
2606,1,0,48,0,-48
2607,1,0,16,0,-16
2608,1,0,51,0,-51
2609,0,0,85,0,-85
2610,1,1,246,1213,967
2611,0,0,57,0,-57
2612,0,0,28,0,-28
2613,1,0,5,0,-5
2614,1,0,10,0,-10
2615,1,1,1442,1387,-55
2616,1,1,48,1964,1916
2617,1,1,152,1292,1140
2618,0,0,2,0,-2
2619,1,0,48,0,-48
2620,0,0,42,0,-42
2621,0,0,37,0,-37
2622,0,0,3,0,-3
2623,1,1,1203,1724,521
2624,1,0,95,0,-95
2625,1,1,373,1414,1041
2626,0,0,15,0,-15
2627,0,0,38,0,-38
2628,0,0,63,0,-63
2629,0,0,142,0,-142
2630,1,0,139,0,-139
2631,0,0,121,0,-121
2632,0,0,86,0,-86
2633,1,0,49,0,-49
2634,1,0,45,0,-45
2635,1,0,49,0,-49
2636,1,1,275,1397,1122
2637,1,0,33,0,-33
2638,1,1,392,1860,1468
2639,1,1,212,1500,1288
2640,0,0,195,0,-195
2641,1,0,85,0,-85
2642,1,1,894,1249,355
2643,1,0,10,0,-10
2644,0,0,27,0,-27
2645,1,1,815,1407,592
2646,0,0,224,0,-224
2647,1,1,313,1436,1123
2648,0,0,75,0,-75
2649,0,0,6,0,-6
2650,1,1,651,1628,977
2651,1,0,35,0,-35
2652,0,0,41,0,-41
2653,1,0,41,0,-41
2654,1,0,31,0,-31
2655,0,0,8,0,-8
2656,0,0,2,0,-2
2657,0,0,46,0,-46
2658,0,0,39,0,-39
2659,0,0,49,0,-49
2660,0,0,36,0,-36
2661,1,0,8,0,-8
2662,0,0,1,0,-1
2663,0,0,17,0,-17
2664,1,1,973,1944,971
2665,1,0,15,0,-15
2666,0,0,32,0,-32
2667,1,0,40,0,-40
2668,0,0,108,0,-108
2669,0,0,37,0,-37
2670,0,0,67,0,-67
2671,0,0,66,0,-66
2672,1,0,133,0,-133
2673,1,1,304,1707,1403
2674,0,0,10,0,-10
2675,0,0,36,0,-36
2676,1,1,299,2260,1961
2677,1,0,37,0,-37
2678,0,0,195,0,-195
2679,1,0,59,0,-59
2680,1,1,303,1651,1348
2681,0,0,8,0,-8
2682,0,0,9,0,-9
2683,0,0,58,0,-58
2684,1,0,25,0,-25
2685,0,0,54,0,-54
2686,1,1,454,2659,2205
2687,1,1,53,2304,2251
2688,0,0,19,0,-19
2689,0,0,88,0,-88
2690,1,0,45,0,-45
2691,0,0,16,0,-16
2692,0,0,76,0,-76
2693,0,0,209,0,-209
2694,0,0,58,0,-58
2695,0,0,49,0,-49
2696,1,1,768,2321,1553
2697,0,0,4,0,-4
2698,1,0,2,0,-2
2699,0,0,41,0,-41
2700,0,0,12,0,-12
2701,0,0,50,0,-50
2702,0,0,40,0,-40
2703,1,0,14,0,-14
2704,0,0,0,0,0
2705,1,1,66,1822,1756
2706,1,0,15,0,-15
2707,0,0,6,0,-6
2708,1,1,373,1243,870
2709,0,0,54,0,-54
2710,1,0,88,0,-88
2711,0,0,45,0,-45
2712,0,0,105,0,-105
2713,1,1,644,1495,851
2714,0,0,14,0,-14
2715,0,0,18,0,-18
2716,0,0,47,0,-47
2717,0,0,76,0,-76
2718,1,1,542,1294,752
2719,0,0,9,0,-9
2720,1,1,1336,1297,-39
2721,0,0,20,0,-20
2722,1,0,43,0,-43
2723,0,0,48,0,-48
2724,0,0,27,0,-27
2725,1,0,73,0,-73
2726,1,1,1180,1236,56
2727,1,1,1203,1726,523
2728,0,0,22,0,-22
2729,1,1,1052,1672,620
2730,1,1,677,1204,527
2731,0,0,97,0,-97
2732,0,0,118,0,-118
2733,1,0,101,0,-101
2734,1,1,395,3173,2778
2735,1,1,940,2133,1193
2736,0,0,16,0,-16
2737,1,0,136,0,-136
2738,1,0,40,0,-40
2739,1,1,298,1650,1352
2740,1,1,389,2204,1815
2741,0,0,33,0,-33
2742,1,0,44,0,-44
2743,0,0,67,0,-67
2744,0,0,46,0,-46
2745,1,0,30,0,-30
2746,1,0,287,0,-287
2747,0,0,171,0,-171
2748,0,0,39,0,-39
2749,1,0,53,0,-53
2750,1,0,4,0,-4
2751,1,0,57,0,-57
2752,1,0,6,0,-6
2753,1,1,264,1486,1222
2754,0,0,77,0,-77
2755,1,0,8,0,-8
2756,1,1,325,1405,1080
2757,1,0,185,0,-185
2758,1,1,932,1220,288
2759,1,1,1470,1224,-246
2760,0,0,21,0,-21
2761,0,0,4,0,-4
2762,1,0,17,0,-17
2763,0,0,41,0,-41
2764,0,0,108,0,-108
2765,1,1,947,1594,647
2766,1,1,186,1226,1040
2767,1,0,9,0,-9
2768,0,0,42,0,-42
2769,0,0,68,0,-68
2770,0,0,8,0,-8
2771,0,0,55,0,-55
2772,1,1,109,1333,1224
2773,1,1,723,1488,765
2774,0,0,98,0,-98
2775,1,0,17,0,-17
2776,0,0,50,0,-50
2777,0,0,31,0,-31
2778,1,1,188,1524,1336
2779,1,0,51,0,-51
2780,0,0,54,0,-54
2781,1,1,1248,1307,59
2782,1,1,466,1340,874
2783,1,1,1410,1390,-20
2784,0,0,2,0,-2
2785,0,0,92,0,-92
2786,1,1,375,1744,1369
2787,0,0,18,0,-18
2788,0,0,201,0,-201
2789,1,0,68,0,-68
2790,1,0,31,0,-31
2791,1,0,54,0,-54
2792,1,0,31,0,-31
2793,1,1,418,1808,1390
2794,1,0,2,0,-2
2795,1,0,3,0,-3
2796,1,0,7,0,-7
2797,1,1,36,2529,2493
2798,0,0,6,0,-6
2799,0,0,69,0,-69
2800,1,1,45,1578,1533
2801,1,0,2,0,-2
2802,1,1,1442,1274,-168
2803,1,1,115,1597,1482
2804,0,0,240,0,-240
2805,0,0,22,0,-22
2806,1,1,82,1780,1698
2807,0,0,91,0,-91
2808,0,0,120,0,-120
2809,1,1,297,1270,973
2810,1,1,233,1297,1064
2811,1,1,538,1445,907
2812,1,1,159,1363,1204
2813,0,0,52,0,-52
2814,1,0,31,0,-31
2815,1,1,167,2966,2799
2816,0,0,15,0,-15
2817,0,0,146,0,-146
2818,0,0,8,0,-8
2819,0,0,149,0,-149
2820,0,0,8,0,-8
2821,1,0,64,0,-64
2822,0,0,21,0,-21
2823,0,0,81,0,-81
2824,1,0,62,0,-62
2825,1,0,20,0,-20
2826,1,0,1,0,-1
2827,1,1,97,1528,1431
2828,1,0,92,0,-92
2829,0,0,89,0,-89
2830,1,0,154,0,-154
2831,1,0,3,0,-3
2832,0,0,81,0,-81
2833,1,1,473,1968,1495
2834,1,1,617,1290,673
2835,0,0,9,0,-9
2836,1,0,97,0,-97
2837,0,0,3,0,-3
2838,0,0,12,0,-12
2839,1,1,303,2212,1909
2840,0,0,55,0,-55
2841,1,0,6,0,-6
2842,0,0,14,0,-14
2843,1,0,2,0,-2
2844,1,0,116,0,-116
2845,1,0,75,0,-75
2846,1,1,316,1454,1138
2847,1,0,76,0,-76
2848,1,0,47,0,-47
2849,1,1,774,1217,443
2850,1,0,18,0,-18
2851,1,0,247,0,-247
2852,0,0,15,0,-15
2853,0,0,111,0,-111
2854,0,0,34,0,-34
2855,1,0,51,0,-51
2856,0,0,59,0,-59
2857,0,0,33,0,-33
2858,0,0,36,0,-36
2859,1,1,194,1347,1153
2860,0,0,21,0,-21
2861,1,1,574,1228,654
2862,0,0,37,0,-37
2863,0,0,43,0,-43
2864,0,0,34,0,-34
2865,1,1,329,1278,949
2866,1,0,15,0,-15
2867,1,1,721,3634,2913
2868,1,0,61,0,-61
2869,0,0,32,0,-32
2870,1,1,85,1527,1442
2871,1,0,12,0,-12
2872,0,0,3,0,-3
2873,1,0,51,0,-51
2874,0,0,2,0,-2
2875,1,0,23,0,-23
2876,1,1,399,1200,801
2877,1,0,3,0,-3
2878,1,0,2,0,-2
2879,0,0,10,0,-10
2880,1,1,666,1302,636
2881,0,0,41,0,-41
2882,0,0,36,0,-36
2883,1,1,1423,1217,-206
2884,1,1,638,1288,650
2885,1,1,292,1369,1077
2886,0,0,11,0,-11
2887,1,0,26,0,-26
2888,0,0,129,0,-129
2889,1,1,848,2117,1269
2890,1,0,14,0,-14
2891,1,1,408,6087,5679
2892,0,0,59,0,-59
2893,0,0,83,0,-83
2894,0,0,44,0,-44
2895,1,0,97,0,-97
2896,1,0,26,0,-26
2897,0,0,38,0,-38
2898,1,1,65,1207,1142
2899,1,0,21,0,-21
2900,1,0,10,0,-10
2901,1,0,8,0,-8
2902,0,0,63,0,-63
2903,1,0,32,0,-32
2904,1,1,800,1537,737
2905,1,1,490,1617,1127
2906,1,0,71,0,-71
2907,1,1,145,1302,1157
2908,1,0,35,0,-35
2909,0,0,70,0,-70
2910,0,0,26,0,-26
2911,0,0,34,0,-34
2912,1,1,293,2550,2257
2913,0,0,120,0,-120
2914,1,0,87,0,-87
2915,1,0,103,0,-103
2916,0,0,1,0,-1
2917,0,0,133,0,-133
2918,1,1,45,1306,1261
2919,0,0,1,0,-1
2920,0,0,140,0,-140
2921,0,0,153,0,-153
2922,0,0,4,0,-4
2923,1,0,43,0,-43
2924,1,1,284,1239,955
2925,1,1,653,1385,732
2926,1,1,66,1253,1187
2927,0,0,40,0,-40
2928,1,1,637,2631,1994
2929,1,1,1165,2009,844
2930,1,0,7,0,-7
2931,0,0,47,0,-47
2932,1,1,415,1608,1193
2933,1,1,518,2086,1568
2934,0,0,42,0,-42
2935,1,1,428,1521,1093
2936,0,0,177,0,-177
2937,0,0,24,0,-24
2938,1,1,542,1563,1021
2939,0,0,45,0,-45
2940,0,0,57,0,-57
2941,0,0,27,0,-27
2942,1,0,30,0,-30
2943,1,0,4,0,-4
2944,0,0,58,0,-58
2945,1,0,43,0,-43
2946,1,0,54,0,-54
2947,1,1,78,1554,1476
2948,1,0,13,0,-13
2949,1,1,352,1873,1521
2950,1,0,99,0,-99
2951,1,1,929,1497,568
2952,1,1,302,1267,965
2953,0,0,70,0,-70
2954,1,0,51,0,-51
2955,0,0,7,0,-7
2956,0,0,97,0,-97
2957,0,0,37,0,-37
2958,0,0,31,0,-31
2959,0,0,31,0,-31
2960,1,1,95,1498,1403
2961,1,0,138,0,-138
2962,0,0,12,0,-12
2963,1,1,190,1836,1646
2964,1,0,111,0,-111
2965,0,0,47,0,-47
2966,1,0,3,0,-3
2967,1,1,741,1462,721
2968,1,0,1,0,-1
2969,1,1,181,2064,1883
2970,0,0,39,0,-39
2971,1,1,164,1282,1118
2972,1,0,16,0,-16
2973,0,0,0,0,0
2974,0,0,36,0,-36
2975,0,0,0,0,0
2976,1,0,72,0,-72
2977,0,0,56,0,-56
2978,0,0,21,0,-21
2979,1,1,321,1478,1157
2980,1,0,4,0,-4
2981,1,0,12,0,-12
2982,1,1,615,1335,720
2983,1,1,96,1789,1693
2984,0,0,53,0,-53
2985,0,0,84,0,-84
2986,0,0,17,0,-17
2987,1,1,186,1882,1696
2988,0,0,34,0,-34
2989,0,0,31,0,-31
2990,1,1,382,1356,974
2991,1,1,261,1589,1328
2992,0,0,37,0,-37
2993,1,1,135,1925,1790
2994,0,0,99,0,-99
2995,1,1,47,1204,1157
2996,1,1,19,2285,2266
2997,0,0,4,0,-4
2998,1,0,156,0,-156
2999,1,0,49,0,-49
3000,1,0,33,0,-33
3001,1,1,901,1494,593
3002,1,1,1022,1430,408
3003,1,1,313,1477,1164
3004,1,1,69,1212,1143
3005,0,0,163,0,-163
3006,1,1,227,1554,1327
3007,1,1,184,1464,1280
3008,1,0,25,0,-25
3009,0,0,86,0,-86
3010,1,1,369,1571,1202
3011,1,0,56,0,-56
3012,1,1,523,1278,755
3013,0,0,134,0,-134
3014,0,0,12,0,-12
3015,0,0,19,0,-19
3016,1,0,60,0,-60
3017,1,1,841,1350,509
3018,1,1,880,1337,457
3019,1,1,259,1649,1390
3020,1,0,44,0,-44
3021,1,0,51,0,-51
3022,1,0,36,0,-36
3023,1,0,215,0,-215
3024,1,1,709,1202,493
3025,1,0,90,0,-90
3026,0,0,42,0,-42
3027,0,0,63,0,-63
3028,1,0,23,0,-23
3029,0,0,140,0,-140
3030,0,0,36,0,-36
3031,0,0,3,0,-3
3032,0,0,13,0,-13
3033,1,0,26,0,-26
3034,0,0,25,0,-25
3035,1,1,412,1326,914
3036,0,0,6,0,-6
3037,1,0,36,0,-36
3038,1,1,1158,1595,437
3039,0,0,18,0,-18
3040,0,0,18,0,-18
3041,0,0,37,0,-37
3042,0,0,42,0,-42
3043,1,1,997,1382,385
3044,1,1,107,1488,1381
3045,0,0,38,0,-38
3046,1,1,576,1256,680
3047,0,0,31,0,-31
3048,1,1,75,1215,1140
3049,0,0,3,0,-3
3050,1,1,192,1200,1008
3051,1,1,1489,1217,-272
3052,1,1,1325,2616,1291
3053,1,0,5,0,-5
3054,0,0,4,0,-4
3055,0,0,189,0,-189
3056,1,0,78,0,-78
3057,1,1,1117,2080,963
3058,1,0,153,0,-153
3059,1,0,37,0,-37
3060,0,0,50,0,-50
3061,0,0,126,0,-126
3062,1,0,11,0,-11
3063,0,0,56,0,-56
3064,1,1,1184,1357,173
3065,0,0,65,0,-65
3066,1,1,764,1800,1036
3067,1,1,290,1288,998
3068,1,0,14,0,-14
3069,1,1,415,1492,1077
3070,1,0,134,0,-134
3071,1,0,90,0,-90
3072,1,0,15,0,-15
3073,0,0,8,0,-8
3074,1,0,8,0,-8
3075,0,0,23,0,-23
3076,1,0,2,0,-2
3077,1,1,294,1442,1148
3078,1,0,53,0,-53
3079,1,0,22,0,-22
3080,0,0,107,0,-107
3081,0,0,59,0,-59
3082,0,0,43,0,-43
3083,1,1,939,2595,1656
3084,0,0,41,0,-41
3085,0,0,27,0,-27
3086,0,0,10,0,-10
3087,1,0,45,0,-45
3088,0,0,7,0,-7
3089,0,0,26,0,-26
3090,1,0,53,0,-53
3091,0,0,141,0,-141
3092,1,0,0,0,0
3093,0,0,6,0,-6
3094,1,1,593,1366,773
3095,0,0,177,0,-177
3096,1,0,14,0,-14
3097,1,1,865,1214,349
3098,1,0,27,0,-27
3099,1,0,16,0,-16
3100,0,0,160,0,-160
3101,0,0,146,0,-146
3102,0,0,188,0,-188
3103,1,0,246,0,-246
3104,1,0,147,0,-147
3105,0,0,116,0,-116
3106,0,0,131,0,-131
3107,0,0,1,0,-1
3108,1,1,335,1245,910
3109,1,0,16,0,-16
3110,1,0,3,0,-3
3111,1,0,34,0,-34
3112,1,1,873,1270,397
3113,0,0,24,0,-24
3114,0,0,4,0,-4
3115,1,1,132,1366,1234
3116,1,0,81,0,-81
3117,1,1,1416,1346,-70
3118,1,1,90,1805,1715
3119,0,0,16,0,-16
3120,1,0,187,0,-187
3121,1,0,26,0,-26
3122,1,0,6,0,-6
3123,0,0,11,0,-11
3124,1,0,0,0,0
3125,0,0,47,0,-47
3126,0,0,24,0,-24
3127,1,0,106,0,-106
3128,1,1,2114,1372,-742
3129,1,0,23,0,-23
3130,1,1,1371,1473,102
3131,0,0,5,0,-5
3132,0,0,64,0,-64
3133,0,0,97,0,-97
3134,0,0,26,0,-26
3135,1,0,51,0,-51
3136,0,0,55,0,-55
3137,0,0,20,0,-20
3138,0,0,50,0,-50
3139,1,1,471,1228,757
3140,0,0,9,0,-9
3141,0,0,0,0,0
3142,0,0,0,0,0
3143,0,0,14,0,-14
3144,1,0,23,0,-23
3145,1,1,971,1205,234
3146,0,0,254,0,-254
3147,1,1,1134,1228,94
3148,0,0,99,0,-99
3149,1,0,29,0,-29
3150,1,0,54,0,-54
3151,1,0,41,0,-41
3152,0,0,3,0,-3
3153,1,1,1036,1570,534
3154,0,0,66,0,-66
3155,0,0,15,0,-15
3156,0,0,72,0,-72
3157,0,0,0,0,0
3158,1,0,14,0,-14
3159,1,1,269,1353,1084
3160,0,0,113,0,-113
3161,0,0,128,0,-128
3162,0,0,76,0,-76
3163,0,0,41,0,-41
3164,0,0,55,0,-55
3165,0,0,0,0,0
3166,1,0,0,0,0
3167,1,1,1058,1278,220
3168,1,0,19,0,-19
3169,0,0,22,0,-22
3170,0,0,17,0,-17
3171,0,0,33,0,-33
3172,0,0,73,0,-73
3173,1,0,17,0,-17
3174,0,0,41,0,-41
3175,0,0,89,0,-89
3176,0,0,69,0,-69
3177,1,1,165,1323,1158
3178,0,0,9,0,-9
3179,1,0,29,0,-29
3180,1,1,496,1640,1144
3181,0,0,11,0,-11
3182,1,1,252,1575,1323
3183,1,0,19,0,-19
3184,0,0,81,0,-81
3185,1,1,788,1428,640
3186,1,1,100,2004,1904
3187,0,0,35,0,-35
3188,1,0,167,0,-167
3189,1,1,1377,1515,138
3190,1,1,1191,1317,126
3191,1,0,31,0,-31
3192,0,0,129,0,-129
3193,0,0,155,0,-155
3194,1,0,141,0,-141
3195,1,0,27,0,-27
3196,1,1,161,1475,1314
3197,1,0,30,0,-30
3198,0,0,309,0,-309
3199,0,0,193,0,-193
3200,1,0,115,0,-115
3201,1,0,10,0,-10
3202,0,0,74,0,-74
3203,1,1,100,2066,1966
3204,0,0,73,0,-73
3205,0,0,89,0,-89
3206,1,1,61,1493,1432
3207,1,0,6,0,-6
3208,1,0,64,0,-64
3209,1,1,99,1607,1508
3210,0,0,1,0,-1
3211,0,0,1,0,-1
3212,0,0,8,0,-8
3213,1,0,27,0,-27
3214,1,1,887,2728,1841
3215,0,0,182,0,-182
3216,1,0,15,0,-15
3217,1,0,18,0,-18
3218,0,0,35,0,-35
3219,0,0,93,0,-93
3220,1,1,258,1237,979
3221,1,1,523,3739,3216
3222,1,1,102,1301,1199
3223,1,1,1179,1569,390
3224,0,0,41,0,-41
3225,1,0,7,0,-7
3226,1,0,31,0,-31
3227,1,0,88,0,-88
3228,1,1,68,1226,1158
3229,1,1,304,3022,2718
3230,1,1,94,1245,1151
3231,0,0,8,0,-8
3232,0,0,23,0,-23
3233,0,0,13,0,-13
3234,0,0,27,0,-27
3235,1,1,153,1659,1506
3236,1,0,45,0,-45
3237,1,1,131,1307,1176
3238,1,0,46,0,-46
3239,0,0,6,0,-6
3240,1,0,37,0,-37
3241,0,0,51,0,-51
3242,0,0,12,0,-12
3243,1,0,39,0,-39
3244,1,1,401,1314,913
3245,1,0,1,0,-1
3246,0,0,56,0,-56
3247,1,0,37,0,-37
3248,1,0,5,0,-5
3249,1,0,22,0,-22
3250,0,0,45,0,-45
3251,0,0,26,0,-26
3252,0,0,17,0,-17
3253,1,1,156,1335,1179
3254,1,0,94,0,-94
3255,1,0,40,0,-40
3256,1,0,71,0,-71
3257,0,0,6,0,-6
3258,1,0,12,0,-12
3259,0,0,0,0,0
3260,0,0,15,0,-15
3261,1,0,70,0,-70
3262,1,0,134,0,-134
3263,1,0,10,0,-10
3264,1,1,143,1382,1239
3265,0,0,33,0,-33
3266,1,1,2643,1218,-1425
3267,1,0,27,0,-27
3268,1,1,156,1256,1100
3269,0,0,76,0,-76
3270,1,1,367,2528,2161
3271,0,0,15,0,-15
3272,0,0,95,0,-95
3273,0,0,138,0,-138
3274,1,1,264,1400,1136
3275,1,1,382,2222,1840
3276,0,0,63,0,-63
3277,0,0,71,0,-71
3278,1,0,47,0,-47
3279,1,1,240,1319,1079
3280,0,0,30,0,-30
3281,1,0,30,0,-30
3282,1,0,4,0,-4
3283,0,0,64,0,-64
3284,0,0,2,0,-2
3285,0,0,133,0,-133
3286,1,0,65,0,-65
3287,0,0,48,0,-48
3288,1,1,1050,2125,1075
3289,1,0,31,0,-31
3290,1,1,113,2297,2184
3291,1,0,63,0,-63
3292,1,0,8,0,-8
3293,0,0,143,0,-143
3294,0,0,66,0,-66
3295,1,0,66,0,-66
3296,0,0,45,0,-45
3297,0,0,45,0,-45
3298,1,1,582,1329,747
3299,1,1,689,1846,1157
3300,0,0,10,0,-10
3301,1,1,1111,1229,118
3302,0,0,1,0,-1
3303,0,0,7,0,-7
3304,1,0,16,0,-16
3305,1,1,221,3833,3612
3306,0,0,2,0,-2
3307,1,1,167,1220,1053
3308,0,0,34,0,-34
3309,1,0,25,0,-25
3310,1,0,27,0,-27
3311,1,0,167,0,-167
3312,1,1,127,1930,1803
3313,1,1,423,1214,791
3314,1,1,742,1360,618
3315,1,0,38,0,-38
3316,1,0,45,0,-45
3317,1,0,7,0,-7
3318,0,0,7,0,-7
3319,1,0,77,0,-77
3320,0,0,17,0,-17
3321,1,0,45,0,-45
3322,0,0,89,0,-89
3323,0,0,2,0,-2
3324,0,0,26,0,-26
3325,1,0,143,0,-143
3326,0,0,18,0,-18
3327,0,0,58,0,-58
3328,1,0,4,0,-4
3329,0,0,15,0,-15
3330,0,0,82,0,-82
3331,1,1,536,1652,1116
3332,0,0,20,0,-20
3333,1,1,41,1324,1283
3334,1,1,612,1459,847
3335,1,0,18,0,-18
3336,1,0,101,0,-101
3337,0,0,177,0,-177
3338,1,1,442,1779,1337
3339,1,1,494,1351,857
3340,0,0,166,0,-166
3341,0,0,185,0,-185
3342,1,1,705,1379,674
3343,1,1,1535,2100,565
3344,1,1,425,1332,907
3345,1,0,49,0,-49
3346,1,1,267,1398,1131
3347,1,1,317,1716,1399
3348,1,1,662,1271,609
3349,1,0,109,0,-109
3350,1,0,21,0,-21
3351,0,0,1,0,-1
3352,1,0,44,0,-44
3353,0,0,29,0,-29
3354,1,1,1565,2174,609
3355,1,1,515,1339,824
3356,0,0,29,0,-29
3357,0,0,139,0,-139
3358,0,0,0,0,0
3359,0,0,68,0,-68
3360,1,1,354,1309,955
3361,0,0,80,0,-80
3362,0,0,47,0,-47
3363,0,0,22,0,-22
3364,1,0,56,0,-56
3365,0,0,32,0,-32
3366,1,0,74,0,-74
3367,1,0,21,0,-21
3368,0,0,5,0,-5
3369,0,0,11,0,-11
3370,0,0,5,0,-5
3371,1,1,2102,1233,-869
3372,1,1,400,1206,806
3373,1,1,447,1454,1007
3374,0,0,14,0,-14
3375,1,1,270,1446,1176
3376,1,0,9,0,-9
3377,1,0,96,0,-96
3378,1,1,1058,1274,216
3379,0,0,172,0,-172
3380,1,0,58,0,-58
3381,1,0,20,0,-20
3382,0,0,59,0,-59
3383,1,1,392,2142,1750
3384,1,1,2162,4537,2375
3385,1,1,119,1478,1359
3386,0,0,17,0,-17
3387,0,0,65,0,-65
3388,1,0,90,0,-90
3389,0,0,37,0,-37
3390,1,1,108,1372,1264
3391,0,0,32,0,-32
3392,0,0,18,0,-18
3393,1,1,403,1475,1072
3394,1,1,520,2464,1944
3395,0,0,21,0,-21
3396,1,1,429,1215,786
3397,1,0,1,0,-1
3398,1,0,65,0,-65
3399,1,0,2,0,-2
3400,1,1,714,1356,642
3401,1,1,73,1367,1294
3402,1,1,376,1244,868
3403,1,0,38,0,-38
3404,1,1,651,2011,1360
3405,0,0,42,0,-42
3406,0,0,4,0,-4
3407,0,0,14,0,-14
3408,1,0,2,0,-2
3409,1,1,147,1726,1579
3410,0,0,9,0,-9
3411,0,0,4,0,-4
3412,1,0,10,0,-10
3413,1,1,329,1337,1008
3414,0,0,24,0,-24
3415,0,0,21,0,-21
3416,1,1,328,1439,1111
3417,0,0,50,0,-50
3418,1,1,855,1280,425
3419,1,1,238,2212,1974
3420,1,1,1449,1396,-53
3421,1,1,1164,1299,135
3422,0,0,9,0,-9
3423,0,0,22,0,-22
3424,0,0,25,0,-25
3425,1,0,104,0,-104
3426,1,1,448,2316,1868
3427,0,0,41,0,-41
3428,1,1,677,2267,1590
3429,0,0,19,0,-19
3430,1,1,444,1259,815
3431,0,0,184,0,-184
3432,1,0,3,0,-3
3433,1,1,28,1252,1224
3434,1,1,90,1575,1485
3435,1,1,1113,1380,267
3436,0,0,52,0,-52
3437,1,1,1453,1366,-87
3438,0,0,137,0,-137
3439,1,0,9,0,-9
3440,1,1,292,1218,926
3441,0,0,20,0,-20
3442,0,0,80,0,-80
3443,1,1,67,1381,1314
3444,1,1,650,1214,564
3445,1,0,26,0,-26
3446,1,0,44,0,-44
3447,1,1,1007,1443,436
3448,1,0,13,0,-13
3449,0,0,63,0,-63
3450,1,0,4,0,-4
3451,0,0,40,0,-40
3452,1,1,528,1748,1220
3453,1,0,88,0,-88
3454,0,0,9,0,-9
3455,1,1,499,1319,820
3456,0,0,119,0,-119
3457,1,1,577,1712,1135
3458,1,0,55,0,-55
3459,0,0,46,0,-46
3460,1,0,117,0,-117
3461,1,1,196,1372,1176
3462,1,0,86,0,-86
3463,0,0,67,0,-67
3464,0,0,88,0,-88
3465,0,0,96,0,-96
3466,1,1,1547,1281,-266
3467,1,1,464,1531,1067
3468,1,1,242,1225,983
3469,1,1,384,1365,981
3470,1,0,9,0,-9
3471,0,0,24,0,-24
3472,0,0,2,0,-2
3473,1,0,6,0,-6
3474,1,1,41,1213,1172
3475,1,1,47,2234,2187
3476,1,0,3,0,-3
3477,1,0,22,0,-22
3478,0,0,31,0,-31
3479,0,0,195,0,-195
3480,0,0,19,0,-19
3481,1,1,108,2239,2131
3482,1,1,280,1587,1307
3483,0,0,45,0,-45
3484,1,0,2,0,-2
3485,1,0,94,0,-94
3486,1,0,67,0,-67
3487,0,0,69,0,-69
3488,1,1,927,1296,369
3489,1,0,13,0,-13
3490,0,0,52,0,-52
3491,1,1,663,1448,785
3492,0,0,31,0,-31
3493,1,1,327,1205,878
3494,0,0,110,0,-110
3495,1,1,238,1243,1005
3496,1,0,14,0,-14
3497,1,1,1008,1229,221
3498,1,0,36,0,-36
3499,1,1,481,1262,781
3500,0,0,12,0,-12
3501,1,0,16,0,-16
3502,1,1,595,1385,790
3503,1,1,174,1389,1215
3504,1,0,133,0,-133
3505,0,0,27,0,-27
3506,1,1,2029,1761,-268
3507,0,0,2,0,-2
3508,1,1,803,1217,414
3509,0,0,29,0,-29
3510,0,0,23,0,-23
3511,1,1,571,1318,747
3512,1,0,75,0,-75
3513,1,0,91,0,-91
3514,0,0,90,0,-90
3515,1,1,391,1259,868
3516,1,0,14,0,-14
3517,0,0,182,0,-182
3518,1,1,249,1447,1198
3519,1,0,11,0,-11
3520,1,0,11,0,-11
3521,0,0,181,0,-181
3522,0,0,24,0,-24
3523,1,1,1984,1233,-751
3524,0,0,3,0,-3
3525,0,0,52,0,-52
3526,0,0,1,0,-1
3527,1,1,331,1704,1373
3528,0,0,155,0,-155
3529,1,1,130,1628,1498
3530,0,0,18,0,-18
3531,1,0,134,0,-134
3532,1,0,21,0,-21
3533,1,0,48,0,-48
3534,0,0,38,0,-38
3535,0,0,30,0,-30
3536,1,1,530,1387,857
3537,0,0,14,0,-14
3538,1,0,3,0,-3
3539,1,0,89,0,-89
3540,0,0,115,0,-115
3541,1,1,735,1388,653
3542,0,0,121,0,-121
3543,1,0,113,0,-113
3544,1,0,1,0,-1
3545,1,1,249,1432,1183
3546,1,1,2073,2251,178
3547,1,0,110,0,-110
3548,1,0,98,0,-98
3549,1,1,207,1975,1768
3550,1,0,52,0,-52
3551,0,0,27,0,-27
3552,1,1,207,1439,1232
3553,0,0,52,0,-52
3554,0,0,70,0,-70
3555,1,0,35,0,-35
3556,0,0,12,0,-12
3557,1,0,86,0,-86
3558,0,0,33,0,-33
3559,1,1,472,2302,1830
3560,0,0,20,0,-20
3561,0,0,72,0,-72
3562,1,1,343,1690,1347
3563,1,0,144,0,-144
3564,0,0,20,0,-20
3565,1,1,177,1290,1113
3566,1,0,56,0,-56
3567,0,0,7,0,-7
3568,0,0,9,0,-9
3569,1,0,23,0,-23
3570,0,0,19,0,-19
3571,1,0,18,0,-18
3572,0,0,42,0,-42
3573,1,1,335,1604,1269
3574,0,0,61,0,-61
3575,1,1,1082,1561,479
3576,0,0,157,0,-157
3577,1,1,1192,1468,276
3578,0,0,23,0,-23
3579,1,0,41,0,-41
3580,1,0,37,0,-37
3581,0,0,0,0,0
3582,1,0,11,0,-11
3583,0,0,82,0,-82
3584,0,0,21,0,-21
3585,0,0,147,0,-147
3586,0,0,156,0,-156
3587,1,1,504,1713,1209
3588,1,1,217,1234,1017
3589,1,0,77,0,-77
3590,1,0,103,0,-103
3591,1,0,61,0,-61
3592,1,0,193,0,-193
3593,0,0,2,0,-2
3594,1,0,81,0,-81
3595,1,1,1069,1529,460
3596,1,1,397,1209,812
3597,1,0,281,0,-281
3598,0,0,10,0,-10
3599,0,0,0,0,0
3600,1,0,64,0,-64
3601,1,0,166,0,-166
3602,1,1,344,1557,1213
3603,1,1,822,1337,515
3604,1,1,1317,1774,457
3605,1,1,128,1316,1188
3606,0,0,47,0,-47
3607,1,0,9,0,-9
3608,1,1,317,1331,1014
3609,0,0,52,0,-52
3610,1,1,306,1268,962
3611,1,0,39,0,-39
3612,0,0,52,0,-52
3613,1,0,14,0,-14
3614,1,1,461,2057,1596
3615,1,0,13,0,-13
3616,1,1,255,1355,1100
3617,1,1,85,1397,1312
3618,0,0,88,0,-88
3619,0,0,26,0,-26
3620,0,0,25,0,-25
3621,1,0,52,0,-52
3622,0,0,41,0,-41
3623,1,0,55,0,-55
3624,1,1,311,1310,999
3625,0,0,138,0,-138
3626,1,0,29,0,-29
3627,1,0,165,0,-165
3628,1,1,416,1228,812
3629,1,1,309,1541,1232
3630,0,0,64,0,-64
3631,1,1,415,1892,1477
3632,1,0,8,0,-8
3633,0,0,7,0,-7
3634,1,1,431,4120,3689
3635,1,0,138,0,-138
3636,0,0,34,0,-34
3637,1,1,2028,1893,-135
3638,0,0,25,0,-25
3639,0,0,20,0,-20
3640,0,0,127,0,-127
3641,1,1,471,1262,791
3642,1,1,184,1210,1026
3643,0,0,53,0,-53
3644,1,0,46,0,-46
3645,1,1,2275,1235,-1040
3646,1,0,6,0,-6
3647,0,0,35,0,-35
3648,0,0,18,0,-18
3649,0,0,55,0,-55
3650,1,1,454,1580,1126
3651,0,0,103,0,-103
3652,1,1,150,1235,1085
3653,1,0,8,0,-8
3654,0,0,8,0,-8
3655,1,0,46,0,-46
3656,1,1,1429,1403,-26
3657,1,1,766,1226,460
3658,0,0,32,0,-32
3659,1,0,32,0,-32
3660,0,0,9,0,-9
3661,1,0,61,0,-61
3662,1,0,27,0,-27
3663,0,0,47,0,-47
3664,1,0,7,0,-7
3665,1,0,42,0,-42
3666,0,0,47,0,-47
3667,1,1,375,1420,1045
3668,1,0,39,0,-39
3669,1,0,15,0,-15
3670,0,0,100,0,-100
3671,1,1,329,1304,975
3672,1,0,21,0,-21
3673,1,1,471,1204,733
3674,0,0,49,0,-49
3675,0,0,15,0,-15
3676,1,1,1466,1364,-102
3677,1,1,337,1207,870
3678,1,0,128,0,-128
3679,1,1,1300,1268,-32
3680,1,0,18,0,-18
3681,1,1,211,1663,1452
3682,0,0,80,0,-80
3683,1,0,10,0,-10
3684,1,1,1446,1276,-170
3685,1,1,206,1614,1408
3686,0,0,47,0,-47
3687,0,0,14,0,-14
3688,1,1,40,1438,1398
3689,0,0,16,0,-16
3690,0,0,85,0,-85
3691,0,0,49,0,-49
3692,0,0,18,0,-18
3693,0,0,6,0,-6
3694,1,1,116,1589,1473
3695,0,0,32,0,-32
3696,0,0,15,0,-15
3697,1,1,765,1257,492
3698,1,0,30,0,-30
3699,1,1,174,1452,1278
3700,0,0,223,0,-223
3701,1,0,3,0,-3
3702,0,0,98,0,-98
3703,1,0,64,0,-64
3704,1,0,32,0,-32
3705,1,0,14,0,-14
3706,1,0,106,0,-106
3707,0,0,35,0,-35
3708,1,0,36,0,-36
3709,1,1,348,1379,1031
3710,0,0,90,0,-90
3711,1,0,67,0,-67
3712,1,0,175,0,-175
3713,0,0,12,0,-12
3714,1,1,976,1253,277
3715,1,0,67,0,-67
3716,1,0,28,0,-28
3717,0,0,175,0,-175
3718,0,0,11,0,-11
3719,1,0,3,0,-3
3720,1,0,78,0,-78
3721,1,0,70,0,-70
3722,1,0,20,0,-20
3723,0,0,27,0,-27
3724,1,1,344,1205,861
3725,1,1,142,1747,1605
3726,0,0,21,0,-21
3727,1,1,527,1276,749
3728,1,1,882,1377,495
3729,1,1,632,1548,916
3730,1,1,198,1264,1066
3731,0,0,20,0,-20
3732,0,0,23,0,-23
3733,1,0,46,0,-46
3734,1,0,48,0,-48
3735,0,0,17,0,-17
3736,1,0,93,0,-93
3737,1,0,32,0,-32
3738,1,0,57,0,-57
3739,1,0,8,0,-8
3740,1,1,414,1381,967
3741,0,0,100,0,-100
3742,0,0,17,0,-17
3743,1,1,1020,1326,306
3744,1,0,236,0,-236
3745,1,1,2086,1569,-517
3746,1,0,26,0,-26
3747,0,0,132,0,-132
3748,1,0,20,0,-20
3749,1,1,2103,1287,-816
3750,0,0,7,0,-7
3751,1,0,28,0,-28
3752,0,0,14,0,-14
3753,0,0,60,0,-60
3754,1,0,20,0,-20
3755,0,0,87,0,-87
3756,1,0,70,0,-70
3757,0,0,9,0,-9
3758,1,1,205,1411,1206
3759,1,0,20,0,-20
3760,1,0,56,0,-56
3761,0,0,30,0,-30
3762,0,0,6,0,-6
3763,1,1,385,2640,2255
3764,0,0,20,0,-20
3765,0,0,25,0,-25
3766,1,1,475,1423,948
3767,0,0,68,0,-68
3768,0,0,18,0,-18
3769,0,0,22,0,-22
3770,0,0,4,0,-4
3771,1,0,50,0,-50
3772,1,0,35,0,-35
3773,1,1,459,1599,1140
3774,1,0,109,0,-109
3775,1,1,374,3399,3025
3776,1,1,1032,1388,356
3777,0,0,126,0,-126
3778,0,0,114,0,-114
3779,1,0,38,0,-38
3780,1,0,2,0,-2
3781,1,1,313,1308,995
3782,1,1,558,1426,868
3783,0,0,88,0,-88
3784,1,1,174,1237,1063
3785,0,0,10,0,-10
3786,1,0,13,0,-13
3787,0,0,12,0,-12
3788,0,0,32,0,-32
3789,0,0,74,0,-74
3790,1,0,148,0,-148
3791,0,0,46,0,-46
3792,0,0,21,0,-21
3793,1,0,39,0,-39
3794,1,0,214,0,-214
3795,1,0,15,0,-15
3796,1,1,2573,2242,-331
3797,1,0,6,0,-6
3798,1,1,471,1225,754
3799,1,1,1096,1339,243
3800,1,1,56,2101,2045
3801,0,0,10,0,-10
3802,0,0,24,0,-24
3803,0,0,91,0,-91
3804,1,1,93,1539,1446
3805,0,0,4,0,-4
3806,1,1,820,1309,489
3807,0,0,161,0,-161
3808,1,0,14,0,-14
3809,1,1,649,1428,779
3810,1,0,2,0,-2
3811,0,0,58,0,-58
3812,1,0,26,0,-26
3813,1,1,294,1735,1441
3814,1,0,2,0,-2
3815,0,0,10,0,-10
3816,1,0,12,0,-12
3817,0,0,165,0,-165
3818,1,0,83,0,-83
3819,1,1,1746,4590,2844
3820,1,0,74,0,-74
3821,0,0,1,0,-1
3822,1,1,613,1200,587
3823,0,0,89,0,-89
3824,0,0,142,0,-142
3825,1,0,2,0,-2
3826,1,0,123,0,-123
3827,0,0,12,0,-12
3828,1,0,0,0,0
3829,0,0,28,0,-28
3830,1,0,43,0,-43
3831,0,0,108,0,-108
3832,1,0,50,0,-50
3833,0,0,29,0,-29
3834,1,0,89,0,-89
3835,0,0,45,0,-45
3836,0,0,50,0,-50
3837,0,0,54,0,-54
3838,1,1,764,1336,572
3839,0,0,79,0,-79
3840,1,0,52,0,-52
3841,1,1,24,1247,1223
3842,1,0,39,0,-39
3843,0,0,0,0,0
3844,1,1,249,2523,2274
3845,0,0,40,0,-40
3846,0,0,15,0,-15
3847,0,0,43,0,-43
3848,1,1,326,1329,1003
3849,1,0,76,0,-76
3850,0,0,100,0,-100
3851,0,0,115,0,-115
3852,0,0,75,0,-75
3853,1,1,86,1935,1849
3854,0,0,125,0,-125
3855,0,0,40,0,-40
3856,0,0,0,0,0
3857,1,1,202,1297,1095
3858,1,1,355,1236,881
3859,1,1,82,1433,1351
3860,1,1,202,1367,1165
3861,1,0,0,0,0
3862,1,0,53,0,-53
3863,0,0,31,0,-31
3864,0,0,26,0,-26
3865,1,0,9,0,-9
3866,1,1,558,1697,1139
3867,0,0,1,0,-1
3868,1,1,382,1424,1042
3869,1,0,14,0,-14
3870,0,0,15,0,-15
3871,0,0,22,0,-22
3872,1,0,33,0,-33
3873,1,0,33,0,-33
3874,1,0,159,0,-159
3875,1,1,104,1208,1104
3876,0,0,64,0,-64
3877,1,0,21,0,-21
3878,0,0,65,0,-65
3879,0,0,134,0,-134
3880,0,0,59,0,-59
3881,0,0,38,0,-38
3882,1,1,340,1239,899
3883,1,1,597,1374,777
3884,1,0,81,0,-81
3885,0,0,14,0,-14
3886,0,0,16,0,-16
3887,0,0,17,0,-17
3888,0,0,18,0,-18
3889,1,1,128,1237,1109
3890,0,0,16,0,-16
3891,1,0,37,0,-37
3892,1,0,39,0,-39
3893,0,0,61,0,-61
3894,1,0,25,0,-25
3895,0,0,19,0,-19
3896,1,1,598,1313,715
3897,1,0,61,0,-61
3898,0,0,18,0,-18
3899,1,1,367,1343,976
3900,0,0,1,0,-1
3901,1,1,615,1514,899
3902,1,1,960,1222,262
3903,1,0,52,0,-52
3904,1,0,3,0,-3
3905,0,0,15,0,-15
3906,1,0,99,0,-99
3907,0,0,1,0,-1
3908,1,1,806,2566,1760
3909,0,0,114,0,-114
3910,1,1,205,1430,1225
3911,1,0,124,0,-124
3912,0,0,122,0,-122
3913,1,0,10,0,-10
3914,1,0,2,0,-2
3915,0,0,22,0,-22
3916,1,0,19,0,-19
3917,0,0,55,0,-55
3918,0,0,6,0,-6
3919,1,1,211,2619,2408
3920,1,0,151,0,-151
3921,1,1,1146,1218,72
3922,1,1,849,1241,392
3923,0,0,54,0,-54
3924,1,0,22,0,-22
3925,1,1,220,1319,1099
3926,0,0,56,0,-56
3927,0,0,125,0,-125
3928,0,0,1,0,-1
3929,1,0,13,0,-13
3930,1,1,1990,1993,3
3931,0,0,14,0,-14
3932,0,0,61,0,-61
3933,0,0,23,0,-23
3934,0,0,32,0,-32
3935,1,0,41,0,-41
3936,0,0,105,0,-105
3937,1,1,349,1228,879
3938,0,0,29,0,-29
3939,1,0,62,0,-62
3940,1,1,668,1246,578
3941,1,0,18,0,-18
3942,1,0,9,0,-9
3943,1,0,149,0,-149
3944,0,0,148,0,-148
3945,1,0,2,0,-2
3946,1,0,0,0,0
3947,0,0,12,0,-12
3948,1,1,705,1230,525
3949,0,0,40,0,-40
3950,1,1,1045,1395,350
3951,0,0,31,0,-31
3952,0,0,21,0,-21
3953,1,1,725,1604,879
3954,1,0,59,0,-59
3955,0,0,42,0,-42
3956,1,0,6,0,-6
3957,1,0,14,0,-14
3958,1,1,496,1599,1103
3959,1,0,16,0,-16
3960,0,0,23,0,-23
3961,0,0,36,0,-36
3962,1,0,78,0,-78
3963,1,0,11,0,-11
3964,0,0,50,0,-50
3965,0,0,28,0,-28
3966,1,0,5,0,-5
3967,1,1,696,1773,1077
3968,1,0,35,0,-35
3969,1,1,1883,1518,-365
3970,0,0,51,0,-51
3971,1,1,445,1461,1016
3972,0,0,30,0,-30
3973,1,0,82,0,-82
3974,1,1,139,1409,1270
3975,1,0,117,0,-117
3976,0,0,38,0,-38
3977,1,1,2036,1353,-683
3978,0,0,48,0,-48
3979,1,0,21,0,-21
3980,1,1,274,1846,1572
3981,0,0,59,0,-59
3982,1,0,35,0,-35
3983,0,0,25,0,-25
3984,1,1,79,1414,1335
3985,1,1,399,1389,990
3986,1,0,32,0,-32
3987,0,0,124,0,-124
3988,1,1,160,1325,1165
3989,1,0,10,0,-10
3990,0,0,25,0,-25
3991,0,0,7,0,-7
3992,1,1,170,3387,3217
3993,1,0,80,0,-80
3994,0,0,118,0,-118
3995,0,0,7,0,-7
3996,1,0,116,0,-116
3997,1,0,61,0,-61
3998,1,0,6,0,-6
3999,1,0,51,0,-51
4000,1,1,816,1706,890
4001,1,0,84,0,-84
4002,1,1,27,1423,1396
4003,1,0,178,0,-178
4004,0,0,28,0,-28
4005,0,0,38,0,-38
4006,0,0,193,0,-193
4007,0,0,43,0,-43
4008,1,1,183,1200,1017
4009,1,0,11,0,-11
4010,1,0,8,0,-8
4011,0,0,106,0,-106
4012,1,0,37,0,-37
4013,1,0,145,0,-145
4014,1,0,7,0,-7
4015,1,0,24,0,-24
4016,0,0,143,0,-143
4017,0,0,0,0,0
4018,0,0,55,0,-55
4019,1,0,1,0,-1
4020,1,0,159,0,-159
4021,1,0,33,0,-33
4022,0,0,105,0,-105
4023,0,0,27,0,-27
4024,0,0,33,0,-33
4025,1,1,946,1280,334
4026,1,0,7,0,-7
4027,1,1,363,1553,1190
4028,0,0,3,0,-3
4029,1,1,18,1813,1795
4030,1,0,104,0,-104
4031,0,0,76,0,-76
4032,0,0,51,0,-51
4033,1,0,23,0,-23
4034,1,1,251,1351,1100
4035,1,0,15,0,-15
4036,1,1,265,1259,994
4037,0,0,10,0,-10
4038,1,0,129,0,-129
4039,0,0,42,0,-42
4040,0,0,30,0,-30
4041,1,0,47,0,-47
4042,0,0,33,0,-33
4043,0,0,35,0,-35
4044,0,0,57,0,-57
4045,0,0,1,0,-1
4046,1,1,2229,1745,-484
4047,0,0,87,0,-87
4048,1,0,7,0,-7
4049,1,1,1167,3854,2687
4050,1,0,4,0,-4
4051,1,1,587,1262,675
4052,1,1,408,1330,922
4053,0,0,76,0,-76
4054,1,1,353,1544,1191
4055,0,0,72,0,-72
4056,1,0,44,0,-44
4057,1,1,310,1397,1087
4058,1,0,26,0,-26
4059,1,1,770,1283,513
4060,1,0,84,0,-84
4061,0,0,35,0,-35
4062,1,1,397,1587,1190
4063,1,1,322,2337,2015
4064,1,0,34,0,-34
4065,1,0,57,0,-57
4066,1,0,29,0,-29
4067,0,0,41,0,-41
4068,1,0,43,0,-43
4069,0,0,38,0,-38
4070,0,0,27,0,-27
4071,1,1,327,1409,1082
4072,0,0,22,0,-22
4073,1,0,12,0,-12
4074,0,0,66,0,-66
4075,1,0,36,0,-36
4076,0,0,64,0,-64
4077,1,1,119,1249,1130
4078,1,0,64,0,-64
4079,1,0,89,0,-89
4080,1,0,76,0,-76
4081,0,0,24,0,-24
4082,0,0,121,0,-121
4083,1,0,51,0,-51
4084,1,0,75,0,-75
4085,0,0,119,0,-119
4086,1,1,62,1746,1684
4087,1,1,687,1511,824
4088,0,0,39,0,-39
4089,1,1,370,3909,3539
4090,1,0,158,0,-158
4091,1,0,52,0,-52
4092,1,1,33,1222,1189
4093,1,0,127,0,-127
4094,1,0,65,0,-65
4095,1,0,190,0,-190
4096,0,0,219,0,-219
4097,1,0,68,0,-68
4098,0,0,38,0,-38
4099,1,1,138,1681,1543
4100,0,0,214,0,-214
4101,0,0,13,0,-13
4102,0,0,120,0,-120
4103,1,1,213,1341,1128
4104,0,0,22,0,-22
4105,1,0,47,0,-47
4106,0,0,32,0,-32
4107,1,0,46,0,-46
4108,1,1,44,1281,1237
4109,1,1,769,1521,752
4110,0,0,4,0,-4
4111,0,0,167,0,-167
4112,1,1,788,1295,507
4113,0,0,51,0,-51
4114,0,0,67,0,-67
4115,1,0,155,0,-155
4116,1,0,102,0,-102
4117,0,0,215,0,-215
4118,1,1,254,1422,1168
4119,1,0,56,0,-56
4120,1,1,868,2102,1234
4121,0,0,106,0,-106
4122,0,0,28,0,-28
4123,1,0,29,0,-29
4124,0,0,108,0,-108
4125,0,0,45,0,-45
4126,0,0,126,0,-126
4127,0,0,28,0,-28
4128,1,1,1316,1620,304
4129,1,1,825,1264,439
4130,1,0,11,0,-11
4131,1,1,232,1832,1600
4132,1,1,1102,1330,228
4133,1,1,370,1543,1173
4134,0,0,42,0,-42
4135,1,0,1,0,-1
4136,1,1,715,1626,911
4137,1,1,197,1780,1583
4138,1,1,1033,1221,188
4139,1,1,312,1209,897
4140,0,0,55,0,-55
4141,1,0,78,0,-78
4142,1,0,40,0,-40
4143,0,0,136,0,-136
4144,1,1,359,1267,908
4145,0,0,81,0,-81
4146,1,0,44,0,-44
4147,0,0,52,0,-52
4148,1,1,359,1264,905
4149,1,0,52,0,-52
4150,0,0,22,0,-22
4151,0,0,18,0,-18
4152,0,0,82,0,-82
4153,0,0,0,0,0
4154,1,1,709,1685,976
4155,0,0,16,0,-16
4156,1,0,68,0,-68
4157,1,0,43,0,-43
4158,0,0,11,0,-11
4159,1,1,902,1327,425
4160,1,0,60,0,-60
4161,1,0,94,0,-94
4162,0,0,62,0,-62
4163,1,1,505,1271,766
4164,0,0,18,0,-18
4165,1,1,445,1559,1114
4166,1,1,181,1326,1145
4167,1,1,272,1206,934
4168,0,0,68,0,-68
4169,0,0,54,0,-54
4170,1,1,474,1502,1028
4171,0,0,135,0,-135
4172,0,0,50,0,-50
4173,1,1,318,4326,4008
4174,1,1,348,1488,1140
4175,1,0,64,0,-64
4176,1,1,479,1252,773
4177,1,0,4,0,-4
4178,0,0,22,0,-22
4179,1,0,11,0,-11
4180,0,0,50,0,-50
4181,0,0,85,0,-85
4182,1,0,44,0,-44
4183,1,0,56,0,-56
4184,1,1,2204,2544,340
4185,1,0,111,0,-111
4186,1,0,115,0,-115
4187,1,1,538,1252,714
4188,0,0,51,0,-51
4189,1,0,3,0,-3
4190,1,0,144,0,-144
4191,1,0,2,0,-2
4192,0,0,91,0,-91
4193,1,1,411,1202,791
4194,0,0,16,0,-16
4195,0,0,27,0,-27
4196,0,0,57,0,-57
4197,0,0,35,0,-35
4198,0,0,73,0,-73
4199,1,1,541,3227,2686
4200,1,1,325,1241,916
4201,1,1,1811,2223,412
4202,1,1,401,1512,1111
4203,1,1,401,1227,826
4204,1,1,854,1234,380
4205,1,1,496,2423,1927
4206,1,0,42,0,-42
4207,1,1,729,1342,613
4208,0,0,61,0,-61
4209,1,0,163,0,-163
4210,1,1,97,1452,1355
4211,0,0,66,0,-66
4212,1,0,60,0,-60
4213,0,0,17,0,-17
4214,1,0,5,0,-5
4215,1,0,49,0,-49
4216,1,0,34,0,-34
4217,0,0,43,0,-43
4218,1,1,1449,1270,-179
4219,0,0,39,0,-39
4220,1,1,858,1561,703
4221,1,1,268,1308,1040
4222,1,1,570,1315,745
4223,0,0,82,0,-82
4224,1,1,149,1917,1768
4225,0,0,81,0,-81
4226,0,0,32,0,-32
4227,1,1,108,1692,1584
4228,1,1,387,1224,837
4229,1,0,38,0,-38
4230,1,1,1060,2121,1061
4231,0,0,12,0,-12
4232,0,0,25,0,-25
4233,0,0,78,0,-78
4234,1,1,181,1210,1029
4235,1,0,15,0,-15
4236,1,1,856,1241,385
4237,1,0,29,0,-29
4238,1,0,67,0,-67
4239,1,1,92,1227,1135
4240,1,1,238,1836,1598
4241,1,0,70,0,-70
4242,0,0,58,0,-58
4243,1,1,359,2186,1827
4244,1,0,153,0,-153
4245,1,0,3,0,-3
4246,0,0,80,0,-80
4247,1,1,299,1776,1477
4248,1,0,3,0,-3
4249,1,0,5,0,-5
4250,1,1,505,1304,799
4251,0,0,3,0,-3
4252,0,0,19,0,-19
4253,1,0,4,0,-4
4254,1,1,173,1663,1490
4255,0,0,8,0,-8
4256,1,0,44,0,-44
4257,0,0,5,0,-5
4258,1,0,245,0,-245
4259,0,0,9,0,-9
4260,1,1,223,1607,1384
4261,1,0,24,0,-24
4262,0,0,20,0,-20
4263,0,0,194,0,-194
4264,1,0,7,0,-7
4265,1,1,1017,1248,231
4266,1,1,369,1375,1006
4267,0,0,5,0,-5
4268,0,0,58,0,-58
4269,1,0,50,0,-50
4270,1,0,5,0,-5
4271,1,1,221,1288,1067
4272,1,0,6,0,-6
4273,0,0,44,0,-44
4274,0,0,240,0,-240
4275,1,0,57,0,-57
4276,0,0,22,0,-22
4277,1,1,565,1268,703
4278,0,0,14,0,-14
4279,1,0,51,0,-51
4280,1,0,104,0,-104
4281,0,0,197,0,-197
4282,1,1,617,1211,594
4283,1,1,313,1255,942
4284,1,1,223,1211,988
4285,0,0,34,0,-34
4286,0,0,26,0,-26
4287,1,1,191,1896,1705
4288,1,0,30,0,-30
4289,1,1,259,1400,1141
4290,1,0,19,0,-19
4291,1,0,25,0,-25
4292,1,0,49,0,-49
4293,0,0,39,0,-39
4294,1,1,264,1223,959
4295,0,0,69,0,-69
4296,1,1,209,1406,1197
4297,1,1,489,1267,778
4298,1,1,261,1233,972
4299,0,0,6,0,-6
4300,1,0,74,0,-74
4301,0,0,109,0,-109
4302,1,0,26,0,-26
4303,1,1,1036,1928,892
4304,0,0,21,0,-21
4305,1,1,352,1323,971
4306,0,0,151,0,-151
4307,1,1,1542,2143,601
4308,1,1,286,1205,919
4309,1,1,743,1475,732
4310,1,0,56,0,-56
4311,0,0,20,0,-20
4312,1,0,2,0,-2
4313,0,0,3,0,-3
4314,1,1,243,1370,1127
4315,1,0,43,0,-43
4316,0,0,47,0,-47
4317,1,0,14,0,-14
4318,1,1,149,1299,1150
4319,1,1,118,1423,1305
4320,1,0,42,0,-42
4321,1,1,252,1503,1251
4322,0,0,19,0,-19
4323,1,1,86,1371,1285
4324,1,1,83,1851,1768
4325,1,1,181,1244,1063
4326,1,0,0,0,0
4327,0,0,66,0,-66
4328,0,0,42,0,-42
4329,1,1,500,1239,739
4330,0,0,65,0,-65
4331,1,0,47,0,-47
4332,1,1,45,1223,1178
4333,1,0,26,0,-26
4334,1,1,1270,1264,-6
4335,0,0,43,0,-43
4336,0,0,103,0,-103
4337,1,1,987,1232,245
4338,1,0,81,0,-81
4339,0,0,7,0,-7
4340,0,0,23,0,-23
4341,0,0,4,0,-4
4342,1,0,116,0,-116
4343,0,0,0,0,0
4344,0,0,4,0,-4
4345,0,0,10,0,-10
4346,1,1,174,1524,1350
4347,0,0,59,0,-59
4348,1,1,555,1232,677
4349,1,0,21,0,-21
4350,1,1,205,4268,4063
4351,1,0,0,0,0
4352,1,0,64,0,-64
4353,1,1,603,1648,1045
4354,1,0,6,0,-6
4355,0,0,21,0,-21
4356,1,1,256,1825,1569
4357,1,1,276,2014,1738
4358,0,0,5,0,-5
4359,1,0,41,0,-41
4360,0,0,1,0,-1
4361,0,0,39,0,-39
4362,1,0,147,0,-147
4363,1,0,18,0,-18
4364,0,0,84,0,-84
4365,0,0,61,0,-61
4366,1,0,19,0,-19
4367,0,0,11,0,-11
4368,1,0,14,0,-14
4369,0,0,17,0,-17
4370,1,0,43,0,-43
4371,1,0,9,0,-9
4372,0,0,19,0,-19
4373,1,0,55,0,-55
4374,1,0,54,0,-54
4375,1,1,386,1255,869
4376,1,1,614,1362,748
4377,1,1,171,1233,1062
4378,0,0,17,0,-17
4379,0,0,122,0,-122
4380,1,1,836,1290,454
4381,1,0,13,0,-13
4382,0,0,23,0,-23
4383,1,1,233,1383,1150
4384,1,0,63,0,-63
4385,0,0,96,0,-96
4386,0,0,16,0,-16
4387,1,1,1308,1400,92
4388,0,0,87,0,-87
4389,0,0,17,0,-17
4390,1,0,65,0,-65
4391,1,1,413,1666,1253
4392,0,0,29,0,-29
4393,0,0,61,0,-61
4394,1,1,64,2128,2064
4395,1,1,114,1439,1325
4396,0,0,47,0,-47
4397,0,0,2,0,-2
4398,0,0,40,0,-40
4399,1,1,215,3339,3124
4400,1,1,152,1587,1435
4401,1,0,121,0,-121
4402,1,0,0,0,0
4403,1,1,330,1321,991
4404,1,0,55,0,-55
4405,1,0,4,0,-4
4406,0,0,14,0,-14
4407,1,0,5,0,-5
4408,0,0,25,0,-25
4409,1,0,13,0,-13
4410,1,1,73,2081,2008
4411,1,1,334,4284,3950
4412,0,0,135,0,-135
4413,1,1,1253,1424,171
4414,1,1,56,1610,1554
4415,0,0,187,0,-187
4416,1,1,522,1375,853
4417,0,0,33,0,-33
4418,0,0,1,0,-1
4419,1,1,23,1551,1528
4420,0,0,5,0,-5
4421,0,0,61,0,-61
4422,0,0,2,0,-2
4423,1,0,19,0,-19
4424,1,1,868,1671,803
4425,1,0,215,0,-215
4426,1,1,376,1408,1032
4427,1,0,35,0,-35
4428,0,0,2,0,-2
4429,0,0,6,0,-6
4430,0,0,18,0,-18
4431,1,1,1435,2815,1380
4432,1,1,1259,1752,493
4433,0,0,24,0,-24
4434,0,0,56,0,-56
4435,1,1,129,1235,1106
4436,0,0,6,0,-6
4437,0,0,36,0,-36
4438,1,0,0,0,0
4439,1,1,2637,1916,-721
4440,1,1,324,1210,886
4441,1,0,43,0,-43
4442,0,0,33,0,-33
4443,1,0,45,0,-45
4444,0,0,89,0,-89
4445,0,0,23,0,-23
4446,1,0,1,0,-1
4447,0,0,16,0,-16
4448,1,0,376,0,-376
4449,1,1,686,1490,804
4450,0,0,68,0,-68
4451,1,1,680,1945,1265
4452,1,0,29,0,-29
4453,0,0,72,0,-72
4454,0,0,88,0,-88
4455,1,0,59,0,-59
4456,0,0,159,0,-159
4457,1,1,1009,1200,191
4458,1,0,26,0,-26
4459,1,0,0,0,0
4460,1,0,9,0,-9
4461,0,0,91,0,-91
4462,1,1,642,1666,1024
4463,1,0,18,0,-18
4464,0,0,6,0,-6
4465,1,0,46,0,-46
4466,1,0,34,0,-34
4467,0,0,8,0,-8
4468,1,1,219,1200,981
4469,1,0,20,0,-20
4470,0,0,3,0,-3
4471,1,0,55,0,-55
4472,0,0,100,0,-100
4473,0,0,54,0,-54
4474,1,1,1497,2308,811
4475,1,0,23,0,-23
4476,1,1,113,1415,1302
4477,1,0,114,0,-114
4478,1,1,446,1672,1226
4479,0,0,106,0,-106
4480,0,0,20,0,-20
4481,0,0,36,0,-36
4482,1,1,451,1317,866
4483,1,0,21,0,-21
4484,0,0,45,0,-45
4485,1,1,247,1286,1039
4486,0,0,20,0,-20
4487,0,0,32,0,-32
4488,1,1,1331,1917,586
4489,1,0,283,0,-283
4490,0,0,29,0,-29
4491,1,1,657,1962,1305
4492,1,0,82,0,-82
4493,0,0,81,0,-81
4494,0,0,24,0,-24
4495,1,0,40,0,-40
4496,0,0,7,0,-7
4497,1,1,672,1259,587
4498,0,0,7,0,-7
4499,1,0,26,0,-26
4500,1,0,123,0,-123
4501,1,0,192,0,-192
4502,1,1,624,1642,1018
4503,0,0,6,0,-6
4504,1,0,14,0,-14
4505,1,0,111,0,-111
4506,0,0,9,0,-9
4507,0,0,14,0,-14
4508,0,0,57,0,-57
4509,0,0,29,0,-29
4510,1,0,25,0,-25
4511,1,1,697,1225,528
4512,1,1,132,1355,1223
4513,0,0,6,0,-6
4514,0,0,27,0,-27
4515,1,1,922,1337,415
4516,1,1,870,2119,1249
4517,0,0,29,0,-29
4518,1,0,1,0,-1
4519,0,0,64,0,-64
4520,0,0,16,0,-16
4521,1,1,414,3702,3288
4522,0,0,87,0,-87
4523,1,1,62,1210,1148
4524,1,1,445,1269,824
4525,1,0,3,0,-3
4526,1,0,39,0,-39
4527,0,0,85,0,-85
4528,1,0,74,0,-74
4529,0,0,5,0,-5
4530,1,0,67,0,-67
4531,1,1,116,1288,1172
4532,1,0,24,0,-24
4533,0,0,2,0,-2
4534,1,1,817,1208,391
4535,1,1,2242,1204,-1038
4536,1,0,55,0,-55
4537,1,0,62,0,-62
4538,1,0,37,0,-37
4539,0,0,132,0,-132
4540,1,0,300,0,-300
4541,0,0,16,0,-16
4542,0,0,57,0,-57
4543,1,1,1265,1444,179
4544,1,0,5,0,-5
4545,0,0,47,0,-47
4546,1,0,64,0,-64
4547,1,0,38,0,-38
4548,1,1,127,1615,1488
4549,1,1,485,1327,842
4550,1,0,14,0,-14
4551,0,0,68,0,-68
4552,0,0,0,0,0
4553,0,0,17,0,-17
4554,0,0,27,0,-27
4555,1,1,1845,2104,259
4556,1,1,758,1711,953
4557,0,0,9,0,-9
4558,1,1,135,2359,2224
4559,0,0,10,0,-10
4560,1,1,70,2897,2827
4561,1,1,134,1375,1241
4562,1,0,98,0,-98
4563,1,0,14,0,-14
4564,1,1,170,1218,1048
4565,0,0,81,0,-81
4566,0,0,151,0,-151
4567,0,0,32,0,-32
4568,0,0,32,0,-32
4569,1,1,382,1870,1488
4570,1,0,173,0,-173
4571,0,0,13,0,-13
4572,0,0,53,0,-53
4573,0,0,56,0,-56
4574,1,1,1461,1416,-45
4575,1,0,8,0,-8
4576,1,0,53,0,-53
4577,1,0,55,0,-55
4578,1,1,267,1401,1134
4579,0,0,5,0,-5
4580,0,0,31,0,-31
4581,0,0,8,0,-8
4582,1,1,143,1538,1395
4583,1,1,29,1284,1255
4584,0,0,3,0,-3
4585,1,0,5,0,-5
4586,1,0,7,0,-7
4587,1,1,1635,1379,-256
4588,0,0,10,0,-10
4589,1,0,55,0,-55
4590,1,1,2074,1323,-751
4591,0,0,76,0,-76
4592,1,1,564,1554,990
4593,1,1,243,1255,1012
4594,1,0,25,0,-25
4595,0,0,53,0,-53
4596,1,0,92,0,-92
4597,1,1,162,1640,1478
4598,1,0,75,0,-75
4599,0,0,5,0,-5
4600,1,1,524,1219,695
4601,0,0,67,0,-67
4602,1,1,72,1280,1208
4603,1,1,1007,1229,222
4604,0,0,15,0,-15
4605,1,1,1158,1684,526
4606,0,0,14,0,-14
4607,1,0,36,0,-36
4608,1,1,718,1322,604
4609,0,0,32,0,-32
4610,1,0,15,0,-15
4611,0,0,3,0,-3
4612,1,1,7,3260,3253
4613,1,1,263,1834,1571
4614,1,0,41,0,-41
4615,1,1,240,1331,1091
4616,0,0,7,0,-7
4617,0,0,90,0,-90
4618,1,0,83,0,-83
4619,1,1,577,1448,871
4620,1,1,846,1312,466
4621,1,1,1491,3465,1974
4622,1,0,101,0,-101
4623,1,0,230,0,-230
4624,1,0,129,0,-129
4625,0,0,2,0,-2
4626,1,1,812,1204,392
4627,0,0,28,0,-28
4628,0,0,67,0,-67
4629,1,1,471,1970,1499
4630,1,1,1244,1597,353
4631,1,0,94,0,-94
4632,1,0,0,0,0
4633,1,1,717,1209,492
4634,1,0,38,0,-38
4635,0,0,3,0,-3
4636,1,1,386,1640,1254
4637,1,0,71,0,-71
4638,1,0,1,0,-1
4639,1,1,787,1331,544
4640,1,0,15,0,-15
4641,0,0,7,0,-7
4642,1,1,434,1394,960
4643,1,0,49,0,-49
4644,1,1,116,1403,1287
4645,1,0,3,0,-3
4646,0,0,75,0,-75
4647,0,0,17,0,-17
4648,0,0,9,0,-9
4649,0,0,86,0,-86
4650,0,0,50,0,-50
4651,1,1,470,1658,1188
4652,1,1,1506,1675,169
4653,1,0,37,0,-37
4654,0,0,6,0,-6
4655,0,0,30,0,-30
4656,1,0,115,0,-115
4657,0,0,38,0,-38
4658,0,0,126,0,-126
4659,1,1,1733,1515,-218
4660,0,0,23,0,-23
4661,0,0,33,0,-33
4662,1,0,30,0,-30
4663,0,0,248,0,-248
4664,1,0,12,0,-12
4665,1,0,5,0,-5
4666,1,0,22,0,-22
4667,1,0,145,0,-145
4668,1,1,839,1940,1101
4669,0,0,29,0,-29
4670,1,1,57,1247,1190
4671,0,0,103,0,-103
4672,1,0,3,0,-3
4673,1,0,104,0,-104
4674,1,1,114,1215,1101
4675,1,0,33,0,-33
4676,1,1,683,1464,781
4677,1,0,15,0,-15
4678,1,0,16,0,-16
4679,1,1,393,1335,942
4680,0,0,2,0,-2
4681,0,0,36,0,-36
4682,0,0,27,0,-27
4683,1,1,468,1240,772
4684,1,1,609,1846,1237
4685,0,0,1,0,-1
4686,1,0,18,0,-18
4687,0,0,4,0,-4
4688,0,0,6,0,-6
4689,1,1,425,1282,857
4690,1,1,529,1425,896
4691,1,1,181,1445,1264
4692,0,0,69,0,-69
4693,1,0,44,0,-44
4694,1,0,70,0,-70
4695,1,1,81,1297,1216
4696,1,0,21,0,-21
4697,1,0,15,0,-15
4698,1,1,152,1949,1797
4699,1,1,474,1419,945
4700,1,1,440,1816,1376
4701,1,0,11,0,-11
4702,1,1,176,1612,1436
4703,1,0,1,0,-1
4704,1,0,36,0,-36
4705,1,1,396,1384,988
4706,1,1,96,1215,1119
4707,1,1,334,1554,1220
4708,1,0,26,0,-26
4709,1,1,455,1428,973
4710,1,1,138,1671,1533
4711,0,0,28,0,-28
4712,1,0,8,0,-8
4713,0,0,2,0,-2
4714,0,0,77,0,-77
4715,1,1,265,1269,1004
4716,1,1,69,1233,1164
4717,1,0,36,0,-36
4718,1,0,1,0,-1
4719,0,0,13,0,-13
4720,1,0,2,0,-2
4721,0,0,49,0,-49
4722,1,1,1230,1214,-16
4723,0,0,2,0,-2
4724,1,0,15,0,-15
4725,0,0,132,0,-132
4726,1,0,258,0,-258
4727,0,0,250,0,-250
4728,1,0,47,0,-47
4729,0,0,144,0,-144
4730,1,0,11,0,-11
4731,0,0,3,0,-3
4732,1,1,692,1222,530
4733,0,0,12,0,-12
4734,0,0,2,0,-2
4735,0,0,52,0,-52
4736,1,0,2,0,-2
4737,1,1,823,1230,407
4738,1,0,150,0,-150
4739,0,0,17,0,-17
4740,1,1,983,1219,236
4741,1,1,1958,1503,-455
4742,0,0,0,0,0
4743,1,1,439,1788,1349
4744,1,1,1873,1747,-126
4745,0,0,25,0,-25
4746,1,1,681,1326,645
4747,0,0,9,0,-9
4748,1,1,197,1341,1144
4749,1,1,1077,1458,381
4750,1,1,90,2154,2064
4751,1,1,191,1200,1009
4752,1,0,11,0,-11
4753,1,1,52,1476,1424
4754,1,1,177,2472,2295
4755,0,0,72,0,-72
4756,1,0,36,0,-36
4757,1,0,31,0,-31
4758,0,0,35,0,-35
4759,1,1,22,1421,1399
4760,0,0,3,0,-3
4761,0,0,67,0,-67
4762,0,0,17,0,-17
4763,1,0,62,0,-62
4764,1,1,736,1298,562
4765,1,1,185,2088,1903
4766,0,0,115,0,-115
4767,1,1,1388,1932,544
4768,1,0,63,0,-63
4769,0,0,6,0,-6
4770,1,1,519,1745,1226
4771,0,0,17,0,-17
4772,1,1,508,1721,1213
4773,0,0,0,0,0
4774,1,0,106,0,-106
4775,0,0,2,0,-2
4776,0,0,40,0,-40
4777,1,0,62,0,-62
4778,0,0,38,0,-38
4779,0,0,61,0,-61
4780,0,0,35,0,-35
4781,1,0,6,0,-6
4782,1,1,1063,1857,794
4783,0,0,43,0,-43
4784,1,0,3,0,-3
4785,0,0,59,0,-59
4786,0,0,287,0,-287
4787,0,0,158,0,-158
4788,0,0,14,0,-14
4789,1,0,4,0,-4
4790,1,0,35,0,-35
4791,0,0,14,0,-14
4792,0,0,2,0,-2
4793,0,0,114,0,-114
4794,0,0,44,0,-44
4795,0,0,18,0,-18
4796,1,1,125,1313,1188
4797,1,0,45,0,-45
4798,1,1,600,1239,639
4799,1,0,15,0,-15
4800,1,1,227,1324,1097
4801,1,0,47,0,-47
4802,0,0,45,0,-45
4803,0,0,166,0,-166
4804,0,0,12,0,-12
4805,1,1,547,1994,1447
4806,0,0,12,0,-12
4807,0,0,36,0,-36
4808,0,0,0,0,0
4809,1,0,13,0,-13
4810,1,1,693,1275,582
4811,1,0,35,0,-35
4812,1,1,227,1205,978
4813,0,0,16,0,-16
4814,0,0,9,0,-9
4815,0,0,44,0,-44
4816,1,0,27,0,-27
4817,1,1,41,1388,1347
4818,1,1,2179,1283,-896
4819,0,0,86,0,-86
4820,0,0,10,0,-10
4821,1,0,10,0,-10
4822,1,0,17,0,-17
4823,1,1,575,1856,1281
4824,0,0,29,0,-29
4825,1,0,10,0,-10
4826,1,0,27,0,-27
4827,1,0,15,0,-15
4828,0,0,51,0,-51
4829,1,1,370,1359,989
4830,1,0,7,0,-7
4831,1,0,17,0,-17
4832,0,0,32,0,-32
4833,0,0,135,0,-135
4834,0,0,29,0,-29
4835,1,1,1043,1212,169
4836,0,0,12,0,-12
4837,0,0,0,0,0
4838,1,0,17,0,-17
4839,1,0,3,0,-3
4840,1,1,590,1502,912
4841,1,0,10,0,-10
4842,1,1,417,1988,1571
4843,1,0,42,0,-42
4844,1,0,14,0,-14
4845,1,1,92,1223,1131
4846,1,1,306,1398,1092
4847,1,1,129,1368,1239
4848,1,1,1047,2332,1285
4849,0,0,2,0,-2
4850,0,0,28,0,-28
4851,0,0,100,0,-100
4852,1,0,90,0,-90
4853,0,0,94,0,-94
4854,1,0,74,0,-74
4855,0,0,125,0,-125
4856,0,0,72,0,-72
4857,0,0,27,0,-27
4858,1,1,468,2068,1600
4859,1,0,43,0,-43
4860,1,1,68,1372,1304
4861,1,1,1597,9649,8052
4862,0,0,5,0,-5
4863,1,1,101,1292,1191
4864,0,0,3,0,-3
4865,0,0,97,0,-97
4866,1,1,812,1316,504
4867,1,1,423,1467,1044
4868,0,0,52,0,-52
4869,1,0,13,0,-13
4870,1,0,22,0,-22
4871,1,0,59,0,-59
4872,0,0,14,0,-14
4873,0,0,48,0,-48
4874,1,1,90,2908,2818
4875,0,0,53,0,-53
4876,1,0,16,0,-16
4877,1,1,1964,1322,-642
4878,0,0,82,0,-82
4879,1,0,78,0,-78
4880,1,0,42,0,-42
4881,0,0,45,0,-45
4882,1,0,0,0,0
4883,1,0,33,0,-33
4884,0,0,11,0,-11
4885,0,0,59,0,-59
4886,1,1,584,1591,1007
4887,1,1,342,1259,917
4888,0,0,8,0,-8
4889,1,1,444,1312,868
4890,0,0,19,0,-19
4891,1,1,75,1210,1135
4892,1,0,75,0,-75
4893,1,1,1633,1800,167
4894,1,0,25,0,-25
4895,1,0,49,0,-49
4896,1,0,30,0,-30
4897,1,0,5,0,-5
4898,1,0,44,0,-44
4899,1,1,412,1300,888
4900,1,0,49,0,-49
4901,1,0,12,0,-12
4902,0,0,30,0,-30
4903,1,1,815,1542,727
4904,0,0,2,0,-2
4905,0,0,76,0,-76
4906,1,1,673,1210,537
4907,1,0,269,0,-269
4908,1,1,430,2394,1964
4909,1,0,31,0,-31
4910,1,1,1423,2250,827
4911,1,1,934,3073,2139
4912,0,0,153,0,-153
4913,0,0,15,0,-15
4914,1,1,572,1680,1108
4915,1,1,327,2344,2017
4916,0,0,98,0,-98
4917,0,0,22,0,-22
4918,1,1,1001,1579,578
4919,1,1,1011,1338,327
4920,1,0,87,0,-87
4921,1,0,18,0,-18
4922,1,0,3,0,-3
4923,1,0,39,0,-39
4924,0,0,67,0,-67
4925,1,0,39,0,-39
4926,1,1,371,1234,863
4927,0,0,21,0,-21
4928,1,0,27,0,-27
4929,0,0,3,0,-3
4930,0,0,14,0,-14
4931,1,1,230,1446,1216
4932,1,1,266,1864,1598
4933,1,0,10,0,-10
4934,0,0,29,0,-29
4935,1,0,155,0,-155
4936,0,0,15,0,-15
4937,0,0,120,0,-120
4938,1,1,270,1240,970
4939,0,0,80,0,-80
4940,1,1,244,1272,1028
4941,0,0,206,0,-206
4942,0,0,14,0,-14
4943,0,0,50,0,-50
4944,0,0,77,0,-77
4945,1,1,685,1418,733
4946,1,0,32,0,-32
4947,1,1,826,1732,906
4948,0,0,3,0,-3
4949,1,0,52,0,-52
4950,1,0,1,0,-1
4951,0,0,62,0,-62
4952,1,0,7,0,-7
4953,0,0,10,0,-10
4954,1,1,153,1765,1612
4955,0,0,3,0,-3
4956,0,0,76,0,-76
4957,1,1,587,1327,740
4958,0,0,36,0,-36
4959,1,1,72,1235,1163
4960,0,0,115,0,-115
4961,0,0,33,0,-33
4962,1,1,249,1265,1016
4963,1,0,78,0,-78
4964,0,0,3,0,-3
4965,0,0,9,0,-9
4966,1,0,6,0,-6
4967,1,1,1158,1540,382
4968,1,1,1325,1369,44
4969,1,0,115,0,-115
4970,1,1,118,1728,1610
4971,0,0,99,0,-99
4972,1,1,2563,1420,-1143
4973,1,0,10,0,-10
4974,1,1,787,1324,537
4975,1,1,2381,1387,-994
4976,1,1,612,1248,636
4977,0,0,5,0,-5
4978,0,0,31,0,-31
4979,1,1,279,1991,1712
4980,1,1,1025,1386,361
4981,1,1,731,1337,606
4982,1,1,257,1600,1343
4983,0,0,9,0,-9
4984,0,0,80,0,-80
4985,0,0,36,0,-36
4986,1,0,38,0,-38
4987,1,0,6,0,-6
4988,0,0,50,0,-50
4989,1,0,3,0,-3
4990,1,1,209,2679,2470
4991,0,0,3,0,-3
4992,0,0,77,0,-77
4993,0,0,86,0,-86
4994,0,0,25,0,-25
4995,0,0,5,0,-5
4996,1,0,14,0,-14
4997,0,0,25,0,-25
4998,1,1,143,1447,1304
4999,1,0,14,0,-14
5000,0,0,18,0,-18
5001,1,0,0,0,0
5002,0,0,2,0,-2
5003,1,1,536,3025,2489
5004,1,0,6,0,-6
5005,1,0,15,0,-15
5006,1,1,185,1707,1522
5007,0,0,6,0,-6
5008,1,1,1187,1465,278
5009,1,0,7,0,-7
5010,0,0,65,0,-65
5011,1,0,32,0,-32
5012,1,0,15,0,-15
5013,1,0,6,0,-6
5014,1,1,394,2427,2033
5015,1,0,2,0,-2
5016,0,0,28,0,-28
5017,0,0,145,0,-145
5018,1,1,187,1824,1637
5019,1,0,18,0,-18
5020,1,0,16,0,-16
5021,1,0,2,0,-2
5022,0,0,11,0,-11
5023,1,1,96,1255,1159
5024,1,0,94,0,-94
5025,1,0,0,0,0
5026,1,1,1910,1211,-699
5027,1,0,18,0,-18
5028,1,1,315,1277,962
5029,1,0,8,0,-8
5030,0,0,63,0,-63
5031,1,1,481,1559,1078
5032,1,1,45,1582,1537
5033,0,0,10,0,-10
5034,1,0,85,0,-85
5035,0,0,11,0,-11
5036,1,1,149,1906,1757
5037,1,0,15,0,-15
5038,0,0,104,0,-104
5039,1,1,823,1729,906
5040,1,1,643,1550,907
5041,1,1,256,2836,2580
5042,1,1,462,1454,992
5043,0,0,13,0,-13
5044,1,0,40,0,-40
5045,0,0,52,0,-52
5046,1,1,1155,1355,200
5047,0,0,46,0,-46
5048,0,0,13,0,-13
5049,0,0,202,0,-202
5050,0,0,17,0,-17
5051,0,0,45,0,-45
5052,0,0,102,0,-102
5053,0,0,140,0,-140
5054,1,1,347,1471,1124
5055,0,0,142,0,-142
5056,0,0,129,0,-129
5057,0,0,45,0,-45
5058,1,0,18,0,-18
5059,1,1,130,1207,1077
5060,1,1,339,1386,1047
5061,1,1,241,1205,964
5062,0,0,6,0,-6
5063,1,1,1130,1623,493
5064,1,0,30,0,-30
5065,1,1,256,1981,1725
5066,1,1,656,1248,592
5067,1,0,18,0,-18
5068,0,0,25,0,-25
5069,1,0,20,0,-20
5070,1,1,116,3188,3072
5071,1,0,76,0,-76
5072,1,1,115,2137,2022
5073,0,0,125,0,-125
5074,0,0,66,0,-66
5075,0,0,9,0,-9
5076,0,0,119,0,-119
5077,0,0,11,0,-11
5078,1,1,645,1536,891
5079,1,1,209,1525,1316
5080,0,0,2,0,-2
5081,1,1,47,1610,1563
5082,1,0,3,0,-3
5083,1,0,175,0,-175
5084,1,0,59,0,-59
5085,1,1,470,1372,902
5086,1,0,31,0,-31
5087,0,0,44,0,-44
5088,0,0,22,0,-22
5089,1,0,49,0,-49
5090,1,1,437,1425,988
5091,0,0,111,0,-111
5092,1,1,438,2787,2349
5093,1,1,636,1547,911
5094,1,1,620,1228,608
5095,1,0,46,0,-46
5096,0,0,21,0,-21
5097,0,0,19,0,-19
5098,1,1,237,1510,1273
5099,1,0,32,0,-32
5100,1,1,562,1281,719
5101,0,0,150,0,-150
5102,1,1,365,1420,1055
5103,1,0,20,0,-20
5104,0,0,107,0,-107
5105,1,1,115,1430,1315
5106,1,0,36,0,-36
5107,1,1,449,1491,1042
5108,1,0,40,0,-40
5109,0,0,61,0,-61
5110,0,0,229,0,-229
5111,1,0,70,0,-70
5112,0,0,20,0,-20
5113,1,0,14,0,-14
5114,1,1,197,1347,1150
5115,1,1,988,1349,361
5116,0,0,20,0,-20
5117,1,1,259,1352,1093
5118,0,0,17,0,-17
5119,0,0,48,0,-48
5120,1,0,104,0,-104
5121,1,1,318,1260,942
5122,0,0,12,0,-12
5123,0,0,38,0,-38
5124,1,0,47,0,-47
5125,0,0,57,0,-57
5126,1,1,933,1429,496
5127,1,0,41,0,-41
5128,0,0,60,0,-60
5129,0,0,10,0,-10
5130,0,0,93,0,-93
5131,1,1,461,1532,1071
5132,1,1,342,1503,1161
5133,1,0,4,0,-4
5134,0,0,20,0,-20
5135,0,0,4,0,-4
5136,1,1,134,1332,1198
5137,1,0,71,0,-71
5138,0,0,186,0,-186
5139,0,0,37,0,-37
5140,1,1,612,1316,704
5141,1,0,37,0,-37
5142,1,0,15,0,-15
5143,1,1,237,1529,1292
5144,1,0,27,0,-27
5145,1,1,52,1275,1223
5146,1,1,73,1591,1518
5147,0,0,70,0,-70
5148,0,0,31,0,-31
5149,0,0,11,0,-11
5150,0,0,13,0,-13
5151,1,0,31,0,-31
5152,0,0,33,0,-33
5153,1,0,17,0,-17
5154,1,1,403,1207,804
5155,1,1,718,1351,633
5156,1,0,70,0,-70
5157,1,1,67,1208,1141
5158,1,1,82,1742,1660
5159,1,1,1956,1301,-655
5160,1,0,48,0,-48
5161,1,1,525,1447,922
5162,1,0,41,0,-41
5163,1,1,921,1450,529
5164,1,1,186,1215,1029
5165,0,0,87,0,-87
5166,1,0,40,0,-40
5167,0,0,4,0,-4
5168,1,1,229,2933,2704
5169,1,1,466,1598,1132
5170,1,0,2,0,-2
5171,0,0,13,0,-13
5172,0,0,86,0,-86
5173,0,0,25,0,-25
5174,0,0,4,0,-4
5175,1,1,1473,1650,177
5176,0,0,15,0,-15
5177,0,0,172,0,-172
5178,1,0,287,0,-287
5179,1,1,164,1391,1227
5180,1,0,3,0,-3
5181,1,1,493,1205,712
5182,1,1,72,1223,1151
5183,1,1,229,1252,1023
5184,1,1,636,1434,798
5185,1,0,0,0,0
5186,0,0,195,0,-195
5187,0,0,92,0,-92
5188,0,0,17,0,-17
5189,1,1,946,1689,743
5190,1,0,50,0,-50
5191,1,1,1855,1649,-206
5192,0,0,54,0,-54
5193,1,0,16,0,-16
5194,0,0,19,0,-19
5195,1,1,343,1351,1008
5196,0,0,73,0,-73
5197,1,0,6,0,-6
5198,1,0,133,0,-133
5199,1,0,31,0,-31
5200,1,1,513,1417,904
5201,1,0,46,0,-46
5202,0,0,66,0,-66
5203,1,1,307,1402,1095
5204,1,1,241,1282,1041
5205,0,0,278,0,-278
5206,0,0,47,0,-47
5207,1,0,53,0,-53
5208,0,0,67,0,-67
5209,1,1,237,1365,1128
5210,1,0,126,0,-126
5211,0,0,48,0,-48
5212,0,0,212,0,-212
5213,1,0,76,0,-76
5214,1,1,1096,2216,1120
5215,1,0,21,0,-21
5216,1,0,49,0,-49
5217,0,0,64,0,-64
5218,1,1,789,2345,1556
5219,0,0,76,0,-76
5220,0,0,62,0,-62
5221,1,1,263,1486,1223
5222,1,1,18,1416,1398
5223,1,0,29,0,-29
5224,1,0,14,0,-14
5225,0,0,42,0,-42
5226,0,0,16,0,-16
5227,1,0,88,0,-88
5228,1,1,1019,1212,193
5229,1,0,74,0,-74
5230,0,0,29,0,-29
5231,1,0,29,0,-29
5232,1,0,6,0,-6
5233,1,0,105,0,-105
5234,0,0,80,0,-80
5235,1,0,196,0,-196
5236,1,1,151,2028,1877
5237,0,0,13,0,-13
5238,0,0,0,0,0
5239,1,0,38,0,-38
5240,1,0,39,0,-39
5241,0,0,92,0,-92
5242,0,0,27,0,-27
5243,0,0,17,0,-17
5244,1,1,76,1402,1326
5245,1,0,231,0,-231
5246,0,0,6,0,-6
5247,1,0,25,0,-25
5248,0,0,19,0,-19
5249,1,1,1794,1350,-444
5250,0,0,30,0,-30
5251,1,0,115,0,-115
5252,1,1,754,1222,468
5253,1,1,133,1572,1439
5254,1,1,77,1326,1249
5255,0,0,10,0,-10
5256,0,0,77,0,-77
5257,0,0,156,0,-156
5258,1,1,786,1317,531
5259,1,0,49,0,-49
5260,0,0,3,0,-3
5261,0,0,6,0,-6
5262,0,0,105,0,-105
5263,0,0,13,0,-13
5264,0,0,32,0,-32
5265,1,0,5,0,-5
5266,0,0,178,0,-178
5267,0,0,4,0,-4
5268,0,0,30,0,-30
5269,1,1,174,1321,1147
5270,1,0,104,0,-104
5271,1,1,675,1265,590
5272,1,0,18,0,-18
5273,1,0,33,0,-33
5274,0,0,128,0,-128
5275,0,0,66,0,-66
5276,1,0,1,0,-1
5277,1,0,50,0,-50
5278,1,1,497,1436,939
5279,0,0,41,0,-41
5280,1,0,131,0,-131
5281,1,1,378,1860,1482
5282,0,0,46,0,-46
5283,1,1,177,1499,1322
5284,1,0,14,0,-14
5285,1,0,63,0,-63
5286,0,0,67,0,-67
5287,1,1,189,1391,1202
5288,0,0,6,0,-6
5289,0,0,5,0,-5
5290,0,0,104,0,-104
5291,0,0,10,0,-10
5292,0,0,44,0,-44
5293,1,0,20,0,-20
5294,1,1,644,1799,1155
5295,0,0,17,0,-17
5296,0,0,328,0,-328
5297,1,0,41,0,-41
5298,1,1,442,2234,1792
5299,0,0,78,0,-78
5300,0,0,30,0,-30
5301,0,0,46,0,-46
5302,1,0,54,0,-54
5303,0,0,5,0,-5
5304,0,0,39,0,-39
5305,0,0,80,0,-80
5306,1,0,158,0,-158
5307,1,0,393,0,-393
5308,0,0,22,0,-22
5309,0,0,159,0,-159
5310,0,0,30,0,-30
5311,0,0,12,0,-12
5312,0,0,96,0,-96
5313,0,0,75,0,-75
5314,1,0,22,0,-22
5315,0,0,149,0,-149
5316,0,0,9,0,-9
5317,0,0,13,0,-13
5318,1,0,26,0,-26
5319,1,1,943,1220,277
5320,1,0,25,0,-25
5321,1,0,13,0,-13
5322,1,1,1142,1608,466
5323,0,0,40,0,-40
5324,1,1,64,1585,1521
5325,1,0,1,0,-1
5326,0,0,38,0,-38
5327,0,0,142,0,-142
5328,0,0,257,0,-257
5329,0,0,24,0,-24
5330,1,1,221,6384,6163
5331,1,1,36,1216,1180
5332,0,0,57,0,-57
5333,0,0,43,0,-43
5334,1,1,1008,3001,1993
5335,1,1,444,1293,849
5336,1,1,110,1286,1176
5337,1,1,358,1627,1269
5338,1,0,25,0,-25
5339,1,0,18,0,-18
5340,0,0,15,0,-15
5341,0,0,116,0,-116
5342,1,0,54,0,-54
5343,1,1,299,2685,2386
5344,0,0,9,0,-9
5345,1,1,454,1462,1008
5346,1,1,671,1202,531
5347,0,0,97,0,-97
5348,1,0,84,0,-84
5349,1,1,434,2050,1616
5350,1,0,89,0,-89
5351,0,0,219,0,-219
5352,1,1,233,1465,1232
5353,1,0,26,0,-26
5354,1,0,52,0,-52
5355,1,0,22,0,-22
5356,0,0,12,0,-12
5357,1,1,237,1267,1030
5358,0,0,47,0,-47
5359,0,0,15,0,-15
5360,1,1,990,1939,949
5361,1,0,197,0,-197
5362,1,1,184,1263,1079
5363,0,0,60,0,-60
5364,1,1,159,1261,1102
5365,1,1,209,1205,996
5366,1,0,81,0,-81
5367,0,0,1,0,-1
5368,1,1,382,1482,1100
5369,1,1,54,1236,1182
5370,0,0,20,0,-20
5371,0,0,60,0,-60
5372,0,0,316,0,-316
5373,0,0,5,0,-5
5374,1,1,610,1213,603
5375,1,1,1450,1632,182
5376,1,1,224,1755,1531
5377,0,0,140,0,-140
5378,0,0,76,0,-76
5379,1,0,25,0,-25
5380,1,0,39,0,-39
5381,0,0,45,0,-45
5382,1,1,1116,2531,1415
5383,0,0,197,0,-197
5384,1,0,10,0,-10
5385,0,0,14,0,-14
5386,1,0,95,0,-95
5387,1,1,68,1359,1291
5388,1,1,1057,1301,244
5389,0,0,41,0,-41
5390,0,0,65,0,-65
5391,0,0,29,0,-29
5392,1,0,66,0,-66
5393,1,0,137,0,-137
5394,0,0,63,0,-63
5395,0,0,10,0,-10
5396,1,0,29,0,-29
5397,1,0,104,0,-104
5398,1,1,643,1886,1243
5399,1,1,477,1252,775
5400,0,0,58,0,-58
5401,1,0,5,0,-5
5402,0,0,78,0,-78
5403,1,1,77,1306,1229
5404,0,0,39,0,-39
5405,0,0,85,0,-85
5406,1,1,1132,1575,443
5407,0,0,8,0,-8
5408,1,1,2634,1765,-869
5409,0,0,4,0,-4
5410,1,1,725,1561,836
5411,0,0,72,0,-72
5412,0,0,31,0,-31
5413,1,0,11,0,-11
5414,1,0,33,0,-33
5415,1,0,37,0,-37
5416,1,1,528,2903,2375
5417,0,0,29,0,-29
5418,0,0,3,0,-3
5419,0,0,11,0,-11
5420,0,0,8,0,-8
5421,0,0,29,0,-29
5422,1,1,81,1435,1354
5423,1,0,34,0,-34
5424,1,0,47,0,-47
5425,1,1,442,2997,2555
5426,1,0,86,0,-86
5427,0,0,39,0,-39
5428,1,0,16,0,-16
5429,1,1,58,1397,1339
5430,1,0,63,0,-63
5431,1,0,1,0,-1
5432,0,0,23,0,-23
5433,1,0,9,0,-9
5434,1,1,197,1293,1096
5435,1,1,592,1368,776
5436,1,1,257,1276,1019
5437,1,1,418,1448,1030
5438,1,0,13,0,-13
5439,0,0,41,0,-41
5440,0,0,6,0,-6
5441,1,0,24,0,-24
5442,1,1,821,2348,1527
5443,0,0,161,0,-161
5444,1,1,2110,1529,-581
5445,1,0,132,0,-132
5446,0,0,37,0,-37
5447,0,0,126,0,-126
5448,1,1,561,1599,1038
5449,0,0,61,0,-61
5450,1,1,782,1364,582
5451,1,0,1,0,-1
5452,1,0,2,0,-2
5453,1,1,485,1355,870
5454,1,0,15,0,-15
5455,1,1,202,2634,2432
5456,0,0,360,0,-360
5457,1,0,12,0,-12
5458,1,0,57,0,-57
5459,0,0,67,0,-67
5460,1,0,68,0,-68
5461,1,0,18,0,-18
5462,1,0,41,0,-41
5463,1,1,860,1225,365
5464,1,1,142,1256,1114
5465,1,0,29,0,-29
5466,1,0,36,0,-36
5467,0,0,24,0,-24
5468,1,0,100,0,-100
5469,1,0,64,0,-64
5470,0,0,2,0,-2
5471,0,0,23,0,-23
5472,1,1,191,1453,1262
5473,1,1,92,1237,1145
5474,1,1,93,1240,1147
5475,1,0,11,0,-11
5476,1,1,1106,1564,458
5477,1,1,361,2648,2287
5478,1,0,21,0,-21
5479,0,0,57,0,-57
5480,1,1,657,1553,896
5481,0,0,28,0,-28
5482,1,1,855,1237,382
5483,0,0,43,0,-43
5484,1,1,2203,1275,-928
5485,1,1,582,1274,692
5486,1,1,182,1553,1371
5487,1,0,125,0,-125
5488,1,1,730,1753,1023
5489,0,0,41,0,-41
5490,1,0,76,0,-76
5491,1,1,462,1323,861
5492,1,0,15,0,-15
5493,0,0,23,0,-23
5494,0,0,46,0,-46
5495,1,0,2,0,-2
5496,0,0,88,0,-88
5497,1,0,2,0,-2
5498,0,0,124,0,-124
5499,1,1,109,1332,1223
5500,1,0,24,0,-24
5501,0,0,70,0,-70
5502,1,0,7,0,-7
5503,1,0,26,0,-26
5504,1,1,323,1415,1092
5505,1,0,1,0,-1
5506,1,0,77,0,-77
5507,1,0,19,0,-19
5508,1,1,409,1449,1040
5509,1,1,516,1424,908
5510,0,0,17,0,-17
5511,1,1,44,1224,1180
5512,1,1,1000,1818,818
5513,0,0,14,0,-14
5514,0,0,28,0,-28
5515,0,0,0,0,0
5516,1,1,645,2598,1953
5517,0,0,30,0,-30
5518,0,0,126,0,-126
5519,1,1,1050,1288,238
5520,0,0,121,0,-121
5521,0,0,22,0,-22
5522,1,0,32,0,-32
5523,1,1,681,1257,576
5524,1,0,36,0,-36
5525,0,0,117,0,-117
5526,1,0,60,0,-60
5527,0,0,25,0,-25
5528,0,0,9,0,-9
5529,1,0,73,0,-73
5530,1,1,760,1331,571
5531,1,0,17,0,-17
5532,1,0,49,0,-49
5533,1,0,16,0,-16
5534,1,0,42,0,-42
5535,0,0,46,0,-46
5536,0,0,64,0,-64
5537,1,1,197,1238,1041
5538,0,0,90,0,-90
5539,0,0,28,0,-28
5540,0,0,76,0,-76
5541,1,0,63,0,-63
5542,1,1,198,1477,1279
5543,0,0,53,0,-53
5544,0,0,45,0,-45
5545,1,0,39,0,-39
5546,0,0,57,0,-57
5547,0,0,122,0,-122
5548,0,0,22,0,-22
5549,1,1,911,1634,723
5550,1,0,33,0,-33
5551,0,0,51,0,-51
5552,0,0,68,0,-68
5553,1,1,583,1256,673
5554,0,0,3,0,-3
5555,1,1,959,2440,1481
5556,1,1,625,1332,707
5557,1,1,141,1378,1237
5558,1,1,133,1486,1353
5559,1,1,975,1336,361
5560,1,1,2046,1300,-746
5561,0,0,6,0,-6
5562,1,1,19,1202,1183
5563,0,0,25,0,-25
5564,0,0,49,0,-49
5565,0,0,81,0,-81
5566,1,1,356,1240,884
5567,1,1,912,1228,316
5568,1,0,66,0,-66
5569,1,0,18,0,-18
5570,0,0,303,0,-303
5571,0,0,7,0,-7
5572,0,0,21,0,-21
5573,0,0,93,0,-93
5574,1,1,1013,3129,2116
5575,1,0,19,0,-19
5576,1,0,26,0,-26
5577,1,1,1099,1379,280
5578,0,0,53,0,-53
5579,0,0,67,0,-67
5580,1,0,65,0,-65
5581,0,0,29,0,-29
5582,1,0,172,0,-172
5583,0,0,68,0,-68
5584,1,0,0,0,0
5585,0,0,24,0,-24
5586,1,0,125,0,-125
5587,1,1,1130,1919,789
5588,1,0,151,0,-151
5589,0,0,3,0,-3
5590,1,0,78,0,-78
5591,1,1,2125,2402,277
5592,0,0,54,0,-54
5593,0,0,21,0,-21
5594,0,0,30,0,-30
5595,1,0,10,0,-10
5596,0,0,16,0,-16
5597,1,0,28,0,-28
5598,0,0,95,0,-95
5599,1,0,51,0,-51
5600,0,0,8,0,-8
5601,0,0,6,0,-6
5602,1,1,147,2264,2117
5603,1,1,568,1993,1425
5604,1,0,151,0,-151
5605,1,1,890,1233,343
5606,1,0,26,0,-26
5607,1,1,115,1647,1532
5608,0,0,14,0,-14
5609,0,0,10,0,-10
5610,1,1,586,1525,939
5611,1,1,354,1558,1204
5612,1,1,934,1216,282
5613,1,0,81,0,-81
5614,1,0,1,0,-1
5615,1,1,249,1293,1044
5616,1,1,152,1434,1282
5617,1,1,306,1273,967
5618,1,0,21,0,-21
5619,0,0,12,0,-12
5620,0,0,11,0,-11
5621,1,0,27,0,-27
5622,1,0,21,0,-21
5623,1,1,1695,2184,489
5624,0,0,67,0,-67
5625,1,0,79,0,-79
5626,0,0,44,0,-44
5627,1,0,5,0,-5
5628,0,0,41,0,-41
5629,0,0,4,0,-4
5630,0,0,17,0,-17
5631,1,1,40,1825,1785
5632,1,0,43,0,-43
5633,1,0,69,0,-69
5634,0,0,67,0,-67
5635,0,0,24,0,-24
5636,1,0,7,0,-7
5637,0,0,114,0,-114
5638,1,1,1449,1808,359
5639,1,1,489,1386,897
5640,0,0,3,0,-3
5641,1,0,23,0,-23
5642,1,1,1967,1490,-477
5643,0,0,62,0,-62
5644,1,1,730,1708,978
5645,0,0,112,0,-112
5646,0,0,147,0,-147
5647,1,0,237,0,-237
5648,0,0,2,0,-2
5649,1,1,82,2553,2471
5650,1,0,70,0,-70
5651,0,0,36,0,-36
5652,0,0,1,0,-1
5653,0,0,135,0,-135
5654,0,0,112,0,-112
5655,1,1,1858,1686,-172
5656,0,0,35,0,-35
5657,1,0,10,0,-10
5658,1,0,91,0,-91
5659,0,0,24,0,-24
5660,0,0,7,0,-7
5661,0,0,151,0,-151
5662,0,0,22,0,-22
5663,0,0,14,0,-14
5664,1,0,13,0,-13
5665,1,0,54,0,-54
5666,1,0,42,0,-42
5667,1,0,107,0,-107
5668,1,1,712,1829,1117
5669,0,0,7,0,-7
5670,1,1,738,1251,513
5671,1,1,130,2052,1922
5672,1,0,46,0,-46
5673,0,0,31,0,-31
5674,0,0,9,0,-9
5675,1,0,14,0,-14
5676,0,0,16,0,-16
5677,0,0,3,0,-3
5678,1,1,278,1437,1159
5679,1,1,229,1203,974
5680,0,0,4,0,-4
5681,1,1,581,1209,628
5682,0,0,97,0,-97
5683,0,0,52,0,-52
5684,1,1,492,1489,997
5685,0,0,65,0,-65
5686,1,1,1091,1715,624
5687,0,0,32,0,-32
5688,0,0,1,0,-1
5689,0,0,1,0,-1
5690,0,0,24,0,-24
5691,1,0,1,0,-1
5692,1,1,35,1443,1408
5693,0,0,24,0,-24
5694,1,1,916,1252,336
5695,1,0,46,0,-46
5696,1,0,5,0,-5
5697,1,0,21,0,-21
5698,1,0,23,0,-23
5699,0,0,8,0,-8
5700,0,0,29,0,-29
5701,1,0,4,0,-4
5702,0,0,6,0,-6
5703,1,1,185,1907,1722
5704,0,0,116,0,-116
5705,1,1,271,1473,1202
5706,0,0,323,0,-323
5707,1,1,499,1776,1277
5708,1,0,13,0,-13
5709,0,0,18,0,-18
5710,0,0,14,0,-14
5711,1,0,55,0,-55
5712,1,0,15,0,-15
5713,1,0,19,0,-19
5714,0,0,77,0,-77
5715,1,0,84,0,-84
5716,1,0,79,0,-79
5717,0,0,1,0,-1
5718,1,1,91,1433,1342
5719,1,1,49,1245,1196
5720,1,0,10,0,-10
5721,0,0,50,0,-50
5722,1,0,0,0,0
5723,1,1,32,1309,1277
5724,0,0,101,0,-101
5725,0,0,13,0,-13
5726,1,0,1,0,-1
5727,0,0,52,0,-52
5728,0,0,0,0,0
5729,1,0,44,0,-44
5730,1,0,12,0,-12
5731,1,1,282,1289,1007
5732,0,0,109,0,-109
5733,0,0,25,0,-25
5734,0,0,25,0,-25
5735,0,0,7,0,-7
5736,1,0,93,0,-93
5737,1,0,25,0,-25
5738,1,0,60,0,-60
5739,0,0,30,0,-30
5740,1,0,70,0,-70
5741,0,0,143,0,-143
5742,0,0,69,0,-69
5743,1,1,39,1282,1243
5744,1,1,881,1411,530
5745,1,0,6,0,-6
5746,1,0,46,0,-46
5747,1,0,2,0,-2
5748,1,1,592,1321,729
5749,0,0,5,0,-5
5750,0,0,7,0,-7
5751,1,0,13,0,-13
5752,1,1,972,1394,422
5753,1,1,1398,1356,-42
5754,0,0,13,0,-13
5755,1,1,803,1385,582
5756,1,0,13,0,-13
5757,0,0,6,0,-6
5758,0,0,98,0,-98
5759,1,1,101,1723,1622
5760,1,1,312,1385,1073
5761,0,0,74,0,-74
5762,0,0,23,0,-23
5763,0,0,29,0,-29
5764,0,0,112,0,-112
5765,1,0,75,0,-75
5766,1,1,605,1447,842
5767,1,0,74,0,-74
5768,0,0,25,0,-25
5769,0,0,5,0,-5
5770,1,0,22,0,-22
5771,1,1,644,1599,955
5772,1,1,311,1671,1360
5773,1,1,462,6010,5548
5774,1,0,3,0,-3
5775,0,0,151,0,-151
5776,0,0,17,0,-17
5777,0,0,56,0,-56
5778,1,0,1,0,-1
5779,1,0,13,0,-13
5780,1,0,4,0,-4
5781,1,0,44,0,-44
5782,0,0,55,0,-55
5783,0,0,26,0,-26
5784,0,0,54,0,-54
5785,0,0,84,0,-84
5786,1,0,128,0,-128
5787,1,0,25,0,-25
5788,1,1,477,1862,1385
5789,1,0,10,0,-10
5790,1,1,90,1285,1195
5791,0,0,135,0,-135
5792,0,0,26,0,-26
5793,1,0,89,0,-89
5794,0,0,87,0,-87
5795,0,0,50,0,-50
5796,1,1,230,1250,1020
5797,1,0,80,0,-80
5798,0,0,36,0,-36
5799,1,1,1297,1214,-83
5800,0,0,37,0,-37
5801,1,0,27,0,-27
5802,0,0,111,0,-111
5803,1,0,37,0,-37
5804,0,0,9,0,-9
5805,0,0,19,0,-19
5806,1,1,370,2235,1865
5807,1,1,602,2466,1864
5808,0,0,99,0,-99
5809,1,0,22,0,-22
5810,1,1,233,1279,1046
5811,1,1,127,1368,1241
5812,0,0,20,0,-20
5813,1,0,31,0,-31
5814,1,1,582,6050,5468
5815,1,1,280,1740,1460
5816,1,1,1276,1285,9
5817,1,0,22,0,-22
5818,0,0,13,0,-13
5819,0,0,55,0,-55
5820,1,1,680,1403,723
5821,1,1,104,1563,1459
5822,1,0,90,0,-90
5823,1,1,542,1942,1400
5824,1,1,418,1340,922
5825,0,0,90,0,-90
5826,1,1,1432,5739,4307
5827,1,0,55,0,-55
5828,1,1,2051,2175,124
5829,1,1,1552,1724,172
5830,1,1,1029,1833,804
5831,1,1,375,1735,1360
5832,1,0,49,0,-49
5833,1,0,33,0,-33
5834,1,0,8,0,-8
5835,1,1,175,1803,1628
5836,0,0,14,0,-14
5837,1,1,261,1322,1061
5838,1,1,816,1219,403
5839,1,0,33,0,-33
5840,0,0,51,0,-51
5841,1,0,5,0,-5
5842,1,1,691,1387,696
5843,0,0,117,0,-117
5844,0,0,133,0,-133
5845,1,0,90,0,-90
5846,1,1,797,1473,676
5847,0,0,64,0,-64
5848,0,0,52,0,-52
5849,0,0,3,0,-3
5850,0,0,28,0,-28
5851,1,1,323,1214,891
5852,1,1,104,1331,1227
5853,1,1,1448,1228,-220
5854,0,0,68,0,-68
5855,0,0,90,0,-90
5856,1,1,67,2447,2380
5857,1,0,0,0,0
5858,1,0,57,0,-57
5859,0,0,3,0,-3
5860,1,1,226,1296,1070
5861,0,0,20,0,-20
5862,1,0,180,0,-180
5863,0,0,61,0,-61
5864,1,1,1452,1328,-124
5865,0,0,2,0,-2
5866,1,1,1235,1824,589
5867,0,0,52,0,-52
5868,0,0,9,0,-9
5869,1,0,9,0,-9
5870,1,0,28,0,-28
5871,0,0,67,0,-67
5872,1,1,91,1239,1148
5873,1,1,87,1508,1421
5874,1,1,533,1334,801
5875,0,0,48,0,-48
5876,0,0,4,0,-4
5877,0,0,26,0,-26
5878,1,0,56,0,-56
5879,0,0,28,0,-28
5880,1,1,203,1704,1501
5881,0,0,19,0,-19
5882,0,0,99,0,-99
5883,0,0,25,0,-25
5884,1,1,1658,1706,48
5885,1,0,118,0,-118
5886,0,0,95,0,-95
5887,1,1,394,3811,3417
5888,0,0,78,0,-78
5889,0,0,162,0,-162
5890,1,1,118,1699,1581
5891,1,0,4,0,-4
5892,1,1,1943,1221,-722
5893,0,0,8,0,-8
5894,0,0,82,0,-82
5895,1,0,4,0,-4
5896,1,1,320,1823,1503
5897,1,1,680,1228,548
5898,0,0,3,0,-3
5899,0,0,11,0,-11
5900,0,0,3,0,-3
5901,1,0,19,0,-19
5902,1,0,100,0,-100
5903,1,1,1119,1565,446
5904,0,0,39,0,-39
5905,0,0,28,0,-28
5906,1,1,914,1522,608
5907,1,1,2385,1878,-507
5908,1,1,1267,1210,-57
5909,1,1,449,1209,760
5910,0,0,4,0,-4
5911,1,1,555,1698,1143
5912,1,1,1174,1251,77
5913,0,0,26,0,-26
5914,1,0,16,0,-16
5915,1,1,365,1567,1202
5916,1,1,727,1281,554
5917,1,0,9,0,-9
5918,0,0,18,0,-18
5919,0,0,9,0,-9
5920,1,0,29,0,-29
5921,0,0,50,0,-50
5922,1,0,30,0,-30
5923,0,0,10,0,-10
5924,0,0,30,0,-30
5925,0,0,15,0,-15
5926,0,0,114,0,-114
5927,1,1,141,2276,2135
5928,0,0,92,0,-92
5929,1,0,92,0,-92
5930,0,0,97,0,-97
5931,1,0,203,0,-203
5932,1,1,57,1429,1372
5933,1,1,199,1359,1160
5934,0,0,138,0,-138
5935,0,0,11,0,-11
5936,0,0,140,0,-140
5937,0,0,5,0,-5
5938,0,0,56,0,-56
5939,1,0,152,0,-152
5940,1,1,1455,1436,-19
5941,1,1,262,1493,1231
5942,0,0,13,0,-13
5943,1,1,668,1403,735
5944,1,0,129,0,-129
5945,1,1,206,1349,1143
5946,1,1,366,1235,869
5947,0,0,112,0,-112
5948,1,0,12,0,-12
5949,1,1,368,1530,1162
5950,1,1,211,1556,1345
5951,1,1,1072,1239,167
5952,1,1,150,1235,1085
5953,1,0,67,0,-67
5954,1,1,47,1230,1183
5955,1,0,10,0,-10
5956,1,0,109,0,-109
5957,0,0,7,0,-7
5958,1,0,170,0,-170
5959,1,0,24,0,-24
5960,1,0,9,0,-9
5961,1,1,788,1668,880
5962,0,0,154,0,-154
5963,1,1,505,2281,1776
5964,1,1,167,2843,2676
5965,1,0,3,0,-3
5966,1,1,97,1284,1187
5967,0,0,47,0,-47
5968,1,1,162,1373,1211
5969,1,1,332,2273,1941
5970,1,1,103,1304,1201
5971,1,0,74,0,-74
5972,0,0,141,0,-141
5973,0,0,110,0,-110
5974,1,1,517,1210,693
5975,0,0,25,0,-25
5976,0,0,34,0,-34
5977,1,1,94,1645,1551
5978,1,1,737,3537,2800
5979,1,1,38,1757,1719
5980,1,0,9,0,-9
5981,0,0,12,0,-12
5982,1,1,1375,1395,20
5983,1,0,28,0,-28
5984,0,0,14,0,-14
5985,1,0,45,0,-45
5986,0,0,5,0,-5
5987,1,0,145,0,-145
5988,1,1,239,1462,1223
5989,1,1,805,1373,568
5990,1,1,119,1378,1259
5991,0,0,17,0,-17
5992,0,0,28,0,-28
5993,0,0,9,0,-9
5994,1,1,862,1356,494
5995,0,0,78,0,-78
5996,1,0,19,0,-19
5997,1,0,14,0,-14
5998,1,0,17,0,-17
5999,0,0,74,0,-74
6000,1,0,9,0,-9
6001,1,0,5,0,-5
6002,1,0,9,0,-9
6003,1,0,87,0,-87
6004,0,0,34,0,-34
6005,0,0,66,0,-66
6006,0,0,134,0,-134
6007,1,1,174,3446,3272
6008,1,1,106,1320,1214
6009,0,0,6,0,-6
6010,1,0,137,0,-137
6011,1,1,1351,1330,-21
6012,1,0,153,0,-153
6013,0,0,22,0,-22
6014,1,1,753,1419,666
6015,1,0,31,0,-31
6016,1,0,4,0,-4
6017,0,0,35,0,-35
6018,1,0,8,0,-8
6019,0,0,4,0,-4
6020,0,0,8,0,-8
6021,1,0,149,0,-149
6022,0,0,8,0,-8
6023,1,0,114,0,-114
6024,0,0,78,0,-78
6025,0,0,138,0,-138
6026,1,1,1023,1523,500
6027,0,0,79,0,-79
6028,1,0,22,0,-22
6029,1,1,99,1262,1163
6030,1,1,463,2345,1882
6031,1,0,88,0,-88
6032,1,1,420,1329,909
6033,0,0,81,0,-81
6034,0,0,25,0,-25
6035,0,0,10,0,-10
6036,1,1,71,2294,2223
6037,0,0,22,0,-22
6038,0,0,80,0,-80
6039,1,0,66,0,-66
6040,1,1,350,1439,1089
6041,1,0,13,0,-13
6042,1,1,135,1272,1137
6043,1,0,63,0,-63
6044,1,1,488,1410,922
6045,1,0,38,0,-38
6046,1,0,36,0,-36
6047,1,1,675,1942,1267
6048,1,0,128,0,-128
6049,1,1,515,1363,848
6050,1,0,72,0,-72
6051,1,1,1609,1225,-384
6052,1,0,104,0,-104
6053,1,1,1219,1585,366
6054,0,0,8,0,-8
6055,0,0,25,0,-25
6056,1,1,275,1489,1214
6057,0,0,85,0,-85
6058,1,1,315,1394,1079
6059,0,0,36,0,-36
6060,1,1,396,2739,2343
6061,1,1,285,1383,1098
6062,0,0,58,0,-58
6063,1,1,254,2142,1888
6064,0,0,190,0,-190
6065,1,1,1338,1520,182
6066,0,0,45,0,-45
6067,1,1,706,1296,590
6068,1,0,9,0,-9
6069,0,0,36,0,-36
6070,1,1,493,1613,1120
6071,0,0,15,0,-15
6072,1,0,44,0,-44
6073,1,0,112,0,-112
6074,1,0,18,0,-18
6075,1,1,132,1611,1479
6076,0,0,79,0,-79
6077,0,0,169,0,-169
6078,0,0,5,0,-5
6079,0,0,56,0,-56
6080,0,0,34,0,-34
6081,1,1,906,1619,713
6082,0,0,45,0,-45
6083,1,0,36,0,-36
6084,1,0,10,0,-10
6085,0,0,24,0,-24
6086,1,1,40,1480,1440
6087,0,0,9,0,-9
6088,1,0,87,0,-87
6089,1,1,358,1556,1198
6090,0,0,81,0,-81
6091,0,0,76,0,-76
6092,0,0,24,0,-24
6093,1,0,66,0,-66
6094,1,0,134,0,-134
6095,1,1,107,1389,1282
6096,0,0,7,0,-7
6097,1,0,13,0,-13
6098,0,0,77,0,-77
6099,1,0,166,0,-166
6100,1,0,152,0,-152
6101,0,0,66,0,-66
6102,1,1,836,1576,740
6103,1,1,217,1317,1100
6104,1,1,241,1203,962
6105,1,0,1,0,-1
6106,0,0,80,0,-80
6107,0,0,67,0,-67
6108,1,0,135,0,-135
6109,0,0,25,0,-25
6110,0,0,6,0,-6
6111,0,0,8,0,-8
6112,0,0,80,0,-80
6113,1,0,9,0,-9
6114,0,0,0,0,0
6115,0,0,93,0,-93
6116,1,0,209,0,-209
6117,1,0,13,0,-13
6118,0,0,5,0,-5
6119,0,0,23,0,-23
6120,0,0,30,0,-30
6121,1,1,1139,1217,78
6122,0,0,17,0,-17
6123,1,1,1339,1884,545
6124,1,0,22,0,-22
6125,1,0,16,0,-16
6126,1,1,1910,1300,-610
6127,1,0,34,0,-34
6128,1,0,25,0,-25
6129,0,0,3,0,-3
6130,0,0,48,0,-48
6131,1,0,7,0,-7
6132,0,0,3,0,-3
6133,0,0,54,0,-54
6134,1,0,37,0,-37
6135,1,0,23,0,-23
6136,1,1,2549,1349,-1200
6137,0,0,44,0,-44
6138,0,0,20,0,-20
6139,0,0,140,0,-140
6140,0,0,7,0,-7
6141,0,0,5,0,-5
6142,1,0,5,0,-5
6143,1,0,30,0,-30
6144,1,0,27,0,-27
6145,1,1,276,2517,2241
6146,0,0,24,0,-24
6147,1,0,16,0,-16
6148,1,1,191,1619,1428
6149,1,1,657,1292,635
6150,1,1,684,1715,1031
6151,1,1,186,1479,1293
6152,1,1,17,1215,1198
6153,0,0,180,0,-180
6154,0,0,6,0,-6
6155,1,0,15,0,-15
6156,1,0,81,0,-81
6157,0,0,53,0,-53
6158,0,0,21,0,-21
6159,1,1,304,1342,1038
6160,0,0,7,0,-7
6161,1,0,19,0,-19
6162,1,1,531,1632,1101
6163,1,1,721,1477,756
6164,1,0,57,0,-57
6165,1,1,556,2046,1490
6166,0,0,10,0,-10
6167,1,1,697,1220,523
6168,1,0,32,0,-32
6169,0,0,54,0,-54
6170,1,0,73,0,-73
6171,0,0,39,0,-39
6172,0,0,13,0,-13
6173,0,0,46,0,-46
6174,1,1,302,1800,1498
6175,0,0,11,0,-11
6176,1,1,161,1496,1335
6177,1,1,331,2808,2477
6178,1,0,68,0,-68
6179,1,1,368,2947,2579
6180,1,1,304,1372,1068
6181,1,1,1053,1984,931
6182,1,0,1,0,-1
6183,1,0,4,0,-4
6184,1,0,50,0,-50
6185,1,0,4,0,-4
6186,1,1,993,2566,1573
6187,0,0,42,0,-42
6188,0,0,14,0,-14
6189,1,1,392,1316,924
6190,1,0,81,0,-81
6191,0,0,56,0,-56
6192,1,0,137,0,-137
6193,0,0,33,0,-33
6194,1,0,35,0,-35
6195,1,1,264,1305,1041
6196,1,1,775,1355,580
6197,0,0,62,0,-62
6198,1,0,7,0,-7
6199,1,0,89,0,-89
6200,1,0,11,0,-11
6201,0,0,84,0,-84
6202,0,0,194,0,-194
6203,1,0,109,0,-109
6204,0,0,43,0,-43
6205,0,0,5,0,-5
6206,1,0,52,0,-52
6207,0,0,100,0,-100
6208,0,0,23,0,-23
6209,0,0,54,0,-54
6210,1,0,254,0,-254
6211,0,0,62,0,-62
6212,0,0,18,0,-18
6213,0,0,2,0,-2
6214,0,0,75,0,-75
6215,1,1,1305,1296,-9
6216,1,1,1145,1306,161
6217,1,0,34,0,-34
6218,0,0,133,0,-133
6219,1,1,1359,1274,-85
6220,1,0,5,0,-5
6221,0,0,50,0,-50
6222,0,0,92,0,-92
6223,1,0,157,0,-157
6224,0,0,42,0,-42
6225,1,0,12,0,-12
6226,0,0,23,0,-23
6227,1,0,65,0,-65
6228,1,1,712,1332,620
6229,1,1,188,1533,1345
6230,1,1,603,2011,1408
6231,1,0,28,0,-28
6232,1,1,560,1377,817
6233,1,0,17,0,-17
6234,1,1,259,1369,1110
6235,0,0,123,0,-123
6236,0,0,1,0,-1
6237,1,0,28,0,-28
6238,0,0,4,0,-4
6239,1,1,956,1406,450
6240,1,0,46,0,-46
6241,0,0,146,0,-146
6242,0,0,66,0,-66
6243,1,1,336,1370,1034
6244,1,1,651,1508,857
6245,0,0,19,0,-19
6246,0,0,44,0,-44
6247,1,0,28,0,-28
6248,0,0,8,0,-8
6249,1,0,40,0,-40
6250,1,1,115,1390,1275
6251,1,1,535,1453,918
6252,0,0,61,0,-61
6253,0,0,30,0,-30
6254,1,1,1742,6056,4314
6255,0,0,14,0,-14
6256,0,0,0,0,0
6257,0,0,54,0,-54
6258,1,1,178,1764,1586
6259,1,1,187,1412,1225
6260,1,1,1359,3295,1936
6261,0,0,14,0,-14
6262,0,0,199,0,-199
6263,0,0,25,0,-25
6264,0,0,67,0,-67
6265,0,0,139,0,-139
6266,1,1,710,1219,509
6267,0,0,60,0,-60
6268,0,0,45,0,-45
6269,1,1,184,1401,1217
6270,1,1,1348,1279,-69
6271,1,0,61,0,-61
6272,1,1,634,1300,666
6273,1,0,100,0,-100
6274,1,0,8,0,-8
6275,1,1,109,1209,1100
6276,0,0,97,0,-97
6277,1,1,122,1316,1194
6278,1,0,27,0,-27
6279,1,0,13,0,-13
6280,0,0,82,0,-82
6281,1,0,3,0,-3
6282,1,1,566,1494,928
6283,0,0,3,0,-3
6284,1,0,87,0,-87
6285,0,0,51,0,-51
6286,1,0,182,0,-182
6287,1,1,479,1280,801
6288,1,1,147,1338,1191
6289,1,1,1675,5124,3449
6290,1,1,1316,1487,171
6291,1,0,7,0,-7
6292,0,0,45,0,-45
6293,1,1,436,1231,795
6294,0,0,33,0,-33
6295,1,0,59,0,-59
6296,1,0,4,0,-4
6297,0,0,13,0,-13
6298,1,0,72,0,-72
6299,1,0,56,0,-56
6300,0,0,42,0,-42
6301,0,0,8,0,-8
6302,0,0,85,0,-85
6303,0,0,16,0,-16
6304,1,1,404,1518,1114
6305,0,0,13,0,-13
6306,0,0,36,0,-36
6307,1,1,450,1441,991
6308,1,0,30,0,-30
6309,1,1,123,1555,1432
6310,0,0,85,0,-85
6311,1,0,107,0,-107
6312,1,1,555,1542,987
6313,1,0,0,0,0
6314,1,1,189,1511,1322
6315,1,1,154,1428,1274
6316,1,1,781,1821,1040
6317,1,0,55,0,-55
6318,0,0,177,0,-177
6319,0,0,54,0,-54
6320,1,1,215,1403,1188
6321,0,0,94,0,-94
6322,1,0,43,0,-43
6323,0,0,62,0,-62
6324,1,1,416,1400,984
6325,1,1,853,1238,385
6326,0,0,3,0,-3
6327,1,0,98,0,-98
6328,0,0,194,0,-194
6329,1,1,174,1416,1242
6330,1,0,214,0,-214
6331,1,0,4,0,-4
6332,1,1,375,1380,1005
6333,0,0,121,0,-121
6334,1,1,953,1322,369
6335,0,0,11,0,-11
6336,1,1,1829,1525,-304
6337,1,1,269,1460,1191
6338,1,1,380,1645,1265
6339,1,1,1111,1443,332
6340,1,1,355,1316,961
6341,1,0,6,0,-6
6342,1,0,28,0,-28
6343,0,0,8,0,-8
6344,1,1,613,1993,1380
6345,1,1,949,1281,332
6346,0,0,29,0,-29
6347,1,1,226,1501,1275
6348,1,1,886,1225,339
6349,1,0,3,0,-3
6350,1,1,219,1435,1216
6351,1,1,643,1309,666
6352,1,0,50,0,-50
6353,0,0,53,0,-53
6354,1,0,39,0,-39
6355,0,0,0,0,0
6356,1,0,18,0,-18
6357,0,0,42,0,-42
6358,1,1,163,1263,1100
6359,1,0,87,0,-87
6360,1,1,82,2540,2458
6361,0,0,13,0,-13
6362,1,1,189,1799,1610
6363,0,0,5,0,-5
6364,1,0,61,0,-61
6365,0,0,35,0,-35
6366,0,0,121,0,-121
6367,1,1,1305,1338,33
6368,0,0,3,0,-3
6369,1,1,269,2208,1939
6370,0,0,54,0,-54
6371,0,0,50,0,-50
6372,1,1,133,1349,1216
6373,1,0,11,0,-11
6374,0,0,53,0,-53
6375,1,1,53,1632,1579
6376,1,0,28,0,-28
6377,0,0,36,0,-36
6378,0,0,16,0,-16
6379,0,0,10,0,-10
6380,0,0,26,0,-26
6381,0,0,200,0,-200
6382,1,0,24,0,-24
6383,1,1,713,1242,529
6384,1,0,4,0,-4
6385,1,1,683,1285,602
6386,1,1,285,1360,1075
6387,1,0,60,0,-60
6388,0,0,21,0,-21
6389,0,0,102,0,-102
6390,1,0,7,0,-7
6391,0,0,98,0,-98
6392,1,0,18,0,-18
6393,1,1,1008,1244,236
6394,0,0,19,0,-19
6395,1,0,51,0,-51
6396,1,1,975,1481,506
6397,1,0,71,0,-71
6398,1,0,93,0,-93
6399,1,1,1916,2434,518
6400,0,0,37,0,-37
6401,0,0,4,0,-4
6402,1,1,2181,1315,-866
6403,1,1,208,3053,2845
6404,1,1,123,2245,2122
6405,1,0,45,0,-45
6406,1,0,44,0,-44
6407,1,0,17,0,-17
6408,0,0,75,0,-75
6409,0,0,160,0,-160
6410,1,1,1158,1208,50
6411,1,0,195,0,-195
6412,0,0,8,0,-8
6413,1,0,67,0,-67
6414,1,1,946,1501,555
6415,1,1,701,1389,688
6416,0,0,0,0,0
6417,1,1,1119,1385,266
6418,1,0,72,0,-72
6419,1,0,111,0,-111
6420,1,0,14,0,-14
6421,1,1,154,1347,1193
6422,0,0,37,0,-37
6423,0,0,117,0,-117
6424,1,1,382,1845,1463
6425,0,0,113,0,-113
6426,0,0,3,0,-3
6427,0,0,25,0,-25
6428,0,0,129,0,-129
6429,0,0,5,0,-5
6430,0,0,60,0,-60
6431,1,0,47,0,-47
6432,0,0,111,0,-111
6433,1,0,228,0,-228
6434,1,0,205,0,-205
6435,1,0,2,0,-2
6436,1,0,32,0,-32
6437,0,0,119,0,-119
6438,0,0,135,0,-135
6439,0,0,68,0,-68
6440,0,0,143,0,-143
6441,1,0,21,0,-21
6442,0,0,58,0,-58
6443,1,1,180,1395,1215
6444,0,0,5,0,-5
6445,0,0,3,0,-3
6446,1,0,89,0,-89
6447,1,1,299,1210,911
6448,1,0,87,0,-87
6449,1,1,347,1331,984
6450,0,0,7,0,-7
6451,1,0,42,0,-42
6452,1,1,684,1257,573
6453,0,0,21,0,-21
6454,1,0,44,0,-44
6455,0,0,63,0,-63
6456,0,0,8,0,-8
6457,0,0,205,0,-205
6458,1,1,651,1260,609
6459,1,1,498,2718,2220
6460,0,0,28,0,-28
6461,1,0,108,0,-108
6462,1,0,7,0,-7
6463,0,0,79,0,-79
6464,1,0,34,0,-34
6465,0,0,7,0,-7
6466,1,1,181,1215,1034
6467,0,0,75,0,-75
6468,1,1,277,1461,1184
6469,1,1,977,2809,1832
6470,1,0,25,0,-25
6471,1,0,30,0,-30
6472,1,0,156,0,-156
6473,0,0,35,0,-35
6474,1,1,438,1617,1179
6475,1,0,30,0,-30
6476,1,1,20,1303,1283
6477,1,0,68,0,-68
6478,1,0,12,0,-12
6479,1,1,540,1329,789
6480,1,0,7,0,-7
6481,1,0,29,0,-29
6482,1,1,391,1212,821
6483,0,0,84,0,-84
6484,0,0,67,0,-67
6485,0,0,70,0,-70
6486,0,0,57,0,-57
6487,1,1,888,1406,518
6488,0,0,26,0,-26
6489,0,0,57,0,-57
6490,1,0,202,0,-202
6491,1,1,720,1773,1053
6492,1,0,26,0,-26
6493,0,0,10,0,-10
6494,1,0,30,0,-30
6495,1,0,26,0,-26
6496,0,0,91,0,-91
6497,0,0,67,0,-67
6498,1,1,160,1517,1357
6499,1,0,75,0,-75
6500,0,0,47,0,-47
6501,1,0,52,0,-52
6502,1,1,645,1211,566
6503,0,0,13,0,-13
6504,0,0,114,0,-114
6505,1,1,382,4086,3704
6506,0,0,0,0,0
6507,0,0,26,0,-26
6508,1,1,84,1266,1182
6509,1,1,144,2285,2141
6510,0,0,55,0,-55
6511,1,0,0,0,0
6512,0,0,10,0,-10
6513,1,0,7,0,-7
6514,0,0,12,0,-12
6515,0,0,102,0,-102
6516,1,0,6,0,-6
6517,1,0,3,0,-3
6518,0,0,8,0,-8
6519,0,0,155,0,-155
6520,0,0,83,0,-83
6521,0,0,1,0,-1
6522,0,0,57,0,-57
6523,1,1,65,1981,1916
6524,1,0,188,0,-188
6525,1,0,26,0,-26
6526,1,0,27,0,-27
6527,0,0,17,0,-17
6528,1,1,320,1364,1044
6529,1,1,1080,1201,121
6530,1,0,98,0,-98
6531,1,0,24,0,-24
6532,1,1,100,1339,1239
6533,1,1,539,1351,812
6534,1,0,75,0,-75
6535,1,0,63,0,-63
6536,0,0,28,0,-28
6537,1,0,15,0,-15
6538,1,0,92,0,-92
6539,1,1,266,1463,1197
6540,1,1,384,1469,1085
6541,0,0,42,0,-42
6542,1,1,665,2492,1827
6543,1,1,66,1880,1814
6544,1,1,160,1285,1125
6545,0,0,13,0,-13
6546,1,0,27,0,-27
6547,1,1,803,2511,1708
6548,0,0,1,0,-1
6549,0,0,0,0,0
6550,1,0,11,0,-11
6551,1,1,38,1266,1228
6552,0,0,245,0,-245
6553,0,0,54,0,-54
6554,1,0,5,0,-5
6555,0,0,63,0,-63
6556,1,1,739,1244,505
6557,1,1,304,1244,940
6558,1,1,186,1546,1360
6559,0,0,14,0,-14
6560,0,0,67,0,-67
6561,1,0,97,0,-97
6562,0,0,8,0,-8
6563,1,0,38,0,-38
6564,1,0,81,0,-81
6565,0,0,26,0,-26
6566,0,0,109,0,-109
6567,0,0,10,0,-10
6568,1,1,877,3951,3074
6569,0,0,23,0,-23
6570,1,1,315,2056,1741
6571,1,0,132,0,-132
6572,1,1,86,1330,1244
6573,0,0,43,0,-43
6574,1,0,91,0,-91
6575,1,0,0,0,0
6576,1,1,233,1382,1149
6577,0,0,11,0,-11
6578,0,0,35,0,-35
6579,0,0,81,0,-81
6580,0,0,1,0,-1
6581,0,0,51,0,-51
6582,1,0,31,0,-31
6583,1,1,535,1272,737
6584,1,0,24,0,-24
6585,0,0,56,0,-56
6586,1,0,16,0,-16
6587,1,0,15,0,-15
6588,0,0,5,0,-5
6589,0,0,5,0,-5
6590,1,1,445,1493,1048
6591,1,1,533,1505,972
6592,1,1,64,1791,1727
6593,1,1,721,1345,624
6594,1,1,504,1353,849
6595,0,0,22,0,-22
6596,1,1,500,1497,997
6597,0,0,62,0,-62
6598,0,0,52,0,-52
6599,1,0,89,0,-89
6600,1,0,35,0,-35
6601,0,0,7,0,-7
6602,1,0,15,0,-15
6603,1,0,29,0,-29
6604,1,1,392,1491,1099
6605,1,1,566,1812,1246
6606,0,0,2,0,-2
6607,0,0,44,0,-44
6608,0,0,13,0,-13
6609,1,0,141,0,-141
6610,0,0,240,0,-240
6611,1,1,1046,1543,497
6612,0,0,60,0,-60
6613,1,0,43,0,-43
6614,1,1,558,1621,1063
6615,1,0,14,0,-14
6616,1,0,20,0,-20
6617,1,1,76,2463,2387
6618,0,0,21,0,-21
6619,1,0,37,0,-37
6620,1,0,39,0,-39
6621,0,0,19,0,-19
6622,1,0,47,0,-47
6623,1,0,45,0,-45
6624,0,0,18,0,-18
6625,0,0,81,0,-81
6626,0,0,125,0,-125
6627,1,1,366,1283,917
6628,1,0,21,0,-21
6629,0,0,36,0,-36
6630,1,1,594,1340,746
6631,1,1,286,1496,1210
6632,1,0,3,0,-3
6633,0,0,7,0,-7
6634,0,0,4,0,-4
6635,0,0,18,0,-18
6636,0,0,9,0,-9
6637,0,0,25,0,-25
6638,1,1,562,1369,807
6639,1,0,67,0,-67
6640,1,1,1186,1209,23
6641,0,0,15,0,-15
6642,0,0,21,0,-21
6643,0,0,109,0,-109
6644,0,0,27,0,-27
6645,1,0,50,0,-50
6646,0,0,50,0,-50
6647,0,0,29,0,-29
6648,1,0,147,0,-147
6649,1,0,12,0,-12
6650,0,0,3,0,-3
6651,1,1,97,2229,2132
6652,0,0,22,0,-22
6653,1,1,69,2152,2083
6654,1,0,55,0,-55
6655,1,0,79,0,-79
6656,1,0,84,0,-84
6657,1,1,623,2031,1408
6658,1,0,131,0,-131
6659,1,1,720,1206,486
6660,1,1,117,1342,1225
6661,1,1,110,1375,1265
6662,0,0,49,0,-49
6663,1,0,14,0,-14
6664,1,0,75,0,-75
6665,0,0,62,0,-62
6666,0,0,76,0,-76
6667,1,1,586,1223,637
6668,0,0,1,0,-1
6669,0,0,110,0,-110
6670,0,0,21,0,-21
6671,0,0,23,0,-23
6672,0,0,0,0,0
6673,0,0,67,0,-67
6674,0,0,87,0,-87
6675,0,0,9,0,-9
6676,0,0,154,0,-154
6677,1,0,135,0,-135
6678,0,0,8,0,-8
6679,0,0,101,0,-101
6680,1,0,87,0,-87
6681,0,0,26,0,-26
6682,1,0,118,0,-118
6683,0,0,59,0,-59
6684,0,0,10,0,-10
6685,1,1,703,1865,1162
6686,0,0,57,0,-57
6687,1,0,6,0,-6
6688,1,0,65,0,-65
6689,1,1,1108,1576,468
6690,1,1,504,1240,736
6691,1,0,306,0,-306
6692,0,0,54,0,-54
6693,1,1,333,1336,1003
6694,1,0,32,0,-32
6695,0,0,4,0,-4
6696,1,0,20,0,-20
6697,1,1,214,1474,1260
6698,0,0,1,0,-1
6699,1,0,27,0,-27
6700,0,0,7,0,-7
6701,0,0,33,0,-33
6702,1,1,36,1492,1456
6703,0,0,8,0,-8
6704,1,0,12,0,-12
6705,0,0,71,0,-71
6706,0,0,202,0,-202
6707,0,0,0,0,0
6708,1,0,40,0,-40
6709,1,1,328,1901,1573
6710,1,0,92,0,-92
6711,1,0,15,0,-15
6712,0,0,158,0,-158
6713,1,1,421,1321,900
6714,1,1,1577,1212,-365
6715,1,1,164,1217,1053
6716,1,1,421,2603,2182
6717,1,0,35,0,-35
6718,1,0,74,0,-74
6719,1,1,136,1291,1155
6720,0,0,17,0,-17
6721,1,1,80,1514,1434
6722,1,0,89,0,-89
6723,0,0,44,0,-44
6724,1,0,47,0,-47
6725,1,0,8,0,-8
6726,0,0,12,0,-12
6727,0,0,60,0,-60
6728,0,0,10,0,-10
6729,0,0,37,0,-37
6730,1,0,52,0,-52
6731,1,1,894,1295,401
6732,1,0,49,0,-49
6733,0,0,29,0,-29
6734,1,0,146,0,-146
6735,1,1,111,1393,1282
6736,1,1,567,1314,747
6737,0,0,174,0,-174
6738,1,1,1140,2126,986
6739,1,1,93,1208,1115
6740,1,1,706,2474,1768
6741,1,1,285,1599,1314
6742,0,0,51,0,-51
6743,1,1,104,2952,2848
6744,1,1,98,2365,2267
6745,1,1,751,1733,982
6746,1,1,1458,1542,84
6747,1,0,41,0,-41
6748,1,0,53,0,-53
6749,1,1,363,1420,1057
6750,1,1,162,2186,2024
6751,1,1,125,1859,1734
6752,0,0,24,0,-24
6753,1,1,820,1342,522
6754,0,0,58,0,-58
6755,1,1,94,1406,1312
6756,0,0,10,0,-10
6757,0,0,0,0,0
6758,1,0,2,0,-2
6759,0,0,11,0,-11
6760,1,0,6,0,-6
6761,0,0,105,0,-105
6762,0,0,7,0,-7
6763,0,0,21,0,-21
6764,1,1,63,1799,1736
6765,0,0,41,0,-41
6766,1,0,6,0,-6
6767,1,1,132,1711,1579
6768,1,0,336,0,-336
6769,0,0,45,0,-45
6770,0,0,97,0,-97
6771,1,1,864,1402,538
6772,1,0,36,0,-36
6773,1,1,681,1517,836
6774,1,1,227,1852,1625
6775,0,0,2,0,-2
6776,1,0,97,0,-97
6777,0,0,8,0,-8
6778,1,1,137,3954,3817
6779,0,0,1,0,-1
6780,1,1,92,1985,1893
6781,0,0,66,0,-66
6782,1,0,26,0,-26
6783,1,0,41,0,-41
6784,0,0,3,0,-3
6785,1,1,419,1327,908
6786,1,0,5,0,-5
6787,0,0,65,0,-65
6788,1,1,267,1351,1084
6789,1,0,72,0,-72
6790,1,1,868,1247,379
6791,1,1,384,1760,1376
6792,0,0,66,0,-66
6793,0,0,20,0,-20
6794,1,1,1158,1474,316
6795,1,0,58,0,-58
6796,1,1,187,1306,1119
6797,0,0,90,0,-90
6798,1,0,24,0,-24
6799,0,0,70,0,-70
6800,1,0,51,0,-51
6801,1,0,36,0,-36
6802,1,1,1107,1926,819
6803,1,0,57,0,-57
6804,0,0,7,0,-7
6805,1,0,103,0,-103
6806,0,0,10,0,-10
6807,1,1,210,1351,1141
6808,1,0,44,0,-44
6809,1,0,13,0,-13
6810,1,1,144,1783,1639
6811,0,0,67,0,-67
6812,1,0,62,0,-62
6813,1,1,211,1315,1104
6814,0,0,58,0,-58
6815,1,1,502,1375,873
6816,1,0,12,0,-12
6817,1,0,27,0,-27
6818,1,1,767,2390,1623
6819,1,0,23,0,-23
6820,1,0,184,0,-184
6821,0,0,23,0,-23
6822,1,1,3326,1861,-1465
6823,1,1,1116,1214,98
6824,1,1,802,2191,1389
6825,1,0,144,0,-144
6826,1,1,156,3197,3041
6827,0,0,109,0,-109
6828,0,0,7,0,-7
6829,0,0,60,0,-60
6830,0,0,14,0,-14
6831,0,0,19,0,-19
6832,1,1,40,1238,1198
6833,1,0,56,0,-56
6834,0,0,2,0,-2
6835,0,0,52,0,-52
6836,1,0,21,0,-21
6837,1,1,2701,2736,35
6838,1,1,41,1480,1439
6839,0,0,3,0,-3
6840,0,0,163,0,-163
6841,0,0,43,0,-43
6842,0,0,29,0,-29
6843,1,0,32,0,-32
6844,0,0,8,0,-8
6845,0,0,23,0,-23
6846,0,0,3,0,-3
6847,1,0,35,0,-35
6848,1,0,32,0,-32
6849,1,1,1455,1760,305
6850,0,0,20,0,-20
6851,1,0,75,0,-75
6852,0,0,43,0,-43
6853,1,1,86,1524,1438
6854,1,0,174,0,-174
6855,0,0,67,0,-67
6856,0,0,6,0,-6
6857,1,0,1,0,-1
6858,1,1,1657,1452,-205
6859,1,1,195,2370,2175
6860,0,0,117,0,-117
6861,1,1,4,1454,1450
6862,0,0,17,0,-17
6863,1,1,1235,1312,77
6864,1,1,2803,1207,-1596
6865,1,1,1106,1627,521
6866,0,0,53,0,-53
6867,1,1,961,1795,834
6868,1,1,347,1644,1297
6869,1,0,9,0,-9
6870,1,1,208,3084,2876
6871,1,1,506,4211,3705
6872,1,0,11,0,-11
6873,0,0,42,0,-42
6874,0,0,44,0,-44
6875,1,1,519,2264,1745
6876,1,0,30,0,-30
6877,1,0,91,0,-91
6878,1,0,3,0,-3
6879,1,0,200,0,-200
6880,1,1,1599,2509,910
6881,1,1,57,1781,1724
6882,0,0,48,0,-48
6883,0,0,14,0,-14
6884,1,1,1238,2009,771
6885,0,0,20,0,-20
6886,1,0,33,0,-33
6887,1,0,18,0,-18
6888,1,0,122,0,-122
6889,0,0,20,0,-20
6890,0,0,29,0,-29
6891,1,1,84,2321,2237
6892,1,1,362,1300,938
6893,1,1,87,3244,3157
6894,1,1,1094,1329,235
6895,1,0,76,0,-76
6896,1,0,3,0,-3
6897,1,1,874,1909,1035
6898,1,0,31,0,-31
6899,0,0,0,0,0
6900,0,0,18,0,-18
6901,1,0,123,0,-123
6902,0,0,45,0,-45
6903,1,0,27,0,-27
6904,1,1,133,2114,1981
6905,0,0,65,0,-65
6906,1,1,430,1460,1030
6907,0,0,90,0,-90
6908,0,0,20,0,-20
6909,1,1,860,1524,664
6910,1,1,137,1934,1797
6911,0,0,92,0,-92
6912,0,0,25,0,-25
6913,1,0,123,0,-123
6914,1,1,474,1558,1084
6915,1,1,143,1418,1275
6916,1,1,636,1265,629
6917,0,0,13,0,-13
6918,0,0,36,0,-36
6919,1,1,488,1704,1216
6920,1,0,13,0,-13
6921,0,0,109,0,-109
6922,1,1,323,1260,937
6923,1,1,2012,1283,-729
6924,1,0,16,0,-16
6925,0,0,32,0,-32
6926,1,1,1063,1802,739
6927,0,0,48,0,-48
6928,1,0,109,0,-109
6929,1,1,594,1607,1013
6930,1,1,75,2127,2052
6931,0,0,24,0,-24
6932,1,0,32,0,-32
6933,1,1,172,1450,1278
6934,1,0,17,0,-17
6935,1,1,137,1292,1155
6936,1,0,131,0,-131
6937,1,1,646,1220,574
6938,1,0,12,0,-12
6939,0,0,125,0,-125
6940,0,0,29,0,-29
6941,1,1,1598,1293,-305
6942,1,1,127,1411,1284
6943,1,1,1112,1580,468
6944,0,0,39,0,-39
6945,1,1,207,1390,1183
6946,1,0,120,0,-120
6947,1,0,40,0,-40
6948,0,0,10,0,-10
6949,0,0,81,0,-81
6950,1,1,55,2414,2359
6951,1,0,13,0,-13
6952,0,0,98,0,-98
6953,1,0,3,0,-3
6954,0,0,22,0,-22
6955,0,0,26,0,-26
6956,1,1,992,1217,225
6957,1,0,11,0,-11
6958,1,1,467,1719,1252
6959,1,1,577,1406,829
6960,1,1,156,1874,1718
6961,1,1,249,2165,1916
6962,1,0,10,0,-10
6963,1,0,15,0,-15
6964,1,0,40,0,-40
6965,0,0,64,0,-64
6966,0,0,15,0,-15
6967,0,0,98,0,-98
6968,0,0,40,0,-40
6969,0,0,5,0,-5
6970,0,0,10,0,-10
6971,1,0,107,0,-107
6972,1,1,74,2227,2153
6973,0,0,23,0,-23
6974,1,0,6,0,-6
6975,1,1,670,1284,614
6976,0,0,101,0,-101
6977,1,1,415,1752,1337
6978,1,1,194,1272,1078
6979,1,1,364,1891,1527
6980,1,1,419,1519,1100
6981,1,0,70,0,-70
6982,0,0,257,0,-257
6983,1,0,27,0,-27
6984,1,0,29,0,-29
6985,1,1,198,1563,1365
6986,1,0,79,0,-79
6987,1,1,457,1420,963
6988,1,1,764,1672,908
6989,1,1,1789,1860,71
6990,0,0,1,0,-1
6991,1,1,10,1267,1257
6992,1,1,373,1886,1513
6993,0,0,70,0,-70
6994,0,0,4,0,-4
6995,1,0,180,0,-180
6996,1,1,1117,1433,316
6997,1,0,13,0,-13
6998,1,1,515,1311,796
6999,1,0,7,0,-7
7000,0,0,44,0,-44
7001,1,1,2153,1706,-447
7002,1,0,93,0,-93
7003,1,1,551,2343,1792
7004,1,1,819,2078,1259
7005,1,1,185,1368,1183
7006,1,0,139,0,-139
7007,0,0,52,0,-52
7008,1,1,505,2750,2245
7009,0,0,65,0,-65
7010,0,0,85,0,-85
7011,0,0,65,0,-65
7012,1,1,1172,1622,450
7013,0,0,12,0,-12
7014,1,0,5,0,-5
7015,1,1,1185,1655,470
7016,0,0,75,0,-75
7017,0,0,54,0,-54
7018,0,0,17,0,-17
7019,0,0,55,0,-55
7020,1,1,360,1726,1366
7021,1,1,319,1426,1107
7022,0,0,197,0,-197
7023,1,0,6,0,-6
7024,0,0,69,0,-69
7025,1,0,5,0,-5
7026,1,0,33,0,-33
7027,0,0,54,0,-54
7028,0,0,153,0,-153
7029,1,0,108,0,-108
7030,1,0,5,0,-5
7031,1,1,358,1764,1406
7032,0,0,45,0,-45
7033,0,0,68,0,-68
7034,1,1,466,1928,1462
7035,0,0,23,0,-23
7036,0,0,62,0,-62
7037,1,0,7,0,-7
7038,1,1,296,1392,1096
7039,1,1,273,1254,981
7040,1,1,828,1231,403
7041,0,0,25,0,-25
7042,1,1,778,1618,840
7043,1,0,189,0,-189
7044,1,0,34,0,-34
7045,1,0,10,0,-10
7046,1,1,1269,1790,521
7047,0,0,32,0,-32
7048,0,0,0,0,0
7049,0,0,55,0,-55
7050,0,0,24,0,-24
7051,1,0,19,0,-19
7052,1,0,151,0,-151
7053,0,0,4,0,-4
7054,0,0,85,0,-85
7055,1,1,599,1359,760
7056,1,1,755,1961,1206
7057,0,0,65,0,-65
7058,1,0,12,0,-12
7059,0,0,44,0,-44
7060,0,0,159,0,-159
7061,1,0,49,0,-49
7062,0,0,17,0,-17
7063,1,0,100,0,-100
7064,1,0,9,0,-9
7065,1,0,14,0,-14
7066,1,1,40,2063,2023
7067,1,1,922,1419,497
7068,1,1,677,2462,1785
7069,1,0,29,0,-29
7070,1,0,64,0,-64
7071,1,1,282,1488,1206
7072,1,1,707,1379,672
7073,0,0,4,0,-4
7074,0,0,40,0,-40
7075,1,0,134,0,-134
7076,1,0,66,0,-66
7077,1,0,31,0,-31
7078,1,1,241,1444,1203
7079,0,0,22,0,-22
7080,0,0,0,0,0
7081,1,0,85,0,-85
7082,0,0,7,0,-7
7083,0,0,4,0,-4
7084,1,1,291,1395,1104
7085,0,0,114,0,-114
7086,1,0,63,0,-63
7087,1,1,1708,4132,2424
7088,1,0,23,0,-23
7089,0,0,21,0,-21
7090,0,0,53,0,-53
7091,0,0,110,0,-110
7092,1,0,35,0,-35
7093,1,0,102,0,-102
7094,0,0,9,0,-9
7095,1,1,554,1928,1374
7096,1,0,196,0,-196
7097,1,0,68,0,-68
7098,0,0,41,0,-41
7099,1,1,142,1769,1627
7100,0,0,84,0,-84
7101,1,0,50,0,-50
7102,0,0,25,0,-25
7103,0,0,19,0,-19
7104,0,0,57,0,-57
7105,1,1,535,1253,718
7106,0,0,50,0,-50
7107,1,0,13,0,-13
7108,1,0,60,0,-60
7109,1,1,118,1530,1412
7110,1,1,462,1956,1494
7111,1,0,12,0,-12
7112,1,1,201,1612,1411
7113,0,0,55,0,-55
7114,1,0,12,0,-12
7115,1,1,838,1285,447
7116,0,0,35,0,-35
7117,0,0,5,0,-5
7118,1,1,398,1219,821
7119,0,0,75,0,-75
7120,0,0,232,0,-232
7121,1,1,388,2178,1790
7122,0,0,10,0,-10
7123,1,1,126,1260,1134
7124,0,0,4,0,-4
7125,1,1,479,1251,772
7126,1,1,315,1293,978
7127,0,0,27,0,-27
7128,0,0,33,0,-33
7129,0,0,5,0,-5
7130,1,1,343,1241,898
7131,0,0,18,0,-18
7132,1,0,12,0,-12
7133,1,1,181,1750,1569
7134,1,0,17,0,-17
7135,1,1,138,1753,1615
7136,1,0,5,0,-5
7137,0,0,59,0,-59
7138,1,1,287,1318,1031
7139,1,0,4,0,-4
7140,0,0,28,0,-28
7141,1,0,56,0,-56
7142,1,0,122,0,-122
7143,1,0,71,0,-71
7144,0,0,32,0,-32
7145,0,0,26,0,-26
7146,0,0,27,0,-27
7147,1,1,984,1234,250
7148,1,1,366,1693,1327
7149,1,0,31,0,-31
7150,0,0,4,0,-4
7151,1,0,19,0,-19
7152,1,0,35,0,-35
7153,1,0,12,0,-12
7154,0,0,47,0,-47
7155,1,0,61,0,-61
7156,1,1,1055,1562,507
7157,1,0,0,0,0
7158,0,0,57,0,-57
7159,1,0,24,0,-24
7160,1,0,96,0,-96
7161,0,0,65,0,-65
7162,0,0,170,0,-170
7163,0,0,24,0,-24
7164,0,0,26,0,-26
7165,1,0,52,0,-52
7166,0,0,42,0,-42
7167,0,0,8,0,-8
7168,0,0,0,0,0
7169,1,1,86,1623,1537
7170,0,0,36,0,-36
7171,1,1,1052,2017,965
7172,1,0,7,0,-7
7173,1,1,357,1230,873
7174,1,1,54,3013,2959
7175,1,0,25,0,-25
7176,1,1,509,1351,842
7177,0,0,64,0,-64
7178,1,1,171,1204,1033
7179,1,1,3421,1341,-2080
7180,1,1,369,1499,1130
7181,0,0,113,0,-113
7182,0,0,15,0,-15
7183,1,1,320,1307,987
7184,0,0,54,0,-54
7185,0,0,40,0,-40
7186,0,0,156,0,-156
7187,0,0,8,0,-8
7188,0,0,49,0,-49
7189,0,0,48,0,-48
7190,1,1,513,1270,757
7191,1,0,3,0,-3
7192,0,0,2,0,-2
7193,1,0,22,0,-22
7194,1,0,25,0,-25
7195,0,0,0,0,0
7196,0,0,110,0,-110
7197,1,0,116,0,-116
7198,1,1,270,1386,1116
7199,1,1,512,1278,766
7200,1,1,1556,1209,-347
7201,1,0,174,0,-174
7202,1,0,48,0,-48
7203,0,0,64,0,-64
7204,1,0,10,0,-10
7205,1,0,21,0,-21
7206,0,0,8,0,-8
7207,1,1,423,1461,1038
7208,1,0,109,0,-109
7209,0,0,3,0,-3
7210,0,0,16,0,-16
7211,1,1,477,1364,887
7212,1,1,360,1321,961
7213,1,0,44,0,-44
7214,1,0,60,0,-60
7215,1,1,461,1252,791
7216,1,1,939,1551,612
7217,0,0,92,0,-92
7218,0,0,72,0,-72
7219,0,0,134,0,-134
7220,0,0,55,0,-55
7221,0,0,28,0,-28
7222,0,0,57,0,-57
7223,0,0,134,0,-134
7224,1,1,600,1349,749
7225,1,0,83,0,-83
7226,0,0,65,0,-65
7227,0,0,29,0,-29
7228,0,0,57,0,-57
7229,1,1,584,2399,1815
7230,1,1,204,1417,1213
7231,0,0,15,0,-15
7232,1,1,983,1566,583
7233,1,0,35,0,-35
7234,1,1,868,2526,1658
7235,1,0,234,0,-234
7236,0,0,14,0,-14
7237,0,0,0,0,0
7238,0,0,15,0,-15
7239,1,0,23,0,-23
7240,1,1,115,1245,1130
7241,1,1,928,1206,278
7242,1,1,1194,1204,10
7243,0,0,17,0,-17
7244,1,0,250,0,-250
7245,1,1,1935,1455,-480
7246,0,0,2,0,-2
7247,1,0,66,0,-66
7248,1,0,28,0,-28
7249,0,0,0,0,0
7250,1,1,953,1282,329
7251,1,0,17,0,-17
7252,1,1,794,1720,926
7253,1,1,77,2154,2077
7254,0,0,3,0,-3
7255,1,0,3,0,-3
7256,0,0,33,0,-33
7257,0,0,72,0,-72
7258,0,0,15,0,-15
7259,1,0,52,0,-52
7260,1,1,754,2427,1673
7261,1,0,3,0,-3
7262,1,1,424,1248,824
7263,1,0,89,0,-89
7264,0,0,28,0,-28
7265,1,0,0,0,0
7266,1,0,38,0,-38
7267,0,0,1,0,-1
7268,0,0,7,0,-7
7269,1,1,1384,1310,-74
7270,1,0,79,0,-79
7271,1,1,431,1799,1368
7272,0,0,33,0,-33
7273,0,0,19,0,-19
7274,0,0,7,0,-7
7275,0,0,4,0,-4
7276,1,0,16,0,-16
7277,1,1,835,1721,886
7278,1,0,54,0,-54
7279,1,1,142,2856,2714
7280,1,1,611,1404,793
7281,0,0,48,0,-48
7282,0,0,24,0,-24
7283,0,0,5,0,-5
7284,1,0,161,0,-161
7285,1,0,29,0,-29
7286,0,0,12,0,-12
7287,0,0,76,0,-76
7288,1,0,36,0,-36
7289,1,0,10,0,-10
7290,0,0,9,0,-9
7291,1,1,364,1319,955
7292,1,0,134,0,-134
7293,1,0,38,0,-38
7294,1,0,198,0,-198
7295,1,1,138,1373,1235
7296,0,0,3,0,-3
7297,0,0,130,0,-130
7298,1,0,61,0,-61
7299,0,0,6,0,-6
7300,1,1,577,1241,664
7301,0,0,38,0,-38
7302,1,1,586,1635,1049
7303,1,0,152,0,-152
7304,0,0,162,0,-162
7305,0,0,10,0,-10
7306,1,0,20,0,-20
7307,0,0,16,0,-16
7308,0,0,34,0,-34
7309,1,0,235,0,-235
7310,1,1,729,1277,548
7311,0,0,58,0,-58
7312,1,0,91,0,-91
7313,1,1,538,2486,1948
7314,1,1,222,1337,1115
7315,1,0,78,0,-78
7316,1,0,275,0,-275
7317,0,0,39,0,-39
7318,1,0,12,0,-12
7319,0,0,64,0,-64
7320,0,0,25,0,-25
7321,1,1,2350,1282,-1068
7322,0,0,21,0,-21
7323,1,1,271,1353,1082
7324,1,1,160,1267,1107
7325,0,0,65,0,-65
7326,1,1,1208,2813,1605
7327,1,1,442,1777,1335
7328,1,1,847,1349,502
7329,1,0,13,0,-13
7330,0,0,16,0,-16
7331,0,0,2,0,-2
7332,1,1,720,1226,506
7333,1,1,158,1850,1692
7334,0,0,10,0,-10
7335,1,1,808,1695,887
7336,1,1,647,2379,1732
7337,0,0,27,0,-27
7338,1,0,21,0,-21
7339,1,0,20,0,-20
7340,0,0,34,0,-34
7341,1,1,386,1383,997
7342,1,0,30,0,-30
7343,1,0,11,0,-11
7344,1,1,185,1367,1182
7345,1,1,45,1340,1295
7346,1,1,496,1327,831
7347,1,0,44,0,-44
7348,0,0,95,0,-95
7349,0,0,75,0,-75
7350,1,1,334,1416,1082
7351,0,0,68,0,-68
7352,1,0,22,0,-22
7353,0,0,54,0,-54
7354,1,0,43,0,-43
7355,1,0,112,0,-112
7356,0,0,61,0,-61
7357,0,0,4,0,-4
7358,0,0,8,0,-8
7359,1,0,46,0,-46
7360,0,0,73,0,-73
7361,1,1,369,2020,1651
7362,1,1,384,1218,834
7363,0,0,38,0,-38
7364,1,0,88,0,-88
7365,1,0,28,0,-28
7366,0,0,20,0,-20
7367,0,0,15,0,-15
7368,1,1,422,1299,877
7369,0,0,12,0,-12
7370,0,0,10,0,-10
7371,0,0,64,0,-64
7372,0,0,15,0,-15
7373,0,0,153,0,-153
7374,1,1,374,1306,932
7375,0,0,38,0,-38
7376,0,0,42,0,-42
7377,0,0,14,0,-14
7378,1,0,132,0,-132
7379,1,0,166,0,-166
7380,1,1,235,1594,1359
7381,0,0,98,0,-98
7382,0,0,52,0,-52
7383,1,0,43,0,-43
7384,1,0,31,0,-31
7385,1,0,10,0,-10
7386,0,0,9,0,-9
7387,1,0,27,0,-27
7388,1,0,59,0,-59
7389,0,0,25,0,-25
7390,1,1,596,1347,751
7391,1,0,28,0,-28
7392,1,0,17,0,-17
7393,1,0,117,0,-117
7394,0,0,41,0,-41
7395,0,0,2,0,-2
7396,1,0,88,0,-88
7397,1,0,42,0,-42
7398,1,0,9,0,-9
7399,0,0,35,0,-35
7400,0,0,138,0,-138
7401,1,0,21,0,-21
7402,1,0,91,0,-91
7403,1,1,938,1333,395
7404,0,0,36,0,-36
7405,0,0,58,0,-58
7406,1,0,82,0,-82
7407,0,0,19,0,-19
7408,1,1,662,2659,1997
7409,1,0,0,0,0
7410,1,1,667,2161,1494
7411,1,0,65,0,-65
7412,1,1,294,1361,1067
7413,1,0,19,0,-19
7414,1,0,60,0,-60
7415,1,0,10,0,-10
7416,0,0,61,0,-61
7417,0,0,14,0,-14
7418,1,0,68,0,-68
7419,1,1,269,1551,1282
7420,1,0,65,0,-65
7421,1,0,27,0,-27
7422,0,0,105,0,-105
7423,0,0,66,0,-66
7424,0,0,12,0,-12
7425,0,0,189,0,-189
7426,1,0,15,0,-15
7427,1,1,483,1376,893
7428,1,1,425,1550,1125
7429,1,0,21,0,-21
7430,0,0,89,0,-89
7431,1,1,248,1321,1073
7432,1,1,278,1568,1290
7433,0,0,7,0,-7
7434,0,0,258,0,-258
7435,1,1,677,1347,670
7436,1,0,10,0,-10
7437,0,0,24,0,-24
7438,0,0,18,0,-18
7439,0,0,75,0,-75
7440,0,0,18,0,-18
7441,0,0,0,0,0
7442,1,1,437,1265,828
7443,0,0,34,0,-34
7444,0,0,73,0,-73
7445,0,0,142,0,-142
7446,1,1,108,1598,1490
7447,1,0,12,0,-12
7448,1,0,50,0,-50
7449,0,0,146,0,-146
7450,0,0,46,0,-46
7451,1,1,97,1543,1446
7452,1,0,44,0,-44
7453,0,0,14,0,-14
7454,0,0,51,0,-51
7455,1,0,21,0,-21
7456,0,0,19,0,-19
7457,1,1,630,2017,1387
7458,1,0,5,0,-5
7459,0,0,6,0,-6
7460,0,0,60,0,-60
7461,1,1,301,2572,2271
7462,1,1,131,1440,1309
7463,1,1,1830,4989,3159
7464,0,0,23,0,-23
7465,0,0,29,0,-29
7466,0,0,14,0,-14
7467,1,1,847,1648,801
7468,0,0,11,0,-11
7469,0,0,43,0,-43
7470,0,0,6,0,-6
7471,0,0,9,0,-9
7472,0,0,38,0,-38
7473,0,0,211,0,-211
7474,1,0,156,0,-156
7475,0,0,89,0,-89
7476,0,0,31,0,-31
7477,1,1,331,1248,917
7478,0,0,5,0,-5
7479,0,0,8,0,-8
7480,0,0,16,0,-16
7481,0,0,105,0,-105
7482,1,1,377,1424,1047
7483,0,0,1,0,-1
7484,0,0,22,0,-22
7485,1,1,21,1326,1305
7486,1,1,828,1384,556
7487,0,0,12,0,-12
7488,0,0,68,0,-68
7489,1,1,453,1203,750
7490,1,1,172,1345,1173
7491,0,0,50,0,-50
7492,1,1,171,1265,1094
7493,1,1,687,1300,613
7494,1,0,13,0,-13
7495,0,0,1,0,-1
7496,1,0,71,0,-71
7497,0,0,87,0,-87
7498,1,0,87,0,-87
7499,1,1,759,1805,1046
7500,1,0,123,0,-123
7501,1,1,303,3329,3026
7502,1,1,49,1244,1195
7503,1,1,814,3384,2570
7504,1,1,405,1842,1437
7505,1,1,990,1985,995
7506,0,0,38,0,-38
7507,0,0,134,0,-134
7508,0,0,68,0,-68
7509,0,0,67,0,-67
7510,1,0,17,0,-17
7511,1,0,46,0,-46
7512,0,0,84,0,-84
7513,1,0,26,0,-26
7514,1,0,28,0,-28
7515,1,0,24,0,-24
7516,0,0,119,0,-119
7517,0,0,62,0,-62
7518,1,1,1549,1291,-258
7519,0,0,126,0,-126
7520,1,0,78,0,-78
7521,1,1,389,1248,859
7522,1,0,207,0,-207
7523,1,1,684,1280,596
7524,1,1,327,2198,1871
7525,1,1,198,1342,1144
7526,1,0,6,0,-6
7527,0,0,19,0,-19
7528,1,0,20,0,-20
7529,1,0,30,0,-30
7530,1,1,1287,1319,32
7531,1,0,39,0,-39
7532,1,1,637,1351,714
7533,0,0,13,0,-13
7534,1,0,181,0,-181
7535,0,0,29,0,-29
7536,1,1,718,1210,492
7537,1,0,27,0,-27
7538,1,1,317,1967,1650
7539,1,1,1251,1208,-43
7540,1,0,62,0,-62
7541,1,0,23,0,-23
7542,0,0,14,0,-14
7543,1,1,117,1497,1380
7544,0,0,0,0,0
7545,1,0,27,0,-27
7546,0,0,46,0,-46
7547,1,1,1220,1446,226
7548,1,1,267,2638,2371
7549,0,0,66,0,-66
7550,1,1,68,1384,1316
7551,1,1,407,1400,993
7552,0,0,83,0,-83
7553,1,1,618,1863,1245
7554,1,1,431,1849,1418
7555,1,1,620,2023,1403
7556,1,0,20,0,-20
7557,0,0,26,0,-26
7558,0,0,27,0,-27
7559,0,0,91,0,-91
7560,1,1,309,1544,1235
7561,1,1,98,1320,1222
7562,1,1,1044,1564,520
7563,0,0,18,0,-18
7564,0,0,43,0,-43
7565,0,0,11,0,-11
7566,0,0,47,0,-47
7567,1,0,19,0,-19
7568,1,1,311,1237,926
7569,0,0,47,0,-47
7570,1,0,10,0,-10
7571,0,0,12,0,-12
7572,1,0,28,0,-28
7573,0,0,60,0,-60
7574,1,0,59,0,-59
7575,1,0,106,0,-106
7576,1,0,138,0,-138
7577,1,0,75,0,-75
7578,1,0,32,0,-32
7579,0,0,2,0,-2
7580,1,1,580,1857,1277
7581,1,1,841,1306,465
7582,1,0,77,0,-77
7583,0,0,35,0,-35
7584,0,0,89,0,-89
7585,0,0,59,0,-59
7586,0,0,81,0,-81
7587,1,0,147,0,-147
7588,1,1,1914,2835,921
7589,0,0,131,0,-131
7590,1,0,24,0,-24
7591,1,1,236,2978,2742
7592,0,0,78,0,-78
7593,0,0,135,0,-135
7594,0,0,30,0,-30
7595,1,1,1598,1449,-149
7596,1,0,117,0,-117
7597,1,0,15,0,-15
7598,1,0,41,0,-41
7599,1,0,112,0,-112
7600,1,1,748,1530,782
7601,0,0,6,0,-6
7602,1,0,41,0,-41
7603,1,1,361,1252,891
7604,0,0,150,0,-150
7605,1,0,78,0,-78
7606,0,0,7,0,-7
7607,0,0,4,0,-4
7608,1,0,28,0,-28
7609,1,1,192,1388,1196
7610,0,0,5,0,-5
7611,0,0,76,0,-76
7612,0,0,41,0,-41
7613,0,0,123,0,-123
7614,1,0,31,0,-31
7615,1,0,73,0,-73
7616,0,0,12,0,-12
7617,0,0,11,0,-11
7618,1,0,4,0,-4
7619,1,0,59,0,-59
7620,1,0,37,0,-37
7621,1,1,1297,1440,143
7622,1,0,4,0,-4
7623,1,0,16,0,-16
7624,1,1,164,1871,1707
7625,1,1,164,1234,1070
7626,1,0,16,0,-16
7627,1,0,70,0,-70
7628,0,0,21,0,-21
7629,0,0,18,0,-18
7630,1,0,25,0,-25
7631,1,0,78,0,-78
7632,1,0,31,0,-31
7633,1,1,763,1898,1135
7634,0,0,27,0,-27
7635,0,0,24,0,-24
7636,0,0,11,0,-11
7637,1,1,160,1438,1278
7638,1,1,396,1243,847
7639,0,0,12,0,-12
7640,1,1,65,3093,3028
7641,0,0,128,0,-128
7642,0,0,71,0,-71
7643,1,0,69,0,-69
7644,0,0,9,0,-9
7645,1,0,37,0,-37
7646,0,0,91,0,-91
7647,1,1,262,1425,1163
7648,0,0,71,0,-71
7649,0,0,33,0,-33
7650,0,0,41,0,-41
7651,1,1,1017,1384,367
7652,1,1,1613,1431,-182
7653,0,0,13,0,-13
7654,0,0,17,0,-17
7655,1,1,266,2581,2315
7656,1,1,289,2560,2271
7657,1,0,49,0,-49
7658,0,0,68,0,-68
7659,0,0,21,0,-21
7660,1,1,402,1545,1143
7661,0,0,33,0,-33
7662,1,0,146,0,-146
7663,1,0,94,0,-94
7664,1,0,214,0,-214
7665,0,0,7,0,-7
7666,0,0,32,0,-32
7667,1,1,279,1325,1046
7668,0,0,58,0,-58
7669,1,0,11,0,-11
7670,1,0,25,0,-25
7671,1,0,45,0,-45
7672,1,0,187,0,-187
7673,1,0,28,0,-28
7674,1,0,43,0,-43
7675,0,0,206,0,-206
7676,0,0,0,0,0
7677,1,1,1279,1561,282
7678,0,0,123,0,-123
7679,1,1,692,1702,1010
7680,1,0,82,0,-82
7681,1,0,9,0,-9
7682,0,0,30,0,-30
7683,1,1,176,2816,2640
7684,0,0,32,0,-32
7685,0,0,111,0,-111
7686,1,0,34,0,-34
7687,0,0,29,0,-29
7688,0,0,8,0,-8
7689,0,0,4,0,-4
7690,1,0,40,0,-40
7691,1,1,124,1760,1636
7692,1,1,299,1229,930
7693,0,0,39,0,-39
7694,1,1,241,1841,1600
7695,0,0,68,0,-68
7696,1,0,50,0,-50
7697,1,1,782,1241,459
7698,0,0,3,0,-3
7699,1,1,599,1668,1069
7700,1,1,813,1860,1047
7701,0,0,12,0,-12
7702,0,0,37,0,-37
7703,1,0,75,0,-75
7704,1,0,62,0,-62
7705,1,1,114,1466,1352
7706,0,0,119,0,-119
7707,1,0,14,0,-14
7708,0,0,26,0,-26
7709,1,0,38,0,-38
7710,1,1,484,1240,756
7711,0,0,2,0,-2
7712,1,1,254,1300,1046
7713,1,0,5,0,-5
7714,0,0,2,0,-2
7715,0,0,29,0,-29
7716,1,1,38,1222,1184
7717,0,0,42,0,-42
7718,0,0,156,0,-156
7719,0,0,13,0,-13
7720,1,0,68,0,-68
7721,1,0,41,0,-41
7722,1,0,3,0,-3
7723,0,0,129,0,-129
7724,0,0,19,0,-19
7725,1,0,128,0,-128
7726,0,0,10,0,-10
7727,0,0,25,0,-25
7728,1,0,16,0,-16
7729,1,0,36,0,-36
7730,0,0,77,0,-77
7731,1,0,38,0,-38
7732,0,0,40,0,-40
7733,0,0,18,0,-18
7734,0,0,49,0,-49
7735,0,0,16,0,-16
7736,0,0,207,0,-207
7737,0,0,61,0,-61
7738,1,1,691,1474,783
7739,0,0,73,0,-73
7740,1,1,547,1576,1029
7741,1,1,461,1297,836
7742,1,1,427,1530,1103
7743,1,0,81,0,-81
7744,1,0,6,0,-6
7745,1,0,6,0,-6
7746,1,0,10,0,-10
7747,1,1,358,3653,3295
7748,0,0,33,0,-33
7749,0,0,12,0,-12
7750,0,0,88,0,-88
7751,1,0,53,0,-53
7752,1,1,799,1369,570
7753,0,0,236,0,-236
7754,0,0,41,0,-41
7755,0,0,93,0,-93
7756,1,1,554,1490,936
7757,1,0,5,0,-5
7758,0,0,5,0,-5
7759,1,0,148,0,-148
7760,1,1,968,1502,534
7761,1,0,12,0,-12
7762,1,0,4,0,-4
7763,1,0,30,0,-30
7764,0,0,41,0,-41
7765,1,0,5,0,-5
7766,1,0,66,0,-66
7767,1,1,138,1362,1224
7768,1,0,10,0,-10
7769,1,0,28,0,-28
7770,1,0,97,0,-97
7771,1,0,7,0,-7
7772,1,1,140,1202,1062
7773,1,1,1173,1283,110
7774,0,0,51,0,-51
7775,1,1,1306,2134,828
7776,0,0,12,0,-12
7777,0,0,24,0,-24
7778,1,0,14,0,-14
7779,0,0,58,0,-58
7780,0,0,20,0,-20
7781,0,0,93,0,-93
7782,0,0,27,0,-27
7783,1,0,0,0,0
7784,1,1,342,1350,1008
7785,1,1,151,1407,1256
7786,1,1,114,1693,1579
7787,0,0,7,0,-7
7788,1,1,153,1386,1233
7789,0,0,76,0,-76
7790,0,0,29,0,-29
7791,1,0,138,0,-138
7792,0,0,50,0,-50
7793,1,1,1175,2918,1743
7794,0,0,53,0,-53
7795,0,0,28,0,-28
7796,1,1,2283,1491,-792
7797,1,1,1590,1318,-272
7798,0,0,77,0,-77
7799,0,0,47,0,-47
7800,0,0,6,0,-6
7801,0,0,21,0,-21
7802,1,0,32,0,-32
7803,0,0,10,0,-10
7804,0,0,187,0,-187
7805,1,0,9,0,-9
7806,1,0,93,0,-93
7807,0,0,15,0,-15
7808,0,0,25,0,-25
7809,1,1,1102,1723,621
7810,0,0,21,0,-21
7811,0,0,91,0,-91
7812,0,0,210,0,-210
7813,0,0,281,0,-281
7814,0,0,99,0,-99
7815,1,1,132,1436,1304
7816,1,1,880,3493,2613
7817,1,0,38,0,-38
7818,1,1,71,1367,1296
7819,1,0,15,0,-15
7820,0,0,19,0,-19
7821,1,1,577,1383,806
7822,1,0,6,0,-6
7823,1,0,65,0,-65
7824,1,0,55,0,-55
7825,1,0,55,0,-55
7826,1,1,361,1330,969
7827,0,0,65,0,-65
7828,0,0,48,0,-48
7829,0,0,27,0,-27
7830,0,0,86,0,-86
7831,1,1,343,1252,909
7832,0,0,54,0,-54
7833,1,0,0,0,0
7834,1,0,125,0,-125
7835,0,0,46,0,-46
7836,1,0,36,0,-36
7837,1,1,1033,1465,432
7838,1,0,31,0,-31
7839,0,0,44,0,-44
7840,0,0,35,0,-35
7841,1,0,91,0,-91
7842,0,0,49,0,-49
7843,0,0,73,0,-73
7844,0,0,48,0,-48
7845,1,1,282,1367,1085
7846,0,0,165,0,-165
7847,1,0,193,0,-193
7848,1,1,1195,1327,132
7849,0,0,48,0,-48
7850,0,0,15,0,-15
7851,1,1,1009,1754,745
7852,0,0,13,0,-13
7853,0,0,57,0,-57
7854,1,1,99,1477,1378
7855,1,1,1390,1457,67
7856,1,1,228,2082,1854
7857,0,0,155,0,-155
7858,1,0,22,0,-22
7859,1,1,401,1285,884
7860,1,0,23,0,-23
7861,1,0,85,0,-85
7862,1,0,12,0,-12
7863,0,0,80,0,-80
7864,0,0,98,0,-98
7865,1,1,847,1800,953
7866,1,1,403,2311,1908
7867,1,0,217,0,-217
7868,0,0,13,0,-13
7869,0,0,23,0,-23
7870,0,0,24,0,-24
7871,0,0,65,0,-65
7872,0,0,18,0,-18
7873,0,0,0,0,0
7874,1,0,47,0,-47
7875,1,1,249,1252,1003
7876,1,0,2,0,-2
7877,0,0,60,0,-60
7878,0,0,3,0,-3
7879,1,0,17,0,-17
7880,0,0,8,0,-8
7881,1,1,414,1424,1010
7882,1,0,7,0,-7
7883,0,0,108,0,-108
7884,0,0,6,0,-6
7885,1,0,35,0,-35
7886,1,0,41,0,-41
7887,1,1,506,1230,724
7888,0,0,29,0,-29
7889,0,0,2,0,-2
7890,1,1,75,1546,1471
7891,1,1,204,1215,1011
7892,1,0,2,0,-2
7893,0,0,5,0,-5
7894,0,0,16,0,-16
7895,1,0,14,0,-14
7896,0,0,25,0,-25
7897,1,1,1094,1271,177
7898,0,0,88,0,-88
7899,0,0,69,0,-69
7900,1,1,508,1592,1084
7901,1,1,1224,1218,-6
7902,1,1,1483,1808,325
7903,0,0,0,0,0
7904,0,0,27,0,-27
7905,0,0,117,0,-117
7906,1,0,11,0,-11
7907,0,0,8,0,-8
7908,1,0,40,0,-40
7909,1,0,65,0,-65
7910,0,0,27,0,-27
7911,1,0,304,0,-304
7912,0,0,78,0,-78
7913,0,0,38,0,-38
7914,1,0,75,0,-75
7915,1,1,177,1999,1822
7916,1,0,40,0,-40
7917,1,0,102,0,-102
7918,1,0,64,0,-64
7919,1,1,1025,1237,212
7920,0,0,27,0,-27
7921,1,1,1053,2124,1071
7922,0,0,29,0,-29
7923,0,0,2,0,-2
7924,1,0,84,0,-84
7925,0,0,188,0,-188
7926,1,0,54,0,-54
7927,1,1,683,1533,850
7928,0,0,8,0,-8
7929,0,0,175,0,-175
7930,1,1,200,1302,1102
7931,0,0,25,0,-25
7932,1,0,24,0,-24
7933,1,1,59,1264,1205
7934,1,1,49,1203,1154
7935,1,1,627,1322,695
7936,1,0,63,0,-63
7937,0,0,58,0,-58
7938,1,1,608,1434,826
7939,1,0,85,0,-85
7940,1,0,27,0,-27
7941,1,1,477,1896,1419
7942,0,0,85,0,-85
7943,1,0,0,0,0
7944,0,0,28,0,-28
7945,1,0,44,0,-44
7946,1,1,625,1213,588
7947,0,0,56,0,-56
7948,0,0,0,0,0
7949,1,1,38,1961,1923
7950,1,0,20,0,-20
7951,0,0,77,0,-77
7952,1,0,92,0,-92
7953,1,1,1407,1347,-60
7954,0,0,23,0,-23
7955,1,1,823,1206,383
7956,0,0,47,0,-47
7957,1,1,131,1504,1373
7958,1,0,45,0,-45
7959,1,1,90,1327,1237
7960,1,0,99,0,-99
7961,1,1,522,1927,1405
7962,1,1,313,1566,1253
7963,1,0,2,0,-2
7964,1,0,30,0,-30
7965,0,0,9,0,-9
7966,1,1,329,1489,1160
7967,1,1,585,1549,964
7968,1,0,93,0,-93
7969,1,0,2,0,-2
7970,0,0,27,0,-27
7971,0,0,152,0,-152
7972,1,1,298,1381,1083
7973,1,1,341,1495,1154
7974,1,1,278,1458,1180
7975,0,0,6,0,-6
7976,1,0,49,0,-49
7977,0,0,12,0,-12
7978,1,0,96,0,-96
7979,1,0,13,0,-13
7980,0,0,1,0,-1
7981,1,1,126,1636,1510
7982,1,0,16,0,-16
7983,0,0,59,0,-59
7984,0,0,115,0,-115
7985,1,0,11,0,-11
7986,1,0,36,0,-36
7987,0,0,51,0,-51
7988,1,1,2035,1456,-579
7989,0,0,63,0,-63
7990,1,1,453,1293,840
7991,1,0,48,0,-48
7992,1,0,103,0,-103
7993,0,0,6,0,-6
7994,1,0,99,0,-99
7995,1,1,1160,1220,60
7996,1,0,224,0,-224
7997,1,1,1229,1361,132
7998,1,0,56,0,-56
7999,0,0,14,0,-14
8000,1,0,42,0,-42
8001,0,0,7,0,-7
8002,1,1,595,1370,775
8003,1,0,40,0,-40
8004,1,1,887,1515,628
8005,0,0,70,0,-70
8006,0,0,1,0,-1
8007,1,0,12,0,-12
8008,1,1,155,1266,1111
8009,0,0,32,0,-32
8010,1,1,316,1767,1451
8011,1,1,697,1390,693
8012,1,0,78,0,-78
8013,0,0,70,0,-70
8014,0,0,23,0,-23
8015,0,0,41,0,-41
8016,1,0,55,0,-55
8017,0,0,0,0,0
8018,0,0,264,0,-264
8019,1,1,861,1402,541
8020,0,0,61,0,-61
8021,1,1,1632,1443,-189
8022,1,1,790,1366,576
8023,0,0,116,0,-116
8024,1,1,92,1285,1193
8025,1,1,35,1773,1738
8026,1,1,1390,1378,-12
8027,0,0,11,0,-11
8028,0,0,82,0,-82
8029,0,0,37,0,-37
8030,0,0,18,0,-18
8031,0,0,44,0,-44
8032,0,0,15,0,-15
8033,1,0,135,0,-135
8034,1,1,875,2051,1176
8035,1,0,22,0,-22
8036,1,1,216,1272,1056
8037,1,0,131,0,-131
8038,1,1,46,1534,1488
8039,1,0,40,0,-40
8040,0,0,0,0,0
8041,1,0,74,0,-74
8042,1,0,9,0,-9
8043,1,1,2068,1704,-364
8044,0,0,15,0,-15
8045,1,0,50,0,-50
8046,1,0,87,0,-87
8047,1,0,38,0,-38
8048,0,0,1,0,-1
8049,1,0,38,0,-38
8050,0,0,17,0,-17
8051,0,0,10,0,-10
8052,0,0,56,0,-56
8053,1,1,76,1230,1154
8054,0,0,60,0,-60
8055,1,1,511,1677,1166
8056,0,0,3,0,-3
8057,1,0,56,0,-56
8058,0,0,3,0,-3
8059,0,0,59,0,-59
8060,1,1,1832,1395,-437
8061,1,1,161,1332,1171
8062,1,1,390,1236,846
8063,0,0,22,0,-22
8064,1,1,1107,1289,182
8065,1,1,906,1498,592
8066,1,1,565,1636,1071
8067,1,0,48,0,-48
8068,1,1,445,1751,1306
8069,0,0,53,0,-53
8070,0,0,27,0,-27
8071,0,0,24,0,-24
8072,1,1,316,1304,988
8073,0,0,51,0,-51
8074,1,0,36,0,-36
8075,1,0,83,0,-83
8076,1,0,15,0,-15
8077,1,1,7,1296,1289
8078,0,0,75,0,-75
8079,0,0,11,0,-11
8080,0,0,6,0,-6
8081,1,0,33,0,-33
8082,0,0,74,0,-74
8083,0,0,49,0,-49
8084,0,0,20,0,-20
8085,1,1,1908,3722,1814
8086,1,1,310,1596,1286
8087,1,1,483,1350,867
8088,1,1,815,1258,443
8089,1,1,3070,1311,-1759
8090,0,0,23,0,-23
8091,1,0,80,0,-80
8092,1,1,997,1841,844
8093,0,0,17,0,-17
8094,0,0,26,0,-26
8095,0,0,19,0,-19
8096,1,1,224,1442,1218
8097,1,0,14,0,-14
8098,1,1,477,1515,1038
8099,0,0,10,0,-10
8100,1,1,792,1276,484
8101,0,0,30,0,-30
8102,1,1,375,1227,852
8103,1,1,248,2386,2138
8104,1,1,391,1383,992
8105,0,0,102,0,-102
8106,1,1,1364,1405,41
8107,1,0,125,0,-125
8108,1,0,21,0,-21
8109,0,0,22,0,-22
8110,1,0,28,0,-28
8111,1,1,128,2015,1887
8112,1,0,0,0,0
8113,1,1,303,1461,1158
8114,0,0,27,0,-27
8115,1,0,6,0,-6
8116,1,1,452,3854,3402
8117,1,0,0,0,0
8118,1,0,29,0,-29
8119,0,0,13,0,-13
8120,1,1,245,1208,963
8121,1,1,434,1493,1059
8122,1,0,25,0,-25
8123,1,1,342,1203,861
8124,1,1,760,1206,446
8125,1,1,497,1895,1398
8126,1,1,1706,1446,-260
8127,0,0,0,0,0
8128,1,1,439,1534,1095
8129,0,0,20,0,-20
8130,1,0,52,0,-52
8131,1,0,4,0,-4
8132,0,0,40,0,-40
8133,1,1,204,1342,1138
8134,1,1,20,1556,1536
8135,1,0,24,0,-24
8136,0,0,19,0,-19
8137,1,1,1774,1851,77
8138,1,0,4,0,-4
8139,0,0,34,0,-34
8140,0,0,9,0,-9
8141,1,0,0,0,0
8142,1,1,388,1335,947
8143,1,0,56,0,-56
8144,0,0,141,0,-141
8145,0,0,10,0,-10
8146,0,0,49,0,-49
8147,1,1,196,1326,1130
8148,0,0,99,0,-99
8149,1,0,12,0,-12
8150,0,0,47,0,-47
8151,1,1,1066,1259,193
8152,1,1,444,1656,1212
8153,0,0,48,0,-48
8154,1,1,1508,2135,627
8155,1,1,197,1345,1148
8156,1,0,2,0,-2
8157,0,0,2,0,-2
8158,1,1,608,1565,957
8159,1,0,35,0,-35
8160,1,0,97,0,-97
8161,1,0,66,0,-66
8162,1,1,669,1231,562
8163,1,1,43,1440,1397
8164,0,0,174,0,-174
8165,1,0,0,0,0
8166,1,1,372,1546,1174
8167,0,0,23,0,-23
8168,0,0,32,0,-32
8169,1,0,4,0,-4
8170,0,0,68,0,-68
8171,1,1,371,1207,836
8172,1,0,33,0,-33
8173,1,0,51,0,-51
8174,0,0,65,0,-65
8175,1,0,32,0,-32
8176,1,1,24,1479,1455
8177,0,0,21,0,-21
8178,0,0,114,0,-114
8179,1,0,1,0,-1
8180,0,0,75,0,-75
8181,1,1,619,1846,1227
8182,1,1,489,1223,734
8183,0,0,48,0,-48
8184,1,1,127,1641,1514
8185,1,0,98,0,-98
8186,1,0,1,0,-1
8187,1,1,126,1464,1338
8188,1,1,1907,1719,-188
8189,1,0,45,0,-45
8190,1,0,70,0,-70
8191,0,0,12,0,-12
8192,0,0,80,0,-80
8193,1,0,123,0,-123
8194,0,0,20,0,-20
8195,0,0,59,0,-59
8196,1,0,116,0,-116
8197,1,0,19,0,-19
8198,0,0,1,0,-1
8199,1,0,98,0,-98
8200,0,0,41,0,-41
8201,1,1,377,1262,885
8202,1,1,262,1236,974
8203,0,0,44,0,-44
8204,1,0,40,0,-40
8205,1,1,211,1724,1513
8206,1,0,3,0,-3
8207,0,0,15,0,-15
8208,0,0,34,0,-34
8209,0,0,32,0,-32
8210,0,0,4,0,-4
8211,1,0,73,0,-73
8212,0,0,16,0,-16
8213,1,0,7,0,-7
8214,1,1,284,1528,1244
8215,0,0,58,0,-58
8216,1,0,60,0,-60
8217,1,1,510,1444,934
8218,0,0,163,0,-163
8219,1,0,69,0,-69
8220,1,1,669,1302,633
8221,1,1,2057,1349,-708
8222,1,1,276,1808,1532
8223,1,0,25,0,-25
8224,0,0,15,0,-15
8225,0,0,32,0,-32
8226,1,0,114,0,-114
8227,0,0,12,0,-12
8228,1,1,508,1219,711
8229,1,0,17,0,-17
8230,1,0,120,0,-120
8231,0,0,59,0,-59
8232,0,0,64,0,-64
8233,0,0,155,0,-155
8234,0,0,106,0,-106
8235,0,0,13,0,-13
8236,0,0,59,0,-59
8237,0,0,8,0,-8
8238,1,1,575,2151,1576
8239,0,0,80,0,-80
8240,1,0,19,0,-19
8241,1,0,106,0,-106
8242,1,1,389,1661,1272
8243,0,0,6,0,-6
8244,1,0,68,0,-68
8245,1,1,193,1668,1475
8246,1,0,112,0,-112
8247,0,0,54,0,-54
8248,1,1,1530,1338,-192
8249,1,0,23,0,-23
8250,0,0,13,0,-13
8251,1,0,21,0,-21
8252,1,1,560,1225,665
8253,0,0,42,0,-42
8254,0,0,11,0,-11
8255,1,0,122,0,-122
8256,0,0,20,0,-20
8257,0,0,17,0,-17
8258,0,0,7,0,-7
8259,1,0,89,0,-89
8260,1,0,22,0,-22
8261,0,0,5,0,-5
8262,1,1,481,1232,751
8263,0,0,7,0,-7
8264,0,0,24,0,-24
8265,1,0,23,0,-23
8266,0,0,75,0,-75
8267,0,0,41,0,-41
8268,1,1,1363,1863,500
8269,0,0,102,0,-102
8270,0,0,124,0,-124
8271,0,0,24,0,-24
8272,1,1,278,1350,1072
8273,1,1,246,1297,1051
8274,1,0,39,0,-39
8275,1,0,10,0,-10
8276,1,0,51,0,-51
8277,0,0,49,0,-49
8278,1,1,567,1205,638
8279,1,1,1481,2402,921
8280,1,0,18,0,-18
8281,1,0,0,0,0
8282,1,0,49,0,-49
8283,0,0,30,0,-30
8284,0,0,225,0,-225
8285,1,1,2247,1391,-856
8286,0,0,70,0,-70
8287,1,0,118,0,-118
8288,0,0,18,0,-18
8289,1,1,206,1682,1476
8290,1,0,18,0,-18
8291,0,0,43,0,-43
8292,1,0,33,0,-33
8293,1,0,11,0,-11
8294,1,0,3,0,-3
8295,1,0,19,0,-19
8296,0,0,24,0,-24
8297,0,0,42,0,-42
8298,1,1,1282,1830,548
8299,1,1,741,3870,3129
8300,0,0,66,0,-66
8301,1,0,27,0,-27
8302,1,0,20,0,-20
8303,1,0,16,0,-16
8304,0,0,12,0,-12
8305,1,0,54,0,-54
8306,1,1,254,1635,1381
8307,1,1,417,1710,1293
8308,1,0,15,0,-15
8309,1,1,449,1553,1104
8310,1,0,74,0,-74
8311,1,0,13,0,-13
8312,0,0,142,0,-142
8313,0,0,16,0,-16
8314,0,0,10,0,-10
8315,0,0,10,0,-10
8316,1,0,12,0,-12
8317,0,0,56,0,-56
8318,0,0,219,0,-219
8319,1,0,23,0,-23
8320,1,0,27,0,-27
8321,1,0,2,0,-2
8322,1,1,272,1855,1583
8323,1,0,27,0,-27
8324,1,0,6,0,-6
8325,0,0,150,0,-150
8326,0,0,21,0,-21
8327,0,0,26,0,-26
8328,0,0,9,0,-9
8329,1,0,91,0,-91
8330,1,0,14,0,-14
8331,0,0,86,0,-86
8332,0,0,27,0,-27
8333,1,1,703,1286,583
8334,0,0,101,0,-101
8335,1,0,14,0,-14
8336,1,1,73,1563,1490
8337,1,0,92,0,-92
8338,0,0,44,0,-44
8339,1,1,1893,1470,-423
8340,0,0,95,0,-95
8341,0,0,28,0,-28
8342,1,1,894,1269,375
8343,0,0,1,0,-1
8344,1,0,106,0,-106
8345,1,1,127,1222,1095
8346,1,1,552,2238,1686
8347,1,1,1268,2658,1390
8348,0,0,89,0,-89
8349,0,0,120,0,-120
8350,0,0,3,0,-3
8351,0,0,22,0,-22
8352,0,0,40,0,-40
8353,1,1,1417,1206,-211
8354,1,1,725,2397,1672
8355,0,0,16,0,-16
8356,1,1,731,1449,718
8357,1,0,63,0,-63
8358,0,0,141,0,-141
8359,1,1,856,1484,628
8360,1,1,271,1217,946
8361,1,1,220,1285,1065
8362,1,1,131,2353,2222
8363,1,1,164,1223,1059
8364,1,1,2132,2295,163
8365,1,0,119,0,-119
8366,1,0,3,0,-3
8367,0,0,82,0,-82
8368,1,0,33,0,-33
8369,0,0,29,0,-29
8370,1,0,24,0,-24
8371,1,1,608,1875,1267
8372,0,0,47,0,-47
8373,1,0,26,0,-26
8374,1,1,298,1222,924
8375,1,0,5,0,-5
8376,1,1,535,1752,1217
8377,1,0,3,0,-3
8378,1,0,71,0,-71
8379,1,0,32,0,-32
8380,0,0,10,0,-10
8381,1,1,239,1523,1284
8382,0,0,160,0,-160
8383,1,0,18,0,-18
8384,1,1,1656,1682,26
8385,1,1,252,1235,983
8386,1,0,29,0,-29
8387,0,0,155,0,-155
8388,1,1,397,1250,853
8389,1,1,352,1649,1297
8390,1,1,1317,1268,-49
8391,0,0,10,0,-10
8392,1,1,179,1336,1157
8393,0,0,40,0,-40
8394,1,1,1295,1577,282
8395,1,0,26,0,-26
8396,0,0,50,0,-50
8397,1,0,54,0,-54
8398,0,0,33,0,-33
8399,0,0,16,0,-16
8400,1,0,18,0,-18
8401,0,0,158,0,-158
8402,1,1,140,1209,1069
8403,1,0,11,0,-11
8404,1,1,145,1246,1101
8405,0,0,72,0,-72
8406,0,0,68,0,-68
8407,1,0,72,0,-72
8408,1,0,9,0,-9
8409,0,0,19,0,-19
8410,0,0,94,0,-94
8411,0,0,32,0,-32
8412,1,1,234,1460,1226
8413,0,0,148,0,-148
8414,1,0,115,0,-115
8415,1,1,524,1578,1054
8416,1,1,65,1607,1542
8417,1,0,10,0,-10
8418,0,0,209,0,-209
8419,1,1,320,2451,2131
8420,0,0,121,0,-121
8421,1,0,1,0,-1
8422,1,0,61,0,-61
8423,0,0,2,0,-2
8424,0,0,220,0,-220
8425,1,1,285,1309,1024
8426,0,0,16,0,-16
8427,0,0,18,0,-18
8428,1,1,197,1493,1296
8429,1,0,8,0,-8
8430,1,1,195,1376,1181
8431,1,0,25,0,-25
8432,1,0,65,0,-65
8433,0,0,10,0,-10
8434,1,1,367,1496,1129
8435,1,0,43,0,-43
8436,1,0,4,0,-4
8437,0,0,10,0,-10
8438,1,0,14,0,-14
8439,1,1,421,1892,1471
8440,1,0,113,0,-113
8441,1,1,852,1292,440
8442,0,0,8,0,-8
8443,1,0,50,0,-50
8444,1,1,663,1238,575
8445,1,1,38,1337,1299
8446,0,0,6,0,-6
8447,0,0,21,0,-21
8448,1,1,454,1606,1152
8449,0,0,4,0,-4
8450,0,0,40,0,-40
8451,1,0,79,0,-79
8452,0,0,115,0,-115
8453,1,1,266,1432,1166
8454,1,1,2003,1478,-525
8455,1,1,279,1478,1199
8456,1,0,27,0,-27
8457,1,0,57,0,-57
8458,1,1,677,1445,768
8459,1,1,96,1349,1253
8460,0,0,35,0,-35
8461,1,1,130,1246,1116
8462,1,0,22,0,-22
8463,1,0,43,0,-43
8464,1,0,77,0,-77
8465,0,0,45,0,-45
8466,0,0,193,0,-193
8467,0,0,17,0,-17
8468,1,1,114,1243,1129
8469,1,1,520,1833,1313
8470,1,1,112,1231,1119
8471,1,1,164,1391,1227
8472,1,0,32,0,-32
8473,1,0,39,0,-39
8474,0,0,159,0,-159
8475,0,0,47,0,-47
8476,0,0,88,0,-88
8477,1,0,14,0,-14
8478,1,1,244,1215,971
8479,0,0,14,0,-14
8480,1,0,35,0,-35
8481,1,0,30,0,-30
8482,1,1,83,1524,1441
8483,0,0,0,0,0
8484,1,1,1979,1338,-641
8485,1,1,1088,1268,180
8486,0,0,3,0,-3
8487,0,0,21,0,-21
8488,1,0,177,0,-177
8489,1,1,230,1392,1162
8490,1,0,22,0,-22
8491,0,0,132,0,-132
8492,1,0,101,0,-101
8493,0,0,25,0,-25
8494,1,0,89,0,-89
8495,1,0,18,0,-18
8496,1,1,319,1252,933
8497,0,0,26,0,-26
8498,1,1,1216,1510,294
8499,0,0,86,0,-86
8500,0,0,81,0,-81
8501,1,0,31,0,-31
8502,1,0,21,0,-21
8503,1,1,412,1237,825
8504,1,0,37,0,-37
8505,1,0,11,0,-11
8506,1,0,34,0,-34
8507,0,0,11,0,-11
8508,1,1,207,1200,993
8509,1,0,51,0,-51
8510,1,0,79,0,-79
8511,1,1,825,1289,464
8512,0,0,8,0,-8
8513,1,0,16,0,-16
8514,1,1,1439,1782,343
8515,1,1,59,1782,1723
8516,1,1,1072,1676,604
8517,1,0,9,0,-9
8518,1,1,923,1210,287
8519,0,0,68,0,-68
8520,0,0,0,0,0
8521,1,0,49,0,-49
8522,1,1,128,2439,2311
8523,1,1,1083,1689,606
8524,0,0,29,0,-29
8525,0,0,3,0,-3
8526,1,1,254,1323,1069
8527,1,0,24,0,-24
8528,1,1,46,1614,1568
8529,0,0,45,0,-45
8530,1,0,61,0,-61
8531,1,0,91,0,-91
8532,1,1,380,1229,849
8533,1,0,81,0,-81
8534,1,0,17,0,-17
8535,1,1,1068,1296,228
8536,0,0,15,0,-15
8537,1,1,494,2157,1663
8538,1,1,1168,1874,706
8539,1,0,82,0,-82
8540,0,0,12,0,-12
8541,1,0,25,0,-25
8542,0,0,18,0,-18
8543,0,0,127,0,-127
8544,1,0,73,0,-73
8545,0,0,153,0,-153
8546,1,0,16,0,-16
8547,1,1,427,1384,957
8548,1,1,357,1869,1512
8549,1,0,34,0,-34
8550,0,0,89,0,-89
8551,0,0,88,0,-88
8552,0,0,47,0,-47
8553,0,0,80,0,-80
8554,1,0,65,0,-65
8555,1,0,50,0,-50
8556,0,0,0,0,0
8557,1,0,44,0,-44
8558,1,1,914,2286,1372
8559,1,0,17,0,-17
8560,1,1,133,1988,1855
8561,1,0,130,0,-130
8562,0,0,218,0,-218
8563,1,1,163,1287,1124
8564,1,1,173,1374,1201
8565,1,1,15,1224,1209
8566,0,0,35,0,-35
8567,1,1,950,1770,820
8568,1,0,30,0,-30
8569,1,0,4,0,-4
8570,1,0,17,0,-17
8571,0,0,54,0,-54
8572,1,1,123,1690,1567
8573,1,0,80,0,-80
8574,1,1,339,1342,1003
8575,0,0,14,0,-14
8576,1,0,6,0,-6
8577,1,0,6,0,-6
8578,1,0,17,0,-17
8579,1,0,17,0,-17
8580,1,1,1578,1258,-320
8581,1,0,96,0,-96
8582,0,0,15,0,-15
8583,1,1,172,1596,1424
8584,0,0,17,0,-17
8585,1,1,135,1293,1158
8586,0,0,48,0,-48
8587,1,1,154,1327,1173
8588,1,1,376,1241,865
8589,1,1,892,1537,645
8590,0,0,35,0,-35
8591,1,1,572,1391,819
8592,1,1,758,1200,442
8593,1,1,440,1449,1009
8594,0,0,2,0,-2
8595,1,0,30,0,-30
8596,1,1,127,1238,1111
8597,1,0,69,0,-69
8598,0,0,52,0,-52
8599,1,0,45,0,-45
8600,1,0,26,0,-26
8601,0,0,55,0,-55
8602,1,1,275,1204,929
8603,0,0,47,0,-47
8604,1,1,120,1402,1282
8605,1,0,12,0,-12
8606,1,1,136,1261,1125
8607,0,0,49,0,-49
8608,1,1,1131,1294,163
8609,0,0,47,0,-47
8610,0,0,47,0,-47
8611,0,0,13,0,-13
8612,1,1,235,2232,1997
8613,1,1,33,1921,1888
8614,1,0,67,0,-67
8615,0,0,103,0,-103
8616,0,0,76,0,-76
8617,1,0,14,0,-14
8618,1,1,503,1300,797
8619,1,1,1906,1953,47
8620,1,1,179,1264,1085
8621,0,0,6,0,-6
8622,1,1,78,1233,1155
8623,1,1,243,1443,1200
8624,1,0,68,0,-68
8625,0,0,74,0,-74
8626,0,0,32,0,-32
8627,1,0,16,0,-16
8628,1,0,15,0,-15
8629,0,0,3,0,-3
8630,1,0,35,0,-35
8631,0,0,2,0,-2
8632,1,1,222,2036,1814
8633,1,1,187,1212,1025
8634,0,0,21,0,-21
8635,1,1,57,3658,3601
8636,1,1,504,1215,711
8637,1,1,1092,1212,120
8638,1,1,176,1575,1399
8639,1,1,1017,1662,645
8640,1,1,685,1569,884
8641,1,0,18,0,-18
8642,0,0,17,0,-17
8643,0,0,70,0,-70
8644,0,0,63,0,-63
8645,1,0,7,0,-7
8646,0,0,36,0,-36
8647,1,0,19,0,-19
8648,1,0,64,0,-64
8649,1,1,114,1239,1125
8650,0,0,62,0,-62
8651,0,0,12,0,-12
8652,0,0,4,0,-4
8653,0,0,23,0,-23
8654,1,0,28,0,-28
8655,1,1,2053,1619,-434
8656,0,0,30,0,-30
8657,0,0,4,0,-4
8658,1,0,30,0,-30
8659,1,1,136,1637,1501
8660,0,0,42,0,-42
8661,1,1,88,1926,1838
8662,1,1,464,1399,935
8663,1,1,347,1855,1508
8664,1,1,834,1450,616
8665,1,0,55,0,-55
8666,0,0,42,0,-42
8667,1,0,4,0,-4
8668,1,1,1017,1257,240
8669,0,0,107,0,-107
8670,1,0,39,0,-39
8671,1,0,16,0,-16
8672,1,0,76,0,-76
8673,1,1,356,1577,1221
8674,0,0,74,0,-74
8675,0,0,131,0,-131
8676,1,0,29,0,-29
8677,0,0,75,0,-75
8678,0,0,49,0,-49
8679,1,1,177,1383,1206
8680,1,1,379,1419,1040
8681,1,1,799,1859,1060
8682,1,0,212,0,-212
8683,0,0,16,0,-16
8684,0,0,16,0,-16
8685,0,0,116,0,-116
8686,1,0,158,0,-158
8687,1,0,90,0,-90
8688,1,0,78,0,-78
8689,1,1,758,1506,748
8690,0,0,116,0,-116
8691,1,1,56,1542,1486
8692,1,1,98,1348,1250
8693,1,1,136,1767,1631
8694,0,0,5,0,-5
8695,0,0,45,0,-45
8696,1,1,177,2319,2142
8697,0,0,49,0,-49
8698,1,1,255,2486,2231
8699,1,0,16,0,-16
8700,1,0,20,0,-20
8701,1,1,1233,3457,2224
8702,1,1,426,1478,1052
8703,1,0,71,0,-71
8704,0,0,0,0,0
8705,1,0,44,0,-44
8706,1,0,87,0,-87
8707,0,0,256,0,-256
8708,1,0,6,0,-6
8709,1,0,21,0,-21
8710,0,0,2,0,-2
8711,0,0,37,0,-37
8712,0,0,38,0,-38
8713,0,0,18,0,-18
8714,0,0,76,0,-76
8715,1,0,8,0,-8
8716,1,0,65,0,-65
8717,1,0,4,0,-4
8718,1,0,58,0,-58
8719,0,0,23,0,-23
8720,1,1,97,1231,1134
8721,1,1,319,1252,933
8722,1,0,92,0,-92
8723,1,0,10,0,-10
8724,0,0,90,0,-90
8725,1,1,268,1361,1093
8726,1,0,7,0,-7
8727,1,1,1252,1317,65
8728,1,0,31,0,-31
8729,0,0,0,0,0
8730,1,0,74,0,-74
8731,1,1,144,1464,1320
8732,0,0,110,0,-110
8733,0,0,27,0,-27
8734,0,0,17,0,-17
8735,0,0,18,0,-18
8736,0,0,52,0,-52
8737,1,0,48,0,-48
8738,1,0,21,0,-21
8739,0,0,15,0,-15
8740,0,0,15,0,-15
8741,1,1,266,1554,1288
8742,0,0,59,0,-59
8743,0,0,171,0,-171
8744,1,1,132,1460,1328
8745,1,1,630,1238,608
8746,1,0,60,0,-60
8747,1,0,13,0,-13
8748,0,0,52,0,-52
8749,0,0,6,0,-6
8750,1,0,15,0,-15
8751,1,1,193,2465,2272
8752,0,0,6,0,-6
8753,1,1,238,1278,1040
8754,1,0,15,0,-15
8755,0,0,4,0,-4
8756,1,0,45,0,-45
8757,1,1,908,1255,347
8758,1,1,343,1956,1613
8759,0,0,56,0,-56
8760,0,0,162,0,-162
8761,1,1,454,1450,996
8762,0,0,11,0,-11
8763,1,0,44,0,-44
8764,1,1,262,1687,1425
8765,1,1,1607,1267,-340
8766,1,0,34,0,-34
8767,1,1,444,1558,1114
8768,0,0,23,0,-23
8769,0,0,12,0,-12
8770,1,1,923,1648,725
8771,1,0,48,0,-48
8772,1,1,245,1412,1167
8773,1,0,48,0,-48
8774,1,0,8,0,-8
8775,1,1,1360,1559,199
8776,0,0,88,0,-88
8777,1,0,1,0,-1
8778,1,1,44,1700,1656
8779,1,0,85,0,-85
8780,1,1,477,1224,747
8781,1,1,1075,1221,146
8782,1,1,177,1281,1104
8783,1,1,845,1243,398
8784,1,1,419,1333,914
8785,1,1,1257,1860,603
8786,1,1,574,2118,1544
8787,1,0,20,0,-20
8788,0,0,40,0,-40
8789,0,0,88,0,-88
8790,0,0,8,0,-8
8791,1,0,34,0,-34
8792,0,0,41,0,-41
8793,1,0,11,0,-11
8794,1,0,42,0,-42
8795,1,0,13,0,-13
8796,1,1,216,2000,1784
8797,1,1,730,2394,1664
8798,0,0,34,0,-34
8799,1,0,41,0,-41
8800,0,0,9,0,-9
8801,1,0,9,0,-9
8802,0,0,1,0,-1
8803,1,1,1220,1549,329
8804,0,0,22,0,-22
8805,1,1,604,1450,846
8806,1,1,165,1781,1616
8807,0,0,0,0,0
8808,0,0,77,0,-77
8809,0,0,14,0,-14
8810,0,0,47,0,-47
8811,0,0,42,0,-42
8812,1,1,90,1619,1529
8813,0,0,80,0,-80
8814,1,1,108,1275,1167
8815,1,1,980,1421,441
8816,0,0,3,0,-3
8817,0,0,59,0,-59
8818,0,0,7,0,-7
8819,1,1,1608,1526,-82
8820,1,0,4,0,-4
8821,0,0,88,0,-88
8822,0,0,5,0,-5
8823,1,1,2222,1590,-632
8824,1,0,2,0,-2
8825,0,0,166,0,-166
8826,0,0,1,0,-1
8827,1,1,173,1608,1435
8828,0,0,177,0,-177
8829,1,0,10,0,-10
8830,0,0,53,0,-53
8831,0,0,2,0,-2
8832,1,1,633,1366,733
8833,0,0,9,0,-9
8834,0,0,19,0,-19
8835,1,1,178,1250,1072
8836,1,1,475,1664,1189
8837,1,1,905,1822,917
8838,1,1,83,1288,1205
8839,1,0,87,0,-87
8840,1,0,142,0,-142
8841,1,0,7,0,-7
8842,0,0,5,0,-5
8843,1,1,1462,1229,-233
8844,0,0,16,0,-16
8845,0,0,32,0,-32
8846,1,1,231,2411,2180
8847,1,1,184,1542,1358
8848,0,0,49,0,-49
8849,1,0,24,0,-24
8850,0,0,22,0,-22
8851,0,0,7,0,-7
8852,1,0,69,0,-69
8853,0,0,24,0,-24
8854,0,0,50,0,-50
8855,0,0,138,0,-138
8856,1,1,355,1245,890
8857,0,0,8,0,-8
8858,1,1,1026,1329,303
8859,1,1,423,1316,893
8860,0,0,39,0,-39
8861,1,1,539,1879,1340
8862,1,1,679,1202,523
8863,0,0,21,0,-21
8864,0,0,50,0,-50
8865,1,1,62,1329,1267
8866,1,1,968,1384,416
8867,0,0,83,0,-83
8868,1,1,89,1284,1195
8869,1,0,4,0,-4
8870,0,0,47,0,-47
8871,0,0,81,0,-81
8872,1,0,35,0,-35
8873,1,1,702,1721,1019
8874,0,0,26,0,-26
8875,1,1,237,1318,1081
8876,1,1,83,1893,1810
8877,1,1,321,1474,1153
8878,1,1,322,1207,885
8879,1,1,149,1209,1060
8880,0,0,0,0,0
8881,0,0,128,0,-128
8882,1,0,113,0,-113
8883,1,0,6,0,-6
8884,0,0,134,0,-134
8885,0,0,20,0,-20
8886,1,1,488,1647,1159
8887,1,1,753,1377,624
8888,1,0,32,0,-32
8889,0,0,40,0,-40
8890,1,1,500,1367,867
8891,1,0,8,0,-8
8892,0,0,71,0,-71
8893,1,1,466,1458,992
8894,1,1,191,1384,1193
8895,0,0,4,0,-4
8896,0,0,227,0,-227
8897,1,1,828,1279,451
8898,1,1,1585,1263,-322
8899,0,0,15,0,-15
8900,1,0,2,0,-2
8901,1,0,102,0,-102
8902,0,0,7,0,-7
8903,1,0,24,0,-24
8904,0,0,3,0,-3
8905,1,0,13,0,-13
8906,0,0,60,0,-60
8907,1,1,315,1567,1252
8908,1,1,38,1264,1226
8909,1,1,345,2170,1825
8910,1,1,798,1326,528
8911,1,0,68,0,-68
8912,1,1,99,1643,1544
8913,0,0,31,0,-31
8914,1,1,3748,1369,-2379
8915,0,0,52,0,-52
8916,1,1,447,1261,814
8917,1,0,2,0,-2
8918,0,0,45,0,-45
8919,1,1,1455,1681,226
8920,0,0,13,0,-13
8921,1,1,387,1651,1264
8922,1,1,748,1230,482
8923,1,0,46,0,-46
8924,1,1,1689,1478,-211
8925,1,1,570,1466,896
8926,0,0,10,0,-10
8927,0,0,69,0,-69
8928,0,0,63,0,-63
8929,0,0,22,0,-22
8930,0,0,33,0,-33
8931,1,0,10,0,-10
8932,1,0,26,0,-26
8933,1,1,1154,1560,406
8934,0,0,4,0,-4
8935,1,1,606,1258,652
8936,0,0,47,0,-47
8937,1,0,32,0,-32
8938,0,0,35,0,-35
8939,1,0,66,0,-66
8940,0,0,16,0,-16
8941,1,1,75,1656,1581
8942,0,0,56,0,-56
8943,1,0,17,0,-17
8944,0,0,6,0,-6
8945,0,0,147,0,-147
8946,1,0,27,0,-27
8947,0,0,192,0,-192
8948,0,0,174,0,-174
8949,0,0,62,0,-62
8950,1,0,46,0,-46
8951,0,0,37,0,-37
8952,1,0,32,0,-32
8953,1,1,307,1251,944
8954,1,0,63,0,-63
8955,1,0,63,0,-63
8956,1,0,48,0,-48
8957,0,0,102,0,-102
8958,1,1,1718,1606,-112
8959,1,0,12,0,-12
8960,1,1,1481,1451,-30
8961,0,0,37,0,-37
8962,0,0,25,0,-25
8963,1,0,5,0,-5
8964,1,1,85,1227,1142
8965,0,0,5,0,-5
8966,1,1,1779,1541,-238
8967,0,0,82,0,-82
8968,0,0,11,0,-11
8969,1,1,192,1214,1022
8970,1,1,282,1255,973
8971,1,0,138,0,-138
8972,0,0,21,0,-21
8973,0,0,65,0,-65
8974,1,0,0,0,0
8975,1,1,270,1884,1614
8976,1,0,46,0,-46
8977,1,1,488,1380,892
8978,0,0,14,0,-14
8979,0,0,78,0,-78
8980,0,0,17,0,-17
8981,1,1,166,1328,1162
8982,1,0,46,0,-46
8983,1,1,310,1451,1141
8984,1,0,51,0,-51
8985,0,0,98,0,-98
8986,0,0,74,0,-74
8987,0,0,20,0,-20
8988,1,1,802,1675,873
8989,1,1,169,2824,2655
8990,1,0,2,0,-2
8991,0,0,18,0,-18
8992,0,0,74,0,-74
8993,1,0,59,0,-59
8994,0,0,28,0,-28
8995,1,0,123,0,-123
8996,0,0,5,0,-5
8997,0,0,91,0,-91
8998,1,1,52,1210,1158
8999,1,0,5,0,-5
9000,1,1,667,1209,542
9001,0,0,7,0,-7
9002,1,0,27,0,-27
9003,1,1,162,1379,1217
9004,1,0,5,0,-5
9005,1,1,38,1505,1467
9006,1,1,349,1329,980
9007,0,0,22,0,-22
9008,0,0,58,0,-58
9009,0,0,5,0,-5
9010,0,0,245,0,-245
9011,0,0,148,0,-148
9012,1,0,127,0,-127
9013,1,1,381,1784,1403
9014,0,0,12,0,-12
9015,0,0,81,0,-81
9016,1,0,17,0,-17
9017,1,1,1088,1396,308
9018,0,0,23,0,-23
9019,0,0,49,0,-49
9020,0,0,68,0,-68
9021,1,0,14,0,-14
9022,1,1,230,1290,1060
9023,1,0,99,0,-99
9024,1,0,74,0,-74
9025,1,0,17,0,-17
9026,1,0,49,0,-49
9027,1,1,1693,2414,721
9028,1,0,5,0,-5
9029,1,1,500,1407,907
9030,1,0,87,0,-87
9031,1,0,26,0,-26
9032,1,0,6,0,-6
9033,1,0,92,0,-92
9034,1,1,216,1377,1161
9035,1,1,550,1314,764
9036,1,1,241,1485,1244
9037,1,1,258,1339,1081
9038,0,0,28,0,-28
9039,0,0,50,0,-50
9040,1,1,900,1313,413
9041,1,1,956,1441,485
9042,1,1,181,1728,1547
9043,1,0,6,0,-6
9044,0,0,0,0,0
9045,0,0,8,0,-8
9046,1,0,149,0,-149
9047,1,0,5,0,-5
9048,1,1,245,1592,1347
9049,1,1,433,1323,890
9050,1,0,23,0,-23
9051,1,1,404,1264,860
9052,1,1,531,1637,1106
9053,0,0,126,0,-126
9054,0,0,55,0,-55
9055,0,0,126,0,-126
9056,1,0,14,0,-14
9057,1,1,753,1776,1023
9058,1,1,800,1333,533
9059,0,0,5,0,-5
9060,0,0,58,0,-58
9061,0,0,68,0,-68
9062,1,1,313,1307,994
9063,1,0,20,0,-20
9064,1,1,162,6261,6099
9065,1,0,178,0,-178
9066,1,1,49,1488,1439
9067,0,0,11,0,-11
9068,0,0,26,0,-26
9069,1,1,389,2207,1818
9070,1,1,800,1334,534
9071,1,1,1676,2055,379
9072,1,0,30,0,-30
9073,0,0,30,0,-30
9074,1,0,46,0,-46
9075,1,0,30,0,-30
9076,1,1,429,1235,806
9077,0,0,97,0,-97
9078,1,0,69,0,-69
9079,1,1,191,1266,1075
9080,1,1,1010,1337,327
9081,0,0,37,0,-37
9082,1,0,5,0,-5
9083,1,1,360,1231,871
9084,1,0,41,0,-41
9085,1,1,392,2096,1704
9086,1,1,615,1285,670
9087,1,0,3,0,-3
9088,0,0,58,0,-58
9089,1,0,134,0,-134
9090,1,0,34,0,-34
9091,0,0,3,0,-3
9092,1,1,288,1424,1136
9093,1,0,12,0,-12
9094,0,0,52,0,-52
9095,1,0,190,0,-190
9096,0,0,13,0,-13
9097,1,1,796,1239,443
9098,0,0,7,0,-7
9099,0,0,62,0,-62
9100,0,0,81,0,-81
9101,1,0,127,0,-127
9102,1,1,447,1816,1369
9103,1,0,5,0,-5
9104,1,0,41,0,-41
9105,1,0,37,0,-37
9106,0,0,10,0,-10
9107,0,0,77,0,-77
9108,1,0,58,0,-58
9109,0,0,15,0,-15
9110,1,1,244,2089,1845
9111,1,0,25,0,-25
9112,1,1,1072,1218,146
9113,1,0,25,0,-25
9114,1,0,108,0,-108
9115,1,0,22,0,-22
9116,1,0,16,0,-16
9117,0,0,33,0,-33
9118,1,1,426,1364,938
9119,0,0,16,0,-16
9120,0,0,5,0,-5
9121,0,0,47,0,-47
9122,1,1,538,1334,796
9123,1,0,18,0,-18
9124,0,0,68,0,-68
9125,1,0,43,0,-43
9126,1,1,153,1245,1092
9127,1,1,1949,1228,-721
9128,1,0,103,0,-103
9129,1,0,31,0,-31
9130,0,0,12,0,-12
9131,0,0,87,0,-87
9132,1,1,292,1415,1123
9133,0,0,26,0,-26
9134,1,0,163,0,-163
9135,1,0,20,0,-20
9136,1,0,33,0,-33
9137,1,1,1706,1286,-420
9138,1,1,373,1967,1594
9139,0,0,2,0,-2
9140,1,1,43,1294,1251
9141,1,0,86,0,-86
9142,1,1,28,1226,1198
9143,1,0,31,0,-31
9144,1,0,82,0,-82
9145,1,0,86,0,-86
9146,0,0,15,0,-15
9147,1,1,941,1252,311
9148,0,0,14,0,-14
9149,0,0,108,0,-108
9150,1,1,691,1235,544
9151,0,0,0,0,0
9152,0,0,15,0,-15
9153,1,0,38,0,-38
9154,1,0,11,0,-11
9155,0,0,118,0,-118
9156,1,1,255,2447,2192
9157,0,0,100,0,-100
9158,1,1,949,1476,527
9159,0,0,167,0,-167
9160,0,0,0,0,0
9161,0,0,13,0,-13
9162,1,0,62,0,-62
9163,0,0,8,0,-8
9164,0,0,51,0,-51
9165,0,0,79,0,-79
9166,1,0,85,0,-85
9167,1,0,25,0,-25
9168,1,0,61,0,-61
9169,1,1,153,1353,1200
9170,0,0,3,0,-3
9171,1,0,5,0,-5
9172,0,0,63,0,-63
9173,0,0,12,0,-12
9174,1,0,153,0,-153
9175,1,1,681,1241,560
9176,1,0,8,0,-8
9177,0,0,15,0,-15
9178,0,0,26,0,-26
9179,1,0,40,0,-40
9180,1,1,36,1214,1178
9181,0,0,12,0,-12
9182,1,0,13,0,-13
9183,1,0,120,0,-120
9184,1,0,71,0,-71
9185,0,0,10,0,-10
9186,0,0,11,0,-11
9187,1,1,447,1513,1066
9188,1,0,30,0,-30
9189,1,1,402,1259,857
9190,1,0,28,0,-28
9191,0,0,30,0,-30
9192,1,1,313,1200,887
9193,0,0,87,0,-87
9194,1,0,144,0,-144
9195,0,0,66,0,-66
9196,1,1,53,1769,1716
9197,1,0,30,0,-30
9198,1,0,18,0,-18
9199,0,0,17,0,-17
9200,0,0,61,0,-61
9201,0,0,80,0,-80
9202,0,0,35,0,-35
9203,0,0,50,0,-50
9204,0,0,96,0,-96
9205,0,0,65,0,-65
9206,1,0,182,0,-182
9207,0,0,40,0,-40
9208,1,1,155,1341,1186
9209,1,1,333,1291,958
9210,0,0,86,0,-86
9211,1,0,11,0,-11
9212,1,0,34,0,-34
9213,1,1,285,1353,1068
9214,0,0,1,0,-1
9215,1,1,929,2144,1215
9216,0,0,170,0,-170
9217,1,0,19,0,-19
9218,0,0,39,0,-39
9219,1,1,101,1395,1294
9220,0,0,84,0,-84
9221,0,0,27,0,-27
9222,0,0,1,0,-1
9223,1,1,198,1211,1013
9224,1,1,1399,1443,44
9225,0,0,102,0,-102
9226,1,1,733,1227,494
9227,0,0,7,0,-7
9228,0,0,29,0,-29
9229,0,0,2,0,-2
9230,0,0,95,0,-95
9231,1,0,30,0,-30
9232,1,1,465,1202,737
9233,1,1,328,1371,1043
9234,0,0,202,0,-202
9235,1,0,85,0,-85
9236,1,1,939,1973,1034
9237,1,0,13,0,-13
9238,0,0,8,0,-8
9239,1,1,152,1334,1182
9240,1,0,22,0,-22
9241,1,0,35,0,-35
9242,1,0,18,0,-18
9243,1,0,68,0,-68
9244,0,0,11,0,-11
9245,1,0,27,0,-27
9246,1,1,744,1410,666
9247,1,1,730,1349,619
9248,1,0,113,0,-113
9249,0,0,149,0,-149
9250,0,0,31,0,-31
9251,1,0,4,0,-4
9252,1,0,82,0,-82
9253,1,1,281,1267,986
9254,1,1,251,4114,3863
9255,1,0,42,0,-42
9256,1,0,114,0,-114
9257,0,0,97,0,-97
9258,1,1,540,1757,1217
9259,0,0,21,0,-21
9260,1,0,43,0,-43
9261,0,0,43,0,-43
9262,0,0,30,0,-30
9263,1,0,80,0,-80
9264,1,1,26,1298,1272
9265,0,0,75,0,-75
9266,0,0,13,0,-13
9267,1,1,375,1771,1396
9268,1,0,26,0,-26
9269,0,0,3,0,-3
9270,1,1,167,1642,1475
9271,1,1,227,1537,1310
9272,1,1,366,1251,885
9273,0,0,158,0,-158
9274,0,0,93,0,-93
9275,0,0,4,0,-4
9276,1,0,13,0,-13
9277,1,1,352,1321,969
9278,1,0,18,0,-18
9279,0,0,12,0,-12
9280,1,1,191,1240,1049
9281,1,1,1645,3296,1651
9282,1,1,282,1697,1415
9283,1,0,54,0,-54
9284,1,0,155,0,-155
9285,1,0,179,0,-179
9286,1,1,346,1334,988
9287,1,1,344,1221,877
9288,0,0,61,0,-61
9289,0,0,6,0,-6
9290,1,1,275,1299,1024
9291,0,0,58,0,-58
9292,1,1,254,1386,1132
9293,0,0,103,0,-103
9294,1,1,96,2124,2028
9295,0,0,42,0,-42
9296,0,0,22,0,-22
9297,0,0,3,0,-3
9298,0,0,10,0,-10
9299,1,1,74,1223,1149
9300,0,0,1,0,-1
9301,0,0,88,0,-88
9302,1,0,0,0,0
9303,1,0,0,0,0
9304,1,1,400,1582,1182
9305,1,1,553,1313,760
9306,0,0,30,0,-30
9307,0,0,17,0,-17
9308,0,0,30,0,-30
9309,1,1,192,1925,1733
9310,1,0,77,0,-77
9311,1,1,39,1418,1379
9312,0,0,10,0,-10
9313,1,0,16,0,-16
9314,1,1,764,1449,685
9315,1,1,566,1378,812
9316,0,0,10,0,-10
9317,0,0,49,0,-49
9318,1,0,19,0,-19
9319,0,0,94,0,-94
9320,1,0,43,0,-43
9321,0,0,27,0,-27
9322,1,1,335,1301,966
9323,1,0,170,0,-170
9324,0,0,88,0,-88
9325,0,0,44,0,-44
9326,0,0,41,0,-41
9327,0,0,60,0,-60
9328,0,0,117,0,-117
9329,1,0,39,0,-39
9330,0,0,0,0,0
9331,0,0,18,0,-18
9332,0,0,28,0,-28
9333,1,0,14,0,-14
9334,0,0,50,0,-50
9335,0,0,96,0,-96
9336,1,0,47,0,-47
9337,1,0,81,0,-81
9338,1,1,133,1845,1712
9339,1,1,764,1563,799
9340,0,0,13,0,-13
9341,0,0,16,0,-16
9342,0,0,12,0,-12
9343,1,0,51,0,-51
9344,0,0,9,0,-9
9345,0,0,72,0,-72
9346,1,1,821,1213,392
9347,0,0,4,0,-4
9348,1,1,433,1911,1478
9349,0,0,32,0,-32
9350,0,0,17,0,-17
9351,0,0,84,0,-84
9352,1,0,7,0,-7
9353,0,0,256,0,-256
9354,1,1,1370,1581,211
9355,1,1,314,1275,961
9356,0,0,78,0,-78
9357,1,0,69,0,-69
9358,0,0,27,0,-27
9359,1,1,629,1347,718
9360,1,0,28,0,-28
9361,1,1,205,1799,1594
9362,0,0,80,0,-80
9363,1,1,343,1512,1169
9364,1,0,33,0,-33
9365,1,0,7,0,-7
9366,1,0,30,0,-30
9367,1,0,33,0,-33
9368,1,1,395,2428,2033
9369,1,0,123,0,-123
9370,1,0,48,0,-48
9371,0,0,171,0,-171
9372,1,0,106,0,-106
9373,1,0,46,0,-46
9374,1,1,219,1285,1066
9375,1,0,14,0,-14
9376,1,0,96,0,-96
9377,1,1,322,2247,1925
9378,1,0,24,0,-24
9379,1,1,908,2201,1293
9380,1,1,287,1219,932
9381,1,1,467,1200,733
9382,0,0,159,0,-159
9383,0,0,127,0,-127
9384,1,1,314,2264,1950
9385,1,0,57,0,-57
9386,1,1,664,1292,628
9387,0,0,141,0,-141
9388,1,0,15,0,-15
9389,0,0,1,0,-1
9390,1,1,170,2476,2306
9391,1,0,2,0,-2
9392,1,0,65,0,-65
9393,1,0,94,0,-94
9394,0,0,13,0,-13
9395,0,0,8,0,-8
9396,1,0,51,0,-51
9397,0,0,15,0,-15
9398,1,1,552,2080,1528
9399,1,0,200,0,-200
9400,1,0,11,0,-11
9401,0,0,20,0,-20
9402,1,0,17,0,-17
9403,1,1,517,1320,803
9404,1,1,526,1688,1162
9405,1,0,59,0,-59
9406,0,0,50,0,-50
9407,1,1,838,1387,549
9408,1,1,3520,1763,-1757
9409,1,0,50,0,-50
9410,1,0,104,0,-104
9411,1,1,352,1685,1333
9412,0,0,122,0,-122
9413,0,0,79,0,-79
9414,1,0,9,0,-9
9415,1,1,93,1888,1795
9416,0,0,159,0,-159
9417,1,1,145,1467,1322
9418,1,1,1166,1403,237
9419,1,0,62,0,-62
9420,1,0,36,0,-36
9421,0,0,71,0,-71
9422,1,1,1102,1906,804
9423,1,0,5,0,-5
9424,1,0,19,0,-19
9425,1,1,446,1589,1143
9426,0,0,21,0,-21
9427,1,1,1451,1554,103
9428,0,0,1,0,-1
9429,1,1,256,1555,1299
9430,1,1,645,1534,889
9431,1,1,263,3099,2836
9432,0,0,54,0,-54
9433,0,0,262,0,-262
9434,0,0,12,0,-12
9435,1,0,46,0,-46
9436,1,1,209,1715,1506
9437,0,0,21,0,-21
9438,0,0,11,0,-11
9439,0,0,49,0,-49
9440,1,0,14,0,-14
9441,0,0,222,0,-222
9442,0,0,3,0,-3
9443,1,1,2447,1201,-1246
9444,0,0,39,0,-39
9445,1,1,345,1269,924
9446,1,1,158,1246,1088
9447,1,0,185,0,-185
9448,0,0,65,0,-65
9449,1,1,1893,1413,-480
9450,1,1,155,1638,1483
9451,1,1,137,1377,1240
9452,1,1,1376,1504,128
9453,0,0,12,0,-12
9454,0,0,56,0,-56
9455,1,1,1592,1232,-360
9456,0,0,123,0,-123
9457,1,0,51,0,-51
9458,0,0,12,0,-12
9459,1,1,311,1235,924
9460,1,0,1,0,-1
9461,0,0,44,0,-44
9462,1,0,17,0,-17
9463,1,0,27,0,-27
9464,1,0,7,0,-7
9465,0,0,57,0,-57
9466,1,1,345,2337,1992
9467,1,1,657,1267,610
9468,0,0,31,0,-31
9469,0,0,74,0,-74
9470,0,0,223,0,-223
9471,1,1,427,3174,2747
9472,1,0,20,0,-20
9473,0,0,184,0,-184
9474,0,0,14,0,-14
9475,1,1,1141,1409,268
9476,1,0,34,0,-34
9477,1,1,202,1594,1392
9478,1,0,67,0,-67
9479,1,0,11,0,-11
9480,1,0,38,0,-38
9481,0,0,63,0,-63
9482,1,1,2149,1906,-243
9483,0,0,56,0,-56
9484,1,1,341,1250,909
9485,0,0,100,0,-100
9486,1,1,277,1780,1503
9487,1,0,1,0,-1
9488,0,0,12,0,-12
9489,1,1,216,1309,1093
9490,0,0,14,0,-14
9491,1,0,87,0,-87
9492,1,1,138,1771,1633
9493,0,0,122,0,-122
9494,0,0,12,0,-12
9495,0,0,23,0,-23
9496,0,0,16,0,-16
9497,0,0,21,0,-21
9498,1,0,59,0,-59
9499,1,0,104,0,-104
9500,1,1,147,1230,1083
9501,0,0,14,0,-14
9502,1,1,1009,1698,689
9503,1,0,3,0,-3
9504,1,1,182,1528,1346
9505,0,0,36,0,-36
9506,1,1,242,1216,974
9507,1,1,105,1227,1122
9508,0,0,24,0,-24
9509,0,0,14,0,-14
9510,0,0,9,0,-9
9511,1,0,49,0,-49
9512,0,0,10,0,-10
9513,0,0,16,0,-16
9514,1,1,270,1206,936
9515,1,1,658,1992,1334
9516,1,0,152,0,-152
9517,0,0,13,0,-13
9518,0,0,97,0,-97
9519,1,1,1182,1771,589
9520,0,0,11,0,-11
9521,0,0,1,0,-1
9522,1,0,76,0,-76
9523,1,1,1663,1562,-101
9524,0,0,58,0,-58
9525,1,1,338,1257,919
9526,1,0,76,0,-76
9527,1,0,56,0,-56
9528,1,0,6,0,-6
9529,0,0,36,0,-36
9530,1,1,324,1396,1072
9531,1,1,1540,1838,298
9532,0,0,28,0,-28
9533,1,0,10,0,-10
9534,0,0,16,0,-16
9535,0,0,74,0,-74
9536,0,0,30,0,-30
9537,1,0,2,0,-2
9538,0,0,1,0,-1
9539,0,0,33,0,-33
9540,1,1,470,1552,1082
9541,0,0,0,0,0
9542,1,1,45,1843,1798
9543,1,0,71,0,-71
9544,1,0,114,0,-114
9545,1,0,3,0,-3
9546,0,0,16,0,-16
9547,1,0,21,0,-21
9548,0,0,37,0,-37
9549,1,0,99,0,-99
9550,0,0,0,0,0
9551,1,0,3,0,-3
9552,0,0,5,0,-5
9553,1,0,40,0,-40
9554,1,1,527,1545,1018
9555,1,1,763,1343,580
9556,1,1,901,1352,451
9557,0,0,25,0,-25
9558,1,1,241,1354,1113
9559,0,0,20,0,-20
9560,1,0,36,0,-36
9561,0,0,93,0,-93
9562,1,0,11,0,-11
9563,1,1,403,1555,1152
9564,0,0,33,0,-33
9565,1,0,58,0,-58
9566,1,0,146,0,-146
9567,0,0,71,0,-71
9568,0,0,2,0,-2
9569,1,0,60,0,-60
9570,0,0,40,0,-40
9571,0,0,96,0,-96
9572,1,0,76,0,-76
9573,1,1,117,1610,1493
9574,1,0,2,0,-2
9575,1,1,1130,1268,138
9576,0,0,40,0,-40
9577,1,1,159,1575,1416
9578,1,0,79,0,-79
9579,0,0,22,0,-22
9580,0,0,12,0,-12
9581,1,0,5,0,-5
9582,1,0,71,0,-71
9583,1,0,15,0,-15
9584,1,0,11,0,-11
9585,1,0,0,0,0
9586,1,1,162,1474,1312
9587,0,0,65,0,-65
9588,1,1,353,1652,1299
9589,1,1,198,1862,1664
9590,0,0,69,0,-69
9591,0,0,15,0,-15
9592,0,0,33,0,-33
9593,0,0,42,0,-42
9594,0,0,10,0,-10
9595,1,1,145,1222,1077
9596,1,0,0,0,0
9597,1,1,1000,1259,259
9598,1,1,2377,1856,-521
9599,1,0,90,0,-90
9600,1,0,47,0,-47
9601,1,1,62,1639,1577
9602,0,0,2,0,-2
9603,1,0,10,0,-10
9604,0,0,22,0,-22
9605,1,0,0,0,0
9606,1,1,628,1412,784
9607,1,0,26,0,-26
9608,1,1,2596,1252,-1344
9609,1,0,19,0,-19
9610,1,1,381,1201,820
9611,1,0,19,0,-19
9612,1,1,834,1248,414
9613,1,0,10,0,-10
9614,0,0,13,0,-13
9615,1,0,203,0,-203
9616,0,0,81,0,-81
9617,0,0,3,0,-3
9618,0,0,20,0,-20
9619,0,0,44,0,-44
9620,1,1,398,1679,1281
9621,0,0,39,0,-39
9622,0,0,39,0,-39
9623,0,0,67,0,-67
9624,0,0,14,0,-14
9625,1,0,15,0,-15
9626,0,0,89,0,-89
9627,0,0,156,0,-156
9628,0,0,81,0,-81
9629,1,0,50,0,-50
9630,0,0,22,0,-22
9631,1,0,7,0,-7
9632,0,0,11,0,-11
9633,1,1,241,1204,963
9634,1,0,9,0,-9
9635,1,0,51,0,-51
9636,0,0,101,0,-101
9637,1,1,1132,1327,195
9638,1,0,2,0,-2
9639,1,1,362,1430,1068
9640,1,0,24,0,-24
9641,0,0,1,0,-1
9642,0,0,8,0,-8
9643,1,0,0,0,0
9644,0,0,16,0,-16
9645,1,0,263,0,-263
9646,1,1,695,1500,805
9647,0,0,10,0,-10
9648,1,0,75,0,-75
9649,0,0,40,0,-40
9650,1,0,139,0,-139
9651,0,0,66,0,-66
9652,1,0,4,0,-4
9653,0,0,153,0,-153
9654,1,0,57,0,-57
9655,0,0,78,0,-78
9656,1,0,131,0,-131
9657,0,0,83,0,-83
9658,0,0,44,0,-44
9659,0,0,26,0,-26
9660,0,0,18,0,-18
9661,1,0,76,0,-76
9662,1,1,197,1281,1084
9663,0,0,4,0,-4
9664,1,1,881,1232,351
9665,1,1,250,1391,1141
9666,1,1,383,1711,1328
9667,1,1,159,2163,2004
9668,0,0,59,0,-59
9669,0,0,13,0,-13
9670,0,0,49,0,-49
9671,0,0,228,0,-228
9672,1,0,59,0,-59
9673,1,0,23,0,-23
9674,1,1,470,1404,934
9675,1,1,442,1480,1038
9676,0,0,180,0,-180
9677,1,0,66,0,-66
9678,1,1,1336,2670,1334
9679,1,1,560,1318,758
9680,1,0,55,0,-55
9681,0,0,65,0,-65
9682,0,0,41,0,-41
9683,0,0,70,0,-70
9684,1,0,54,0,-54
9685,1,0,49,0,-49
9686,1,1,124,1244,1120
9687,0,0,61,0,-61
9688,1,1,38,1852,1814
9689,0,0,30,0,-30
9690,0,0,32,0,-32
9691,1,0,48,0,-48
9692,0,0,15,0,-15
9693,1,1,745,1788,1043
9694,1,0,72,0,-72
9695,1,0,13,0,-13
9696,1,0,0,0,0
9697,1,1,772,1320,548
9698,1,1,369,2891,2522
9699,0,0,14,0,-14
9700,1,0,75,0,-75
9701,1,1,156,1804,1648
9702,1,1,380,2359,1979
9703,0,0,10,0,-10
9704,1,1,156,1304,1148
9705,0,0,11,0,-11
9706,1,1,718,1399,681
9707,1,0,119,0,-119
9708,1,1,1818,1628,-190
9709,1,0,31,0,-31
9710,0,0,23,0,-23
9711,1,0,26,0,-26
9712,1,1,1167,1619,452
9713,0,0,9,0,-9
9714,1,0,29,0,-29
9715,1,1,198,1422,1224
9716,1,0,63,0,-63
9717,0,0,41,0,-41
9718,1,1,217,1212,995
9719,0,0,25,0,-25
9720,1,1,66,2140,2074
9721,0,0,43,0,-43
9722,0,0,74,0,-74
9723,1,1,764,1317,553
9724,1,0,53,0,-53
9725,0,0,102,0,-102
9726,0,0,23,0,-23
9727,0,0,42,0,-42
9728,0,0,20,0,-20
9729,1,1,405,1591,1186
9730,1,0,84,0,-84
9731,0,0,89,0,-89
9732,1,1,1051,1862,811
9733,1,0,49,0,-49
9734,0,0,31,0,-31
9735,1,1,107,1333,1226
9736,0,0,147,0,-147
9737,1,1,1123,2681,1558
9738,0,0,3,0,-3
9739,1,1,2156,1589,-567
9740,1,0,58,0,-58
9741,1,1,485,1284,799
9742,0,0,119,0,-119
9743,1,1,721,1666,945
9744,1,1,85,1341,1256
9745,1,1,53,1221,1168
9746,1,1,463,1315,852
9747,0,0,1,0,-1
9748,0,0,1,0,-1
9749,0,0,5,0,-5
9750,0,0,5,0,-5
9751,1,1,354,1436,1082
9752,0,0,12,0,-12
9753,0,0,62,0,-62
9754,1,1,2396,1486,-910
9755,1,0,171,0,-171
9756,1,0,179,0,-179
9757,1,0,91,0,-91
9758,1,1,215,1430,1215
9759,0,0,69,0,-69
9760,1,1,153,1748,1595
9761,0,0,15,0,-15
9762,1,1,166,1740,1574
9763,1,1,486,1254,768
9764,0,0,47,0,-47
9765,1,0,22,0,-22
9766,1,1,656,1207,551
9767,1,1,913,1498,585
9768,0,0,19,0,-19
9769,1,0,69,0,-69
9770,1,0,44,0,-44
9771,0,0,0,0,0
9772,0,0,40,0,-40
9773,0,0,156,0,-156
9774,0,0,30,0,-30
9775,1,1,326,1216,890
9776,1,1,583,1255,672
9777,0,0,67,0,-67
9778,1,0,17,0,-17
9779,1,0,46,0,-46
9780,0,0,16,0,-16
9781,1,0,14,0,-14
9782,0,0,20,0,-20
9783,1,0,3,0,-3
9784,0,0,61,0,-61
9785,1,0,14,0,-14
9786,1,0,19,0,-19
9787,1,0,13,0,-13
9788,1,0,10,0,-10
9789,0,0,9,0,-9
9790,1,0,63,0,-63
9791,1,1,272,1232,960
9792,0,0,55,0,-55
9793,0,0,85,0,-85
9794,0,0,35,0,-35
9795,0,0,28,0,-28
9796,0,0,2,0,-2
9797,1,1,480,1584,1104
9798,1,0,3,0,-3
9799,1,1,412,1642,1230
9800,1,1,95,1249,1154
9801,1,0,25,0,-25
9802,0,0,81,0,-81
9803,1,0,28,0,-28
9804,1,0,226,0,-226
9805,1,1,387,1568,1181
9806,0,0,20,0,-20
9807,0,0,28,0,-28
9808,1,0,10,0,-10
9809,1,1,49,1367,1318
9810,1,0,150,0,-150
9811,0,0,59,0,-59
9812,1,1,222,1441,1219
9813,0,0,10,0,-10
9814,0,0,59,0,-59
9815,1,0,86,0,-86
9816,0,0,130,0,-130
9817,0,0,27,0,-27
9818,1,0,22,0,-22
9819,1,1,1314,1357,43
9820,0,0,42,0,-42
9821,0,0,23,0,-23
9822,0,0,109,0,-109
9823,1,0,28,0,-28
9824,0,0,4,0,-4
9825,1,0,2,0,-2
9826,0,0,69,0,-69
9827,1,1,1352,2507,1155
9828,0,0,16,0,-16
9829,0,0,35,0,-35
9830,1,0,14,0,-14
9831,1,0,135,0,-135
9832,0,0,66,0,-66
9833,1,0,26,0,-26
9834,1,1,543,1309,766
9835,0,0,2,0,-2
9836,1,0,22,0,-22
9837,0,0,9,0,-9
9838,1,0,37,0,-37
9839,1,1,211,1321,1110
9840,1,0,35,0,-35
9841,1,0,6,0,-6
9842,1,1,1696,1903,207
9843,0,0,12,0,-12
9844,1,0,60,0,-60
9845,0,0,27,0,-27
9846,1,1,1790,1468,-322
9847,1,1,744,1496,752
9848,0,0,40,0,-40
9849,1,1,998,1250,252
9850,1,0,103,0,-103
9851,0,0,132,0,-132
9852,0,0,272,0,-272
9853,1,0,54,0,-54
9854,1,1,106,1218,1112
9855,0,0,63,0,-63
9856,0,0,112,0,-112
9857,1,0,7,0,-7
9858,1,1,1147,1234,87
9859,1,0,94,0,-94
9860,1,0,30,0,-30
9861,1,1,584,1239,655
9862,1,1,361,1268,907
9863,1,0,35,0,-35
9864,1,1,390,1463,1073
9865,0,0,85,0,-85
9866,1,0,46,0,-46
9867,1,0,45,0,-45
9868,1,1,262,1219,957
9869,1,0,86,0,-86
9870,0,0,84,0,-84
9871,0,0,9,0,-9
9872,1,0,35,0,-35
9873,1,1,62,1601,1539
9874,0,0,59,0,-59
9875,0,0,12,0,-12
9876,0,0,91,0,-91
9877,0,0,23,0,-23
9878,1,1,67,1603,1536
9879,1,0,34,0,-34
9880,0,0,2,0,-2
9881,1,0,41,0,-41
9882,0,0,53,0,-53
9883,1,0,23,0,-23
9884,1,0,13,0,-13
9885,1,1,264,1413,1149
9886,1,1,127,1396,1269
9887,0,0,16,0,-16
9888,1,0,24,0,-24
9889,1,1,303,1457,1154
9890,1,1,761,1288,527
9891,0,0,76,0,-76
9892,1,1,1600,1344,-256
9893,1,1,295,1364,1069
9894,0,0,81,0,-81
9895,1,1,314,1947,1633
9896,0,0,47,0,-47
9897,0,0,37,0,-37
9898,0,0,50,0,-50
9899,0,0,70,0,-70
9900,1,1,478,2699,2221
9901,1,1,27,1382,1355
9902,0,0,134,0,-134
9903,1,0,7,0,-7
9904,1,0,52,0,-52
9905,1,0,20,0,-20
9906,0,0,146,0,-146
9907,1,1,490,1200,710
9908,0,0,30,0,-30
9909,1,0,16,0,-16
9910,1,0,6,0,-6
9911,1,0,4,0,-4
9912,0,0,40,0,-40
9913,1,0,43,0,-43
9914,0,0,48,0,-48
9915,0,0,28,0,-28
9916,1,1,121,2731,2610
9917,0,0,7,0,-7
9918,1,0,6,0,-6
9919,0,0,47,0,-47
9920,1,0,95,0,-95
9921,0,0,6,0,-6
9922,0,0,21,0,-21
9923,1,0,10,0,-10
9924,1,0,121,0,-121
9925,1,1,331,1724,1393
9926,0,0,51,0,-51
9927,1,0,61,0,-61
9928,0,0,100,0,-100
9929,0,0,14,0,-14
9930,1,0,164,0,-164
9931,1,1,305,1496,1191
9932,1,1,537,1787,1250
9933,0,0,42,0,-42
9934,0,0,1,0,-1
9935,1,0,63,0,-63
9936,1,1,1219,1202,-17
9937,1,0,5,0,-5
9938,0,0,152,0,-152
9939,0,0,96,0,-96
9940,0,0,1,0,-1
9941,1,0,294,0,-294
9942,1,1,35,1278,1243
9943,1,0,22,0,-22
9944,1,1,88,1258,1170
9945,1,0,220,0,-220
9946,0,0,70,0,-70
9947,0,0,5,0,-5
9948,0,0,21,0,-21
9949,0,0,189,0,-189
9950,1,0,11,0,-11
9951,1,0,6,0,-6
9952,1,1,74,1358,1284
9953,1,1,161,1399,1238
9954,1,0,26,0,-26
9955,1,1,768,2052,1284
9956,0,0,69,0,-69
9957,0,0,66,0,-66
9958,0,0,8,0,-8
9959,1,1,193,2131,1938
9960,0,0,6,0,-6
9961,1,0,81,0,-81
9962,0,0,82,0,-82
9963,0,0,1,0,-1
9964,0,0,44,0,-44
9965,0,0,111,0,-111
9966,1,1,1024,2551,1527
9967,1,1,1655,1445,-210
9968,1,0,121,0,-121
9969,0,0,17,0,-17
9970,1,1,112,1938,1826
9971,0,0,82,0,-82
9972,1,1,132,1552,1420
9973,0,0,6,0,-6
9974,0,0,6,0,-6
9975,1,1,739,1327,588
9976,1,0,41,0,-41
9977,0,0,34,0,-34
9978,0,0,55,0,-55
9979,0,0,113,0,-113
9980,0,0,10,0,-10
9981,1,1,827,1495,668
9982,0,0,0,0,0
9983,0,0,2,0,-2
9984,0,0,47,0,-47
9985,1,1,422,1350,928
9986,1,1,114,2145,2031
9987,1,0,27,0,-27
9988,1,1,569,1942,1373
9989,1,0,125,0,-125
9990,0,0,20,0,-20
9991,1,1,587,1221,634
9992,1,0,18,0,-18
9993,1,1,751,1732,981
9994,1,1,287,3306,3019
9995,0,0,25,0,-25
9996,1,0,143,0,-143
9997,0,0,29,0,-29
9998,0,0,186,0,-186
9999,0,0,13,0,-13
10000,0,0,37,0,-37
10001,1,0,78,0,-78
10002,1,0,1,0,-1
10003,1,1,556,1463,907
10004,0,0,167,0,-167
10005,1,1,231,1399,1168
10006,0,0,17,0,-17
10007,0,0,15,0,-15
10008,1,1,332,2001,1669
10009,0,0,21,0,-21
10010,1,0,3,0,-3
10011,1,1,208,2096,1888
10012,0,0,25,0,-25
10013,1,1,344,1739,1395
10014,1,0,169,0,-169
10015,0,0,74,0,-74
10016,0,0,75,0,-75
10017,1,1,587,1234,647
10018,1,1,398,1450,1052
10019,0,0,33,0,-33
10020,1,0,24,0,-24
10021,1,0,35,0,-35
10022,0,0,52,0,-52
10023,1,0,21,0,-21
10024,0,0,14,0,-14
10025,0,0,3,0,-3
10026,0,0,0,0,0
10027,0,0,76,0,-76
10028,1,1,458,1320,862
10029,0,0,82,0,-82
10030,0,0,167,0,-167
10031,0,0,20,0,-20
10032,1,0,61,0,-61
10033,1,1,431,1205,774
10034,1,1,47,1320,1273
10035,1,0,19,0,-19
10036,1,0,6,0,-6
10037,1,1,396,1212,816
10038,1,1,131,1204,1073
10039,0,0,20,0,-20
10040,1,0,14,0,-14
10041,1,1,144,1504,1360
10042,1,0,27,0,-27
10043,1,0,47,0,-47
10044,1,1,476,1216,740
10045,1,0,46,0,-46
10046,0,0,89,0,-89
10047,0,0,58,0,-58
10048,0,0,2,0,-2
10049,0,0,72,0,-72
10050,1,1,552,1813,1261
10051,1,0,29,0,-29
10052,1,0,90,0,-90
10053,0,0,114,0,-114
10054,0,0,6,0,-6
10055,1,1,480,1647,1167
10056,1,1,954,1256,302
10057,1,1,65,1345,1280
10058,0,0,74,0,-74
10059,1,0,21,0,-21
10060,1,0,83,0,-83
10061,1,0,117,0,-117
10062,1,1,80,1516,1436
10063,1,0,61,0,-61
10064,0,0,66,0,-66
10065,1,1,2203,1956,-247
10066,1,0,19,0,-19
10067,0,0,97,0,-97
10068,1,1,293,1556,1263
10069,1,1,839,1291,452
10070,0,0,1,0,-1
10071,1,0,18,0,-18
10072,1,1,1321,1249,-72
10073,1,1,701,1422,721
10074,0,0,13,0,-13
10075,1,1,1203,1371,168
10076,0,0,52,0,-52
10077,1,0,1,0,-1
10078,0,0,5,0,-5
10079,1,0,13,0,-13
10080,0,0,35,0,-35
10081,1,0,69,0,-69
10082,0,0,51,0,-51
10083,0,0,10,0,-10
10084,1,0,110,0,-110
10085,0,0,25,0,-25
10086,0,0,15,0,-15
10087,1,0,37,0,-37
10088,1,1,282,1540,1258
10089,1,1,503,1658,1155
10090,1,0,36,0,-36
10091,1,0,12,0,-12
10092,1,0,288,0,-288
10093,0,0,15,0,-15
10094,1,0,336,0,-336
10095,0,0,16,0,-16
10096,0,0,132,0,-132
10097,0,0,2,0,-2
10098,1,0,135,0,-135
10099,1,0,28,0,-28
10100,0,0,34,0,-34
10101,0,0,14,0,-14
10102,1,0,10,0,-10
10103,1,1,97,1489,1392
10104,1,0,139,0,-139
10105,1,1,57,1368,1311
10106,1,0,11,0,-11
10107,1,1,419,1467,1048
10108,1,0,77,0,-77
10109,1,1,500,1292,792
10110,1,1,767,1288,521
10111,1,0,14,0,-14
10112,1,0,4,0,-4
10113,0,0,20,0,-20
10114,0,0,11,0,-11
10115,1,0,7,0,-7
10116,1,1,46,1740,1694
10117,1,1,449,1759,1310
10118,0,0,44,0,-44
10119,1,0,63,0,-63
10120,0,0,20,0,-20
10121,1,0,7,0,-7
10122,0,0,76,0,-76
10123,1,1,1581,1489,-92
10124,0,0,40,0,-40
10125,1,0,45,0,-45
10126,1,1,444,1205,761
10127,1,1,413,1556,1143
10128,1,1,215,1267,1052
10129,1,0,10,0,-10
10130,1,1,42,2015,1973
10131,1,1,225,1324,1099
10132,1,1,773,2021,1248
10133,1,1,546,1620,1074
10134,1,1,672,1515,843
10135,0,0,15,0,-15
10136,0,0,63,0,-63
10137,0,0,46,0,-46
10138,1,1,80,1684,1604
10139,1,0,3,0,-3
10140,1,1,1077,2179,1102
10141,0,0,19,0,-19
10142,0,0,25,0,-25
10143,0,0,2,0,-2
10144,0,0,27,0,-27
10145,1,0,18,0,-18
10146,0,0,1,0,-1
10147,0,0,1,0,-1
10148,1,0,16,0,-16
10149,0,0,25,0,-25
10150,1,1,1278,3553,2275
10151,0,0,33,0,-33
10152,0,0,8,0,-8
10153,0,0,20,0,-20
10154,0,0,11,0,-11
10155,1,0,41,0,-41
10156,0,0,33,0,-33
10157,0,0,26,0,-26
10158,1,1,963,1400,437
10159,0,0,37,0,-37
10160,1,1,575,1413,838
10161,0,0,32,0,-32
10162,0,0,38,0,-38
10163,1,1,453,2150,1697
10164,1,0,29,0,-29
10165,1,0,23,0,-23
10166,0,0,26,0,-26
10167,1,1,411,2253,1842
10168,1,0,206,0,-206
10169,1,0,63,0,-63
10170,1,1,183,1212,1029
10171,1,0,84,0,-84
10172,0,0,125,0,-125
10173,1,0,6,0,-6
10174,0,0,100,0,-100
10175,1,1,52,1323,1271
10176,1,0,3,0,-3
10177,1,0,35,0,-35
10178,0,0,15,0,-15
10179,1,0,8,0,-8
10180,1,0,78,0,-78
10181,1,1,517,1279,762
10182,1,0,21,0,-21
10183,1,1,839,1619,780
10184,1,1,379,1213,834
10185,0,0,6,0,-6
10186,0,0,1,0,-1
10187,1,1,587,1406,819
10188,0,0,170,0,-170
10189,0,0,0,0,0
10190,1,1,292,1240,948
10191,1,1,382,1852,1470
10192,1,1,523,1518,995
10193,0,0,3,0,-3
10194,1,0,74,0,-74
10195,1,0,3,0,-3
10196,1,0,15,0,-15
10197,1,0,86,0,-86
10198,1,1,1407,1312,-95
10199,0,0,9,0,-9
10200,1,0,54,0,-54
10201,1,1,569,1573,1004
10202,0,0,59,0,-59
10203,1,1,484,1533,1049
10204,0,0,6,0,-6
10205,1,1,1374,1490,116
10206,0,0,178,0,-178
10207,1,0,55,0,-55
10208,0,0,70,0,-70
10209,1,1,168,1425,1257
10210,1,1,426,2093,1667
10211,0,0,32,0,-32
10212,1,0,79,0,-79
10213,0,0,51,0,-51
10214,1,0,102,0,-102
10215,0,0,42,0,-42
10216,1,1,623,1497,874
10217,0,0,43,0,-43
10218,1,1,1018,1391,373
10219,1,0,26,0,-26
10220,0,0,40,0,-40
10221,0,0,72,0,-72
10222,1,0,108,0,-108
10223,1,1,490,1298,808
10224,0,0,13,0,-13
10225,0,0,106,0,-106
10226,1,1,918,1261,343
10227,1,0,95,0,-95
10228,1,0,26,0,-26
10229,0,0,28,0,-28
10230,1,1,1099,1264,165
10231,1,0,27,0,-27
10232,0,0,136,0,-136
10233,0,0,19,0,-19
10234,1,1,532,1496,964
10235,0,0,18,0,-18
10236,1,1,336,1272,936
10237,0,0,24,0,-24
10238,1,0,24,0,-24
10239,1,1,21,1215,1194
10240,0,0,30,0,-30
10241,0,0,23,0,-23
10242,1,1,330,1207,877
10243,0,0,39,0,-39
10244,0,0,4,0,-4
10245,1,1,1111,1202,91
10246,1,1,790,1575,785
10247,1,1,407,1648,1241
10248,0,0,14,0,-14
10249,1,0,5,0,-5
10250,0,0,63,0,-63
10251,1,1,565,2650,2085
10252,1,1,418,1947,1529
10253,1,0,106,0,-106
10254,0,0,32,0,-32
10255,1,0,13,0,-13
10256,1,0,74,0,-74
10257,1,0,104,0,-104
10258,0,0,88,0,-88
10259,1,1,262,1642,1380
10260,1,1,1112,1368,256
10261,1,1,325,1603,1278
10262,1,1,435,1477,1042
10263,0,0,19,0,-19
10264,0,0,87,0,-87
10265,1,0,53,0,-53
10266,1,0,26,0,-26
10267,0,0,4,0,-4
10268,1,0,5,0,-5
10269,1,1,293,1889,1596
10270,1,1,368,2104,1736
10271,0,0,1,0,-1
10272,1,1,720,1306,586
10273,1,1,376,1392,1016
10274,0,0,103,0,-103
10275,0,0,27,0,-27
10276,1,0,77,0,-77
10277,1,0,193,0,-193
10278,1,1,1068,1304,236
10279,1,1,1228,1466,238
10280,1,0,33,0,-33
10281,1,1,439,2406,1967
10282,1,0,37,0,-37
10283,1,0,34,0,-34
10284,0,0,54,0,-54
10285,0,0,145,0,-145
10286,0,0,9,0,-9
10287,0,0,90,0,-90
10288,1,1,1042,2050,1008
10289,1,1,541,1289,748
10290,0,0,4,0,-4
10291,1,1,349,1967,1618
10292,0,0,1,0,-1
10293,1,1,961,1746,785
10294,1,0,30,0,-30
10295,1,1,1220,1963,743
10296,1,0,4,0,-4
10297,1,1,888,1210,322
10298,1,0,90,0,-90
10299,0,0,95,0,-95
10300,1,0,40,0,-40
10301,1,1,606,1424,818
10302,0,0,11,0,-11
10303,1,1,239,1856,1617
10304,1,1,79,1451,1372
10305,0,0,159,0,-159
10306,1,1,57,1230,1173
10307,1,0,16,0,-16
10308,1,1,1011,1226,215
10309,0,0,13,0,-13
10310,0,0,15,0,-15
10311,1,1,325,1278,953
10312,1,1,1315,1454,139
10313,1,1,815,1235,420
10314,1,0,57,0,-57
10315,1,1,1212,1606,394
10316,0,0,13,0,-13
10317,1,1,25,1434,1409
10318,0,0,140,0,-140
10319,1,0,7,0,-7
10320,1,0,117,0,-117
10321,1,0,2,0,-2
10322,1,0,83,0,-83
10323,0,0,14,0,-14
10324,1,0,5,0,-5
10325,0,0,60,0,-60
10326,1,1,86,1254,1168
10327,0,0,10,0,-10
10328,0,0,3,0,-3
10329,1,1,723,1316,593
10330,1,1,436,2612,2176
10331,0,0,19,0,-19
10332,0,0,45,0,-45
10333,1,0,10,0,-10
10334,1,1,6,1355,1349
10335,0,0,80,0,-80
10336,0,0,36,0,-36
10337,1,1,356,1719,1363
10338,1,0,44,0,-44
10339,1,1,189,1415,1226
10340,0,0,64,0,-64
10341,0,0,49,0,-49
10342,0,0,5,0,-5
10343,1,0,32,0,-32
10344,0,0,7,0,-7
10345,0,0,19,0,-19
10346,0,0,29,0,-29
10347,0,0,6,0,-6
10348,1,1,1226,1467,241
10349,1,1,1888,1343,-545
10350,1,0,10,0,-10
10351,1,1,2448,1705,-743
10352,1,0,92,0,-92
10353,1,0,43,0,-43
10354,0,0,31,0,-31
10355,1,0,8,0,-8
10356,1,0,169,0,-169
10357,1,1,365,1599,1234
10358,1,0,25,0,-25
10359,0,0,5,0,-5
10360,1,0,62,0,-62
10361,0,0,72,0,-72
10362,1,0,43,0,-43
10363,0,0,38,0,-38
10364,1,1,1380,1274,-106
10365,1,1,1456,1219,-237
10366,0,0,0,0,0
10367,1,1,518,1810,1292
10368,1,1,885,1367,482
10369,0,0,11,0,-11
10370,1,1,3376,1340,-2036
10371,0,0,51,0,-51
10372,0,0,2,0,-2
10373,1,0,9,0,-9
10374,0,0,5,0,-5
10375,0,0,74,0,-74
10376,1,0,2,0,-2
10377,0,0,38,0,-38
10378,0,0,30,0,-30
10379,0,0,81,0,-81
10380,1,0,124,0,-124
10381,1,0,4,0,-4
10382,0,0,3,0,-3
10383,1,0,56,0,-56
10384,0,0,13,0,-13
10385,0,0,59,0,-59
10386,1,1,188,3311,3123
10387,1,1,1121,1378,257
10388,1,0,58,0,-58
10389,1,0,27,0,-27
10390,0,0,29,0,-29
10391,1,1,859,1682,823
10392,0,0,21,0,-21
10393,1,1,77,1214,1137
10394,1,0,14,0,-14
10395,0,0,81,0,-81
10396,1,1,169,1636,1467
10397,0,0,25,0,-25
10398,1,1,101,1224,1123
10399,0,0,10,0,-10
10400,1,0,73,0,-73
10401,1,0,28,0,-28
10402,0,0,28,0,-28
10403,0,0,21,0,-21
10404,0,0,57,0,-57
10405,0,0,134,0,-134
10406,0,0,25,0,-25
10407,1,0,35,0,-35
10408,0,0,4,0,-4
10409,1,1,328,1295,967
10410,1,0,82,0,-82
10411,1,0,55,0,-55
10412,1,1,373,1346,973
10413,1,1,203,1242,1039
10414,1,0,6,0,-6
10415,1,1,47,1313,1266
10416,1,1,230,1631,1401
10417,1,0,60,0,-60
10418,1,0,0,0,0
10419,1,0,26,0,-26
10420,1,0,40,0,-40
10421,1,1,223,1218,995
10422,0,0,182,0,-182
10423,1,1,214,1436,1222
10424,1,0,19,0,-19
10425,0,0,0,0,0
10426,0,0,13,0,-13
10427,0,0,122,0,-122
10428,1,1,867,2907,2040
10429,0,0,49,0,-49
10430,0,0,45,0,-45
10431,1,0,21,0,-21
10432,1,0,20,0,-20
10433,0,0,0,0,0
10434,0,0,90,0,-90
10435,1,0,23,0,-23
10436,1,0,40,0,-40
10437,0,0,140,0,-140
10438,1,0,284,0,-284
10439,1,1,378,2196,1818
10440,0,0,56,0,-56
10441,1,0,143,0,-143
10442,0,0,86,0,-86
10443,0,0,149,0,-149
10444,1,0,74,0,-74
10445,1,0,113,0,-113
10446,0,0,12,0,-12
10447,0,0,1,0,-1
10448,0,0,4,0,-4
10449,1,1,366,1364,998
10450,1,1,487,1238,751
10451,1,1,381,1285,904
10452,1,1,875,1463,588
10453,1,0,14,0,-14
10454,0,0,10,0,-10
10455,1,0,17,0,-17
10456,1,0,63,0,-63
10457,1,1,302,1220,918
10458,0,0,161,0,-161
10459,1,1,318,1962,1644
10460,1,0,51,0,-51
10461,0,0,104,0,-104
10462,1,1,1684,1419,-265
10463,1,1,363,1821,1458
10464,0,0,86,0,-86
10465,1,0,25,0,-25
10466,1,1,1790,1221,-569
10467,1,1,977,1732,755
10468,0,0,6,0,-6
10469,1,0,7,0,-7
10470,1,1,63,1351,1288
10471,1,0,14,0,-14
10472,1,0,19,0,-19
10473,1,0,39,0,-39
10474,0,0,61,0,-61
10475,0,0,61,0,-61
10476,0,0,41,0,-41
10477,1,0,15,0,-15
10478,0,0,1,0,-1
10479,1,0,42,0,-42
10480,1,1,210,2139,1929
10481,1,0,12,0,-12
10482,0,0,147,0,-147
10483,1,0,2,0,-2
10484,0,0,132,0,-132
10485,1,0,50,0,-50
10486,0,0,213,0,-213
10487,0,0,39,0,-39
10488,1,1,653,1740,1087
10489,1,1,308,2698,2390
10490,0,0,46,0,-46
10491,0,0,20,0,-20
10492,0,0,21,0,-21
10493,1,0,6,0,-6
10494,1,1,1102,1426,324
10495,0,0,42,0,-42
10496,1,1,92,1281,1189
10497,1,0,6,0,-6
10498,0,0,28,0,-28
10499,0,0,55,0,-55
10500,1,0,47,0,-47
10501,0,0,14,0,-14
10502,1,1,325,1644,1319
10503,1,1,82,1271,1189
10504,1,0,119,0,-119
10505,1,0,70,0,-70
10506,0,0,31,0,-31
10507,0,0,46,0,-46
10508,1,1,228,1765,1537
10509,1,1,103,1791,1688
10510,1,1,339,1289,950
10511,0,0,66,0,-66
10512,1,0,3,0,-3
10513,0,0,1,0,-1
10514,1,0,32,0,-32
10515,1,0,30,0,-30
10516,1,1,86,1457,1371
10517,1,0,12,0,-12
10518,0,0,93,0,-93
10519,1,0,4,0,-4
10520,1,0,3,0,-3
10521,1,1,478,1700,1222
10522,0,0,102,0,-102
10523,1,0,40,0,-40
10524,0,0,26,0,-26
10525,0,0,36,0,-36
10526,1,1,2563,2053,-510
10527,1,0,14,0,-14
10528,0,0,104,0,-104
10529,1,1,362,1599,1237
10530,1,1,652,1594,942
10531,0,0,12,0,-12
10532,0,0,136,0,-136
10533,1,0,4,0,-4
10534,1,0,29,0,-29
10535,0,0,44,0,-44
10536,1,1,128,1241,1113
10537,1,0,47,0,-47
10538,1,0,36,0,-36
10539,1,0,21,0,-21
10540,1,0,12,0,-12
10541,1,0,108,0,-108
10542,0,0,92,0,-92
10543,0,0,74,0,-74
10544,0,0,42,0,-42
10545,1,1,396,1332,936
10546,0,0,20,0,-20
10547,1,1,212,1683,1471
10548,0,0,72,0,-72
10549,1,0,17,0,-17
10550,1,0,59,0,-59
10551,1,0,112,0,-112
10552,0,0,5,0,-5
10553,0,0,7,0,-7
10554,1,0,13,0,-13
10555,0,0,63,0,-63
10556,1,1,267,1317,1050
10557,1,0,12,0,-12
10558,0,0,37,0,-37
10559,1,0,14,0,-14
10560,1,0,142,0,-142
10561,1,0,3,0,-3
10562,0,0,4,0,-4
10563,1,1,570,1919,1349
10564,0,0,45,0,-45
10565,1,1,1150,1317,167
10566,0,0,37,0,-37
10567,0,0,45,0,-45
10568,1,0,13,0,-13
10569,0,0,118,0,-118
10570,1,0,49,0,-49
10571,1,0,101,0,-101
10572,1,1,463,1208,745
10573,1,0,54,0,-54
10574,1,0,59,0,-59
10575,1,0,2,0,-2
10576,0,0,12,0,-12
10577,1,0,6,0,-6
10578,0,0,9,0,-9
10579,1,1,932,1413,481
10580,1,0,15,0,-15
10581,0,0,87,0,-87
10582,1,0,54,0,-54
10583,1,1,758,2099,1341
10584,1,1,485,1328,843
10585,1,0,74,0,-74
10586,1,1,200,1882,1682
10587,1,1,1023,1831,808
10588,0,0,19,0,-19
10589,1,1,104,1888,1784
10590,1,0,66,0,-66
10591,1,0,34,0,-34
10592,0,0,27,0,-27
10593,0,0,8,0,-8
10594,1,1,426,1457,1031
10595,0,0,27,0,-27
10596,0,0,66,0,-66
10597,0,0,18,0,-18
10598,1,1,467,1525,1058
10599,1,0,1,0,-1
10600,1,0,12,0,-12
10601,1,0,15,0,-15
10602,0,0,0,0,0
10603,1,1,1353,1236,-117
10604,1,1,30,1620,1590
10605,0,0,44,0,-44
10606,0,0,5,0,-5
10607,0,0,73,0,-73
10608,0,0,7,0,-7
10609,1,0,32,0,-32
10610,1,1,717,2690,1973
10611,1,0,37,0,-37
10612,1,1,233,1536,1303
10613,0,0,107,0,-107
10614,0,0,68,0,-68
10615,0,0,52,0,-52
10616,1,0,10,0,-10
10617,1,0,13,0,-13
10618,1,0,43,0,-43
10619,1,1,883,1383,500
10620,0,0,36,0,-36
10621,0,0,140,0,-140
10622,0,0,9,0,-9
10623,0,0,171,0,-171
10624,0,0,26,0,-26
10625,1,1,646,1538,892
10626,1,1,347,1212,865
10627,1,1,654,2067,1413
10628,1,1,1093,1574,481
10629,1,0,72,0,-72
10630,0,0,2,0,-2
10631,0,0,3,0,-3
10632,1,0,23,0,-23
10633,0,0,23,0,-23
10634,0,0,4,0,-4
10635,0,0,12,0,-12
10636,0,0,61,0,-61
10637,1,1,336,1649,1313
10638,0,0,15,0,-15
10639,0,0,7,0,-7
10640,1,1,135,1657,1522
10641,1,0,89,0,-89
10642,0,0,14,0,-14
10643,1,0,97,0,-97
10644,1,0,48,0,-48
10645,0,0,54,0,-54
10646,1,1,858,1464,606
10647,1,0,16,0,-16
10648,1,1,337,1648,1311
10649,1,1,561,2986,2425
10650,0,0,38,0,-38
10651,1,0,40,0,-40
10652,0,0,105,0,-105
10653,1,0,2,0,-2
10654,1,0,60,0,-60
10655,1,0,4,0,-4
10656,1,1,83,1461,1378
10657,0,0,49,0,-49
10658,1,1,314,1489,1175
10659,0,0,5,0,-5
10660,0,0,130,0,-130
10661,0,0,18,0,-18
10662,1,1,1540,1427,-113
10663,1,0,49,0,-49
10664,0,0,55,0,-55
10665,1,0,1,0,-1
10666,0,0,43,0,-43
10667,1,1,201,1562,1361
10668,1,1,542,1684,1142
10669,0,0,14,0,-14
10670,1,0,59,0,-59
10671,0,0,44,0,-44
10672,1,1,707,1826,1119
10673,1,0,1,0,-1
10674,1,1,199,2345,2146
10675,1,1,472,2015,1543
10676,1,1,296,1467,1171
10677,1,1,16,1464,1448
10678,0,0,36,0,-36
10679,1,1,231,2295,2064
10680,0,0,34,0,-34
10681,0,0,33,0,-33
10682,1,1,83,1520,1437
10683,1,1,70,1628,1558
10684,1,0,26,0,-26
10685,1,0,10,0,-10
10686,1,1,577,1333,756
10687,0,0,19,0,-19
10688,0,0,8,0,-8
10689,0,0,19,0,-19
10690,1,0,0,0,0
10691,0,0,39,0,-39
10692,1,0,37,0,-37
10693,1,0,23,0,-23
10694,1,0,1,0,-1
10695,0,0,23,0,-23
10696,1,0,20,0,-20
10697,1,0,48,0,-48
10698,1,1,355,2695,2340
10699,0,0,37,0,-37
10700,0,0,71,0,-71
10701,0,0,42,0,-42
10702,1,1,54,1608,1554
10703,1,0,57,0,-57
10704,0,0,23,0,-23
10705,1,1,443,1779,1336
10706,0,0,33,0,-33
10707,0,0,24,0,-24
10708,1,0,54,0,-54
10709,0,0,8,0,-8
10710,1,1,98,3148,3050
10711,0,0,2,0,-2
10712,0,0,3,0,-3
10713,0,0,44,0,-44
10714,0,0,2,0,-2
10715,1,1,328,1537,1209
10716,1,0,54,0,-54
10717,0,0,5,0,-5
10718,1,1,56,1486,1430
10719,1,0,42,0,-42
10720,0,0,7,0,-7
10721,1,1,999,1254,255
10722,1,0,8,0,-8
10723,1,1,130,1338,1208
10724,1,0,3,0,-3
10725,1,0,50,0,-50
10726,1,0,22,0,-22
10727,0,0,4,0,-4
10728,1,1,300,1280,980
10729,0,0,91,0,-91
10730,0,0,20,0,-20
10731,0,0,82,0,-82
10732,1,1,1211,1354,143
10733,0,0,29,0,-29
10734,0,0,118,0,-118
10735,1,1,81,1885,1804
10736,0,0,17,0,-17
10737,0,0,72,0,-72
10738,1,0,4,0,-4
10739,0,0,78,0,-78
10740,0,0,34,0,-34
10741,0,0,24,0,-24
10742,1,0,68,0,-68
10743,0,0,22,0,-22
10744,1,0,31,0,-31
10745,1,1,1046,1634,588
10746,0,0,59,0,-59
10747,1,0,36,0,-36
10748,1,1,101,1339,1238
10749,0,0,42,0,-42
10750,0,0,118,0,-118
10751,0,0,48,0,-48
10752,1,1,247,1209,962
10753,1,1,787,1455,668
10754,1,1,538,1758,1220
10755,0,0,190,0,-190
10756,0,0,77,0,-77
10757,1,0,8,0,-8
10758,1,0,181,0,-181
10759,0,0,59,0,-59
10760,0,0,1,0,-1
10761,1,1,409,1449,1040
10762,0,0,60,0,-60
10763,1,1,411,1296,885
10764,1,1,190,2268,2078
10765,0,0,21,0,-21
10766,0,0,100,0,-100
10767,1,1,684,1761,1077
10768,0,0,26,0,-26
10769,0,0,45,0,-45
10770,1,0,100,0,-100
10771,1,1,1401,1397,-4
10772,1,1,890,1253,363
10773,1,1,289,1395,1106
10774,1,0,52,0,-52
10775,1,0,57,0,-57
10776,0,0,175,0,-175
10777,1,0,6,0,-6
10778,0,0,48,0,-48
10779,0,0,17,0,-17
10780,0,0,35,0,-35
10781,1,1,94,1209,1115
10782,1,0,190,0,-190
10783,1,1,203,1615,1412
10784,0,0,27,0,-27
10785,1,0,42,0,-42
10786,0,0,14,0,-14
10787,1,0,27,0,-27
10788,0,0,54,0,-54
10789,1,0,5,0,-5
10790,0,0,35,0,-35
10791,0,0,77,0,-77
10792,1,1,200,1833,1633
10793,0,0,105,0,-105
10794,0,0,34,0,-34
10795,0,0,6,0,-6
10796,1,1,458,1419,961
10797,1,0,44,0,-44
10798,0,0,29,0,-29
10799,1,1,845,1257,412
10800,0,0,65,0,-65
10801,0,0,77,0,-77
10802,0,0,20,0,-20
10803,1,1,268,1704,1436
10804,0,0,7,0,-7
10805,0,0,44,0,-44
10806,1,0,89,0,-89
10807,0,0,8,0,-8
10808,0,0,209,0,-209
10809,1,0,30,0,-30
10810,0,0,6,0,-6
10811,1,0,16,0,-16
10812,0,0,42,0,-42
10813,0,0,82,0,-82
10814,1,1,250,1327,1077
10815,1,0,118,0,-118
10816,0,0,13,0,-13
10817,1,1,202,2286,2084
10818,1,0,120,0,-120
10819,1,1,175,1287,1112
10820,1,0,293,0,-293
10821,1,1,83,1241,1158
10822,0,0,8,0,-8
10823,0,0,66,0,-66
10824,0,0,6,0,-6
10825,0,0,38,0,-38
10826,1,1,236,1453,1217
10827,0,0,71,0,-71
10828,0,0,12,0,-12
10829,0,0,6,0,-6
10830,1,1,1577,3394,1817
10831,1,0,49,0,-49
10832,0,0,1,0,-1
10833,1,0,25,0,-25
10834,1,0,198,0,-198
10835,0,0,86,0,-86
10836,1,1,947,1976,1029
10837,1,0,101,0,-101
10838,0,0,82,0,-82
10839,1,0,73,0,-73
10840,1,0,93,0,-93
10841,1,0,1,0,-1
10842,0,0,76,0,-76
10843,0,0,44,0,-44
10844,1,0,76,0,-76
10845,0,0,108,0,-108
10846,1,1,200,1808,1608
10847,0,0,30,0,-30
10848,1,0,63,0,-63
10849,1,1,689,1296,607
10850,1,0,191,0,-191
10851,0,0,18,0,-18
10852,1,0,143,0,-143
10853,1,1,256,1308,1052
10854,1,1,532,1373,841
10855,0,0,124,0,-124
10856,0,0,13,0,-13
10857,0,0,227,0,-227
10858,0,0,32,0,-32
10859,0,0,15,0,-15
10860,0,0,17,0,-17
10861,1,0,25,0,-25
10862,0,0,5,0,-5
10863,1,1,343,1597,1254
10864,0,0,3,0,-3
10865,1,1,176,1211,1035
10866,0,0,17,0,-17
10867,1,1,373,1273,900
10868,1,0,31,0,-31
10869,1,1,724,1423,699
10870,0,0,15,0,-15
10871,0,0,5,0,-5
10872,1,1,962,1467,505
10873,0,0,35,0,-35
10874,1,1,139,1222,1083
10875,0,0,49,0,-49
10876,0,0,61,0,-61
10877,0,0,86,0,-86
10878,1,1,390,1456,1066
10879,1,1,121,1255,1134
10880,1,1,1186,1585,399
10881,1,1,33,1347,1314
10882,0,0,109,0,-109
10883,0,0,208,0,-208
10884,0,0,16,0,-16
10885,1,0,152,0,-152
10886,1,0,67,0,-67
10887,1,0,57,0,-57
10888,1,1,113,1452,1339
10889,1,1,93,1331,1238
10890,0,0,7,0,-7
10891,1,0,108,0,-108
10892,0,0,67,0,-67
10893,1,0,84,0,-84
10894,1,1,767,1260,493
10895,1,0,5,0,-5
10896,0,0,148,0,-148
10897,1,0,20,0,-20
10898,1,1,554,2000,1446
10899,1,0,19,0,-19
10900,0,0,5,0,-5
10901,0,0,17,0,-17
10902,1,0,24,0,-24
10903,0,0,1,0,-1
10904,0,0,65,0,-65
10905,1,1,862,1609,747
10906,0,0,8,0,-8
10907,1,0,65,0,-65
10908,1,0,49,0,-49
10909,1,1,609,1234,625
10910,0,0,39,0,-39
10911,1,1,148,1211,1063
10912,1,0,26,0,-26
10913,1,1,935,1280,345
10914,1,1,92,1469,1377
10915,0,0,19,0,-19
10916,1,0,2,0,-2
10917,1,1,892,1306,414
10918,1,1,2924,1355,-1569
10919,1,1,901,1270,369
10920,0,0,77,0,-77
10921,1,1,561,2237,1676
10922,1,0,177,0,-177
10923,0,0,64,0,-64
10924,1,0,8,0,-8
10925,1,0,20,0,-20
10926,0,0,75,0,-75
10927,1,1,2502,1609,-893
10928,1,0,18,0,-18
10929,1,0,33,0,-33
10930,1,0,4,0,-4
10931,1,0,106,0,-106
10932,0,0,1,0,-1
10933,1,0,90,0,-90
10934,1,1,985,1327,342
10935,0,0,37,0,-37
10936,1,0,108,0,-108
10937,0,0,108,0,-108
10938,0,0,2,0,-2
10939,1,1,1508,1998,490
10940,1,1,839,1247,408
10941,1,1,99,1243,1144
10942,1,1,752,1344,592
10943,1,1,186,1262,1076
10944,0,0,13,0,-13
10945,0,0,40,0,-40
10946,0,0,50,0,-50
10947,1,1,1222,1214,-8
10948,1,0,31,0,-31
10949,0,0,63,0,-63
10950,0,0,38,0,-38
10951,1,1,491,1360,869
10952,1,0,62,0,-62
10953,1,1,675,1266,591
10954,1,0,32,0,-32
10955,1,0,130,0,-130
10956,0,0,52,0,-52
10957,0,0,2,0,-2
10958,1,0,23,0,-23
10959,0,0,125,0,-125
10960,0,0,51,0,-51
10961,0,0,38,0,-38
10962,1,1,1039,1230,191
10963,0,0,29,0,-29
10964,0,0,44,0,-44
10965,1,0,88,0,-88
10966,1,0,23,0,-23
10967,1,1,1098,3292,2194
10968,1,0,36,0,-36
10969,1,1,113,1418,1305
10970,1,1,122,1485,1363
10971,1,0,86,0,-86
10972,0,0,46,0,-46
10973,0,0,31,0,-31
10974,0,0,250,0,-250
10975,1,0,69,0,-69
10976,0,0,22,0,-22
10977,0,0,13,0,-13
10978,1,1,661,1388,727
10979,1,0,164,0,-164
10980,1,0,64,0,-64
10981,1,0,112,0,-112
10982,1,0,5,0,-5
10983,1,0,8,0,-8
10984,1,1,434,2117,1683
10985,0,0,27,0,-27
10986,1,1,2559,1383,-1176
10987,1,0,40,0,-40
10988,0,0,279,0,-279
10989,0,0,268,0,-268
10990,1,0,22,0,-22
10991,0,0,114,0,-114
10992,0,0,21,0,-21
10993,0,0,46,0,-46
10994,0,0,13,0,-13
10995,1,0,98,0,-98
10996,1,0,45,0,-45
10997,1,1,314,1289,975
10998,1,0,32,0,-32
10999,0,0,44,0,-44
11000,0,0,45,0,-45
11001,1,1,310,1780,1470
11002,0,0,213,0,-213
11003,0,0,2,0,-2
11004,1,0,5,0,-5
11005,1,0,59,0,-59
11006,1,1,1447,1350,-97
11007,1,1,507,1284,777
11008,1,1,125,2759,2634
11009,1,0,9,0,-9
11010,1,1,164,1557,1393
11011,1,1,270,1654,1384
11012,1,1,99,1663,1564
11013,1,0,23,0,-23
11014,1,0,16,0,-16
11015,0,0,42,0,-42
11016,1,1,125,1272,1147
11017,0,0,78,0,-78
11018,1,1,227,1631,1404
11019,1,0,24,0,-24
11020,1,0,4,0,-4
11021,1,1,383,1205,822
11022,1,0,58,0,-58
11023,0,0,27,0,-27
11024,1,1,994,1334,340
11025,1,0,82,0,-82
11026,1,1,734,1221,487
11027,1,1,956,1380,424
11028,0,0,47,0,-47
11029,0,0,73,0,-73
11030,0,0,58,0,-58
11031,0,0,3,0,-3
11032,0,0,1,0,-1
11033,0,0,1,0,-1
11034,0,0,32,0,-32
11035,1,1,952,1265,313
11036,0,0,22,0,-22
11037,1,0,78,0,-78
11038,1,1,733,1746,1013
11039,1,0,23,0,-23
11040,1,1,162,1363,1201
11041,1,0,128,0,-128
11042,1,0,2,0,-2
11043,1,0,38,0,-38
11044,0,0,6,0,-6
11045,1,1,317,1309,992
11046,1,1,503,1210,707
11047,0,0,24,0,-24
11048,1,0,0,0,0
11049,0,0,40,0,-40
11050,1,0,12,0,-12
11051,1,1,962,1870,908
11052,1,1,296,1332,1036
11053,0,0,8,0,-8
11054,1,0,14,0,-14
11055,1,0,18,0,-18
11056,0,0,23,0,-23
11057,1,1,121,1288,1167
11058,0,0,47,0,-47
11059,1,0,50,0,-50
11060,1,1,135,1256,1121
11061,1,1,731,1354,623
11062,0,0,73,0,-73
11063,0,0,43,0,-43
11064,0,0,59,0,-59
11065,1,1,443,1383,940
11066,0,0,90,0,-90
11067,0,0,342,0,-342
11068,0,0,60,0,-60
11069,1,1,143,1365,1222
11070,0,0,14,0,-14
11071,1,1,147,1342,1195
11072,1,0,171,0,-171
11073,0,0,32,0,-32
11074,1,1,2728,1590,-1138
11075,0,0,136,0,-136
11076,0,0,57,0,-57
11077,1,0,11,0,-11
11078,1,1,255,1698,1443
11079,1,1,561,1749,1188
11080,0,0,38,0,-38
11081,0,0,39,0,-39
11082,1,0,23,0,-23
11083,1,0,24,0,-24
11084,1,1,1702,1380,-322
11085,1,0,64,0,-64
11086,1,0,14,0,-14
11087,1,1,148,1247,1099
11088,1,0,27,0,-27
11089,1,1,585,1457,872
11090,0,0,14,0,-14
11091,1,1,366,1235,869
11092,1,0,118,0,-118
11093,0,0,32,0,-32
11094,1,1,17,1805,1788
11095,0,0,24,0,-24
11096,0,0,2,0,-2
11097,0,0,57,0,-57
11098,1,1,1758,2088,330
11099,1,1,155,1296,1141
11100,1,1,275,2662,2387
11101,0,0,42,0,-42
11102,1,1,428,1290,862
11103,1,0,13,0,-13
11104,1,0,13,0,-13
11105,1,0,53,0,-53
11106,0,0,20,0,-20
11107,1,0,66,0,-66
11108,0,0,33,0,-33
11109,1,1,477,1238,761
11110,1,1,706,1596,890
11111,1,0,87,0,-87
11112,1,1,179,1313,1134
11113,1,1,855,1560,705
11114,1,1,395,1487,1092
11115,0,0,3,0,-3
11116,1,0,80,0,-80
11117,0,0,2,0,-2
11118,0,0,10,0,-10
11119,1,0,38,0,-38
11120,1,0,38,0,-38
11121,0,0,28,0,-28
11122,0,0,111,0,-111
11123,1,0,33,0,-33
11124,1,1,489,1222,733
11125,0,0,74,0,-74
11126,0,0,118,0,-118
11127,0,0,42,0,-42
11128,0,0,4,0,-4
11129,1,0,36,0,-36
11130,1,1,1446,1464,18
11131,0,0,18,0,-18
11132,1,1,576,1432,856
11133,1,1,700,1547,847
11134,1,0,94,0,-94
11135,0,0,89,0,-89
11136,1,0,187,0,-187
11137,0,0,65,0,-65
11138,1,0,66,0,-66
11139,1,1,852,1304,452
11140,1,0,57,0,-57
11141,0,0,21,0,-21
11142,1,0,51,0,-51
11143,1,0,54,0,-54
11144,0,0,84,0,-84
11145,1,0,45,0,-45
11146,1,1,874,1464,590
11147,0,0,33,0,-33
11148,1,1,17,1618,1601
11149,0,0,4,0,-4
11150,1,0,258,0,-258
11151,0,0,141,0,-141
11152,1,1,122,1219,1097
11153,1,0,24,0,-24
11154,0,0,2,0,-2
11155,0,0,14,0,-14
11156,1,1,110,1475,1365
11157,0,0,142,0,-142
11158,0,0,27,0,-27
11159,0,0,76,0,-76
11160,1,0,15,0,-15
11161,1,0,18,0,-18
11162,1,0,32,0,-32
11163,1,0,30,0,-30
11164,1,1,458,1846,1388
11165,1,0,133,0,-133
11166,1,1,399,1402,1003
11167,1,0,38,0,-38
11168,0,0,39,0,-39
11169,1,1,148,1429,1281
11170,1,0,138,0,-138
11171,1,0,54,0,-54
11172,1,0,104,0,-104
11173,1,1,177,1990,1813
11174,0,0,23,0,-23
11175,0,0,8,0,-8
11176,0,0,19,0,-19
11177,1,1,933,1423,490
11178,1,0,34,0,-34
11179,0,0,371,0,-371
11180,1,1,1138,1313,175
11181,0,0,64,0,-64
11182,1,1,124,1376,1252
11183,1,0,141,0,-141
11184,1,1,2244,1300,-944
11185,0,0,8,0,-8
11186,1,0,139,0,-139
11187,1,1,583,1203,620
11188,0,0,26,0,-26
11189,0,0,16,0,-16
11190,1,0,13,0,-13
11191,1,0,40,0,-40
11192,1,0,10,0,-10
11193,1,1,175,1213,1038
11194,0,0,85,0,-85
11195,0,0,8,0,-8
11196,1,1,535,1495,960
11197,0,0,41,0,-41
11198,1,0,71,0,-71
11199,0,0,48,0,-48
11200,1,0,0,0,0
11201,1,1,43,1260,1217
11202,0,0,16,0,-16
11203,1,0,83,0,-83
11204,0,0,39,0,-39
11205,1,0,60,0,-60
11206,0,0,97,0,-97
11207,1,1,117,1526,1409
11208,1,0,49,0,-49
11209,0,0,121,0,-121
11210,0,0,32,0,-32
11211,1,0,15,0,-15
11212,1,0,69,0,-69
11213,0,0,31,0,-31
11214,1,1,2880,1417,-1463
11215,0,0,110,0,-110
11216,0,0,101,0,-101
11217,1,1,548,2454,1906
11218,0,0,62,0,-62
11219,1,0,75,0,-75
11220,0,0,44,0,-44
11221,0,0,22,0,-22
11222,0,0,89,0,-89
11223,1,0,26,0,-26
11224,1,1,49,1268,1219
11225,0,0,20,0,-20
11226,1,1,108,1554,1446
11227,1,1,308,1240,932
11228,1,1,442,1403,961
11229,1,0,40,0,-40
11230,1,0,99,0,-99
11231,0,0,49,0,-49
11232,1,1,667,1331,664
11233,1,0,15,0,-15
11234,1,0,10,0,-10
11235,1,0,15,0,-15
11236,1,1,126,1308,1182
11237,1,0,2,0,-2
11238,1,1,196,1362,1166
11239,1,0,37,0,-37
11240,0,0,0,0,0
11241,0,0,12,0,-12
11242,0,0,12,0,-12
11243,1,0,63,0,-63
11244,0,0,52,0,-52
11245,0,0,0,0,0
11246,0,0,36,0,-36
11247,1,0,20,0,-20
11248,1,0,280,0,-280
11249,1,0,106,0,-106
11250,0,0,19,0,-19
11251,0,0,36,0,-36
11252,0,0,74,0,-74
11253,0,0,29,0,-29
11254,1,1,257,1264,1007
11255,0,0,7,0,-7
11256,0,0,121,0,-121
11257,1,0,129,0,-129
11258,0,0,1,0,-1
11259,1,1,640,1213,573
11260,0,0,2,0,-2
11261,0,0,31,0,-31
11262,1,1,243,1816,1573
11263,0,0,206,0,-206
11264,0,0,14,0,-14
11265,1,1,731,1697,966
11266,1,1,1032,1403,371
11267,1,0,64,0,-64
11268,0,0,14,0,-14
11269,1,1,27,1214,1187
11270,1,0,30,0,-30
11271,1,1,1230,1228,-2
11272,1,1,214,1294,1080
11273,1,1,709,1216,507
11274,1,0,83,0,-83
11275,0,0,102,0,-102
11276,1,1,666,2261,1595
11277,0,0,8,0,-8
11278,0,0,9,0,-9
11279,1,1,89,1225,1136
11280,1,1,375,2355,1980
11281,1,1,180,2197,2017
11282,1,0,124,0,-124
11283,1,1,623,1287,664
11284,0,0,36,0,-36
11285,1,0,70,0,-70
11286,1,1,293,1633,1340
11287,1,0,160,0,-160
11288,0,0,6,0,-6
11289,0,0,132,0,-132
11290,1,1,687,1250,563
11291,1,1,701,2333,1632
11292,1,1,484,1443,959
11293,0,0,23,0,-23
11294,1,1,883,1269,386
11295,1,1,1150,2707,1557
11296,0,0,2,0,-2
11297,1,0,92,0,-92
11298,1,1,392,1355,963
11299,0,0,128,0,-128
11300,0,0,77,0,-77
11301,1,0,111,0,-111
11302,0,0,81,0,-81
11303,0,0,6,0,-6
11304,1,1,561,1642,1081
11305,1,0,6,0,-6
11306,0,0,79,0,-79
11307,1,0,10,0,-10
11308,0,0,11,0,-11
11309,1,1,317,3215,2898
11310,1,1,980,1227,247
11311,0,0,6,0,-6
11312,0,0,46,0,-46
11313,0,0,28,0,-28
11314,1,0,160,0,-160
11315,1,0,56,0,-56
11316,1,0,15,0,-15
11317,1,1,946,1232,286
11318,1,1,605,1242,637
11319,1,0,3,0,-3
11320,0,0,28,0,-28
11321,0,0,32,0,-32
11322,1,1,563,1685,1122
11323,1,1,1165,1622,457
11324,0,0,41,0,-41
11325,1,0,119,0,-119
11326,0,0,40,0,-40
11327,1,1,122,1401,1279
11328,1,1,205,1268,1063
11329,1,0,44,0,-44
11330,1,0,27,0,-27
11331,0,0,41,0,-41
11332,0,0,78,0,-78
11333,0,0,194,0,-194
11334,0,0,4,0,-4
11335,1,0,14,0,-14
11336,0,0,88,0,-88
11337,0,0,77,0,-77
11338,0,0,89,0,-89
11339,0,0,23,0,-23
11340,1,1,18,1453,1435
11341,0,0,35,0,-35
11342,1,1,267,3353,3086
11343,1,0,60,0,-60
11344,0,0,20,0,-20
11345,0,0,115,0,-115
11346,1,0,37,0,-37
11347,1,0,21,0,-21
11348,1,0,150,0,-150
11349,0,0,41,0,-41
11350,0,0,42,0,-42
11351,0,0,89,0,-89
11352,0,0,75,0,-75
11353,1,1,436,1627,1191
11354,1,1,618,1743,1125
11355,0,0,21,0,-21
11356,1,1,1568,1454,-114
11357,1,0,9,0,-9
11358,0,0,113,0,-113
11359,0,0,19,0,-19
11360,1,0,2,0,-2
11361,0,0,17,0,-17
11362,1,1,361,1503,1142
11363,0,0,75,0,-75
11364,0,0,74,0,-74
11365,1,1,641,1769,1128
11366,1,0,21,0,-21
11367,1,1,537,1351,814
11368,0,0,29,0,-29
11369,1,0,92,0,-92
11370,1,1,835,1394,559
11371,0,0,13,0,-13
11372,1,0,13,0,-13
11373,1,0,70,0,-70
11374,1,1,397,1277,880
11375,0,0,16,0,-16
11376,0,0,28,0,-28
11377,1,0,111,0,-111
11378,0,0,41,0,-41
11379,1,0,49,0,-49
11380,0,0,17,0,-17
11381,1,0,111,0,-111
11382,1,0,32,0,-32
11383,0,0,17,0,-17
11384,1,1,568,2202,1634
11385,0,0,5,0,-5
11386,0,0,45,0,-45
11387,1,0,79,0,-79
11388,0,0,15,0,-15
11389,0,0,92,0,-92
11390,0,0,52,0,-52
11391,1,0,88,0,-88
11392,1,1,207,1360,1153
11393,1,0,58,0,-58
11394,1,0,27,0,-27
11395,1,1,342,1485,1143
11396,0,0,10,0,-10
11397,0,0,5,0,-5
11398,1,0,0,0,0
11399,1,1,129,1505,1376
11400,1,0,0,0,0
11401,1,1,497,1221,724
11402,0,0,67,0,-67
11403,0,0,12,0,-12
11404,1,0,63,0,-63
11405,0,0,17,0,-17
11406,1,0,23,0,-23
11407,1,0,95,0,-95
11408,1,1,242,1991,1749
11409,0,0,223,0,-223
11410,1,1,119,1670,1551
11411,1,0,0,0,0
11412,0,0,32,0,-32
11413,0,0,23,0,-23
11414,0,0,74,0,-74
11415,1,1,111,3187,3076
11416,0,0,48,0,-48
11417,0,0,22,0,-22
11418,0,0,56,0,-56
11419,0,0,41,0,-41
11420,0,0,80,0,-80
11421,0,0,75,0,-75
11422,0,0,0,0,0
11423,1,0,2,0,-2
11424,0,0,17,0,-17
11425,1,0,9,0,-9
11426,1,0,2,0,-2
11427,0,0,48,0,-48
11428,0,0,25,0,-25
11429,1,1,884,1404,520
11430,1,0,22,0,-22
11431,0,0,3,0,-3
11432,0,0,66,0,-66
11433,1,1,80,2160,2080
11434,0,0,8,0,-8
11435,0,0,56,0,-56
11436,1,1,620,1426,806
11437,1,0,24,0,-24
11438,1,1,121,1337,1216
11439,0,0,54,0,-54
11440,1,0,70,0,-70
11441,0,0,6,0,-6
11442,0,0,253,0,-253
11443,0,0,72,0,-72
11444,1,0,4,0,-4
11445,0,0,16,0,-16
11446,0,0,29,0,-29
11447,1,1,469,1455,986
11448,0,0,108,0,-108
11449,1,0,51,0,-51
11450,0,0,181,0,-181
11451,1,0,35,0,-35
11452,0,0,11,0,-11
11453,0,0,52,0,-52
11454,0,0,20,0,-20
11455,0,0,123,0,-123
11456,0,0,77,0,-77
11457,0,0,52,0,-52
11458,0,0,3,0,-3
11459,0,0,21,0,-21
11460,0,0,45,0,-45
11461,0,0,8,0,-8
11462,1,0,62,0,-62
11463,0,0,3,0,-3
11464,1,0,16,0,-16
11465,0,0,94,0,-94
11466,0,0,82,0,-82
11467,0,0,104,0,-104
11468,1,1,619,2274,1655
11469,0,0,2,0,-2
11470,1,1,286,1337,1051
11471,1,0,3,0,-3
11472,1,0,9,0,-9
11473,1,0,14,0,-14
11474,0,0,90,0,-90
11475,0,0,46,0,-46
11476,0,0,16,0,-16
11477,1,1,13,2183,2170
11478,0,0,5,0,-5
11479,1,0,33,0,-33
11480,1,0,10,0,-10
11481,1,0,7,0,-7
11482,1,1,437,1207,770
11483,1,0,15,0,-15
11484,0,0,27,0,-27
11485,1,1,895,1214,319
11486,0,0,22,0,-22
11487,0,0,47,0,-47
11488,0,0,18,0,-18
11489,1,0,38,0,-38
11490,1,0,41,0,-41
11491,0,0,127,0,-127
11492,0,0,124,0,-124
11493,0,0,16,0,-16
11494,0,0,39,0,-39
11495,0,0,29,0,-29
11496,1,1,528,1498,970
11497,1,0,9,0,-9
11498,0,0,22,0,-22
11499,1,0,23,0,-23
11500,1,0,37,0,-37
11501,0,0,66,0,-66
11502,1,1,232,2513,2281
11503,1,0,0,0,0
11504,0,0,71,0,-71
11505,1,0,14,0,-14
11506,0,0,16,0,-16
11507,1,1,99,2254,2155
11508,1,1,322,2380,2058
11509,0,0,66,0,-66
11510,1,0,26,0,-26
11511,0,0,12,0,-12
11512,0,0,49,0,-49
11513,1,0,139,0,-139
11514,1,1,33,1503,1470
11515,0,0,24,0,-24
11516,1,0,35,0,-35
11517,1,1,164,1348,1184
11518,0,0,58,0,-58
11519,1,1,188,1232,1044
11520,1,0,4,0,-4
11521,0,0,51,0,-51
11522,0,0,55,0,-55
11523,1,1,501,1343,842
11524,0,0,159,0,-159
11525,1,1,380,1584,1204
11526,1,0,43,0,-43
11527,1,0,21,0,-21
11528,1,0,9,0,-9
11529,0,0,21,0,-21
11530,1,1,149,1374,1225
11531,0,0,40,0,-40
11532,0,0,49,0,-49
11533,0,0,4,0,-4
11534,1,1,275,1355,1080
11535,1,1,1635,1402,-233
11536,0,0,38,0,-38
11537,0,0,10,0,-10
11538,1,0,111,0,-111
11539,1,1,248,1813,1565
11540,1,1,571,1223,652
11541,1,1,695,1207,512
11542,1,1,98,1487,1389
11543,1,1,306,1260,954
11544,1,0,162,0,-162
11545,0,0,150,0,-150
11546,0,0,24,0,-24
11547,1,0,126,0,-126
11548,1,0,114,0,-114
11549,1,0,151,0,-151
11550,0,0,58,0,-58
11551,1,0,89,0,-89
11552,0,0,31,0,-31
11553,0,0,34,0,-34
11554,1,1,221,1925,1704
11555,0,0,2,0,-2
11556,1,0,139,0,-139
11557,1,0,31,0,-31
11558,1,1,646,2087,1441
11559,1,1,717,1226,509
11560,1,0,24,0,-24
11561,1,0,77,0,-77
11562,1,1,208,1335,1127
11563,0,0,0,0,0
11564,1,0,11,0,-11
11565,1,1,1489,2739,1250
11566,0,0,64,0,-64
11567,1,0,2,0,-2
11568,1,0,1,0,-1
11569,1,1,223,1251,1028
11570,1,1,203,1675,1472
11571,0,0,19,0,-19
11572,1,1,498,1749,1251
11573,1,0,70,0,-70
11574,1,0,40,0,-40
11575,0,0,64,0,-64
11576,1,0,25,0,-25
11577,0,0,2,0,-2
11578,1,1,1036,1317,281
11579,0,0,10,0,-10
11580,1,0,4,0,-4
11581,1,0,82,0,-82
11582,1,1,1394,1265,-129
11583,0,0,19,0,-19
11584,1,0,20,0,-20
11585,1,1,278,1444,1166
11586,1,0,31,0,-31
11587,0,0,41,0,-41
11588,0,0,74,0,-74
11589,1,1,720,1359,639
11590,0,0,20,0,-20
11591,1,0,20,0,-20
11592,0,0,11,0,-11
11593,0,0,6,0,-6
11594,1,1,416,1330,914
11595,0,0,0,0,0
11596,0,0,97,0,-97
11597,1,1,461,2298,1837
11598,1,1,645,1245,600
11599,0,0,33,0,-33
11600,1,1,495,1719,1224
11601,0,0,21,0,-21
11602,0,0,47,0,-47
11603,0,0,45,0,-45
11604,1,1,1325,1360,35
11605,0,0,33,0,-33
11606,0,0,86,0,-86
11607,0,0,14,0,-14
11608,1,1,1390,1344,-46
11609,0,0,9,0,-9
11610,1,1,1714,1496,-218
11611,1,0,92,0,-92
11612,1,1,52,2752,2700
11613,1,1,154,1606,1452
11614,1,0,25,0,-25
11615,1,1,254,1269,1015
11616,1,1,351,1584,1233
11617,1,0,5,0,-5
11618,1,1,209,1458,1249
11619,0,0,64,0,-64
11620,1,1,186,1361,1175
11621,0,0,23,0,-23
11622,1,0,178,0,-178
11623,1,0,87,0,-87
11624,0,0,3,0,-3
11625,0,0,1,0,-1
11626,1,0,15,0,-15
11627,1,0,7,0,-7
11628,1,1,963,1209,246
11629,1,0,4,0,-4
11630,1,0,44,0,-44
11631,1,1,220,2565,2345
11632,1,1,167,1260,1093
11633,1,0,5,0,-5
11634,1,0,44,0,-44
11635,1,0,103,0,-103
11636,0,0,54,0,-54
11637,0,0,139,0,-139
11638,0,0,165,0,-165
11639,1,0,3,0,-3
11640,0,0,104,0,-104
11641,1,1,30,1871,1841
11642,1,0,103,0,-103
11643,1,0,90,0,-90
11644,1,1,322,1538,1216
11645,1,1,242,1979,1737
11646,0,0,6,0,-6
11647,0,0,46,0,-46
11648,1,0,11,0,-11
11649,0,0,235,0,-235
11650,1,0,77,0,-77
11651,1,0,42,0,-42
11652,1,0,85,0,-85
11653,0,0,7,0,-7
11654,1,1,1741,1751,10
11655,1,1,346,1693,1347
11656,1,1,273,1223,950
11657,0,0,1,0,-1
11658,1,1,144,1997,1853
11659,1,0,52,0,-52
11660,1,0,116,0,-116
11661,1,1,170,1908,1738
11662,0,0,55,0,-55
11663,1,1,227,1334,1107
11664,1,0,76,0,-76
11665,1,1,457,1206,749
11666,0,0,29,0,-29
11667,1,0,12,0,-12
11668,0,0,78,0,-78
11669,1,1,953,1735,782
11670,0,0,6,0,-6
11671,1,0,36,0,-36
11672,0,0,34,0,-34
11673,1,0,27,0,-27
11674,0,0,1,0,-1
11675,0,0,7,0,-7
11676,1,1,135,1291,1156
11677,0,0,83,0,-83
11678,1,1,634,1352,718
11679,1,1,593,1230,637
11680,0,0,155,0,-155
11681,1,1,265,1753,1488
11682,0,0,40,0,-40
11683,1,0,10,0,-10
11684,0,0,38,0,-38
11685,1,1,617,1588,971
11686,0,0,9,0,-9
11687,0,0,160,0,-160
11688,1,1,131,1284,1153
11689,0,0,5,0,-5
11690,1,1,281,1369,1088
11691,1,0,66,0,-66
11692,1,0,68,0,-68
11693,0,0,48,0,-48
11694,0,0,11,0,-11
11695,0,0,103,0,-103
11696,1,0,3,0,-3
11697,0,0,109,0,-109
11698,0,0,39,0,-39
11699,1,1,620,1282,662
11700,0,0,31,0,-31
11701,0,0,24,0,-24
11702,1,1,99,1220,1121
11703,1,1,942,1268,326
11704,0,0,25,0,-25
11705,1,0,17,0,-17
11706,0,0,11,0,-11
11707,1,1,426,1554,1128
11708,1,1,790,1256,466
11709,1,0,47,0,-47
11710,1,0,4,0,-4
11711,1,1,708,1723,1015
11712,1,0,32,0,-32
11713,1,0,62,0,-62
11714,1,0,87,0,-87
11715,0,0,22,0,-22
11716,1,0,30,0,-30
11717,0,0,13,0,-13
11718,0,0,10,0,-10
11719,1,0,104,0,-104
11720,0,0,56,0,-56
11721,0,0,58,0,-58
11722,1,1,484,1218,734
11723,1,1,168,1929,1761
11724,1,0,158,0,-158
11725,1,1,120,1656,1536
11726,0,0,65,0,-65
11727,1,1,233,1267,1034
11728,0,0,75,0,-75
11729,1,0,1,0,-1
11730,1,1,334,1912,1578
11731,1,1,1208,1330,122
11732,0,0,55,0,-55
11733,1,0,115,0,-115
11734,1,0,182,0,-182
11735,1,0,83,0,-83
11736,1,1,173,1404,1231
11737,1,0,42,0,-42
11738,0,0,14,0,-14
11739,1,0,1,0,-1
11740,0,0,6,0,-6
11741,0,0,86,0,-86
11742,0,0,2,0,-2
11743,0,0,77,0,-77
11744,0,0,120,0,-120
11745,1,0,0,0,0
11746,1,0,99,0,-99
11747,1,1,814,1348,534
11748,1,0,78,0,-78
11749,0,0,225,0,-225
11750,1,0,14,0,-14
11751,0,0,13,0,-13
11752,0,0,47,0,-47
11753,1,0,32,0,-32
11754,0,0,4,0,-4
11755,1,1,536,1855,1319
11756,0,0,54,0,-54
11757,0,0,41,0,-41
11758,1,1,614,1372,758
11759,1,0,6,0,-6
11760,1,1,413,1245,832
11761,1,1,339,2198,1859
11762,0,0,88,0,-88
11763,0,0,83,0,-83
11764,0,0,29,0,-29
11765,0,0,20,0,-20
11766,1,1,923,1410,487
11767,1,1,1505,1230,-275
11768,1,0,31,0,-31
11769,1,1,736,1379,643
11770,0,0,274,0,-274
11771,0,0,59,0,-59
11772,1,1,1818,1608,-210
11773,0,0,26,0,-26
11774,1,1,905,1654,749
11775,1,1,871,1622,751
11776,0,0,71,0,-71
11777,1,1,102,2333,2231
11778,1,1,229,1240,1011
11779,0,0,60,0,-60
11780,1,0,132,0,-132
11781,1,0,45,0,-45
11782,1,1,513,2691,2178
11783,0,0,118,0,-118
11784,0,0,23,0,-23
11785,1,0,15,0,-15
11786,0,0,6,0,-6
11787,0,0,30,0,-30
11788,0,0,47,0,-47
11789,0,0,85,0,-85
11790,1,0,8,0,-8
11791,1,0,23,0,-23
11792,1,1,991,1452,461
11793,0,0,85,0,-85
11794,1,1,411,1364,953
11795,1,1,118,1872,1754
11796,0,0,5,0,-5
11797,0,0,89,0,-89
11798,1,0,18,0,-18
11799,1,1,761,1858,1097
11800,1,1,280,1428,1148
11801,1,1,191,1243,1052
11802,0,0,33,0,-33
11803,0,0,26,0,-26
11804,0,0,39,0,-39
11805,1,0,39,0,-39
11806,0,0,72,0,-72
11807,0,0,3,0,-3
11808,1,1,199,1323,1124
11809,0,0,15,0,-15
11810,0,0,67,0,-67
11811,0,0,212,0,-212
11812,0,0,1,0,-1
11813,0,0,56,0,-56
11814,0,0,128,0,-128
11815,1,1,137,1385,1248
11816,1,0,10,0,-10
11817,1,0,0,0,0
11818,1,1,596,1206,610
11819,0,0,83,0,-83
11820,1,0,49,0,-49
11821,0,0,48,0,-48
11822,1,0,31,0,-31
11823,0,0,256,0,-256
11824,0,0,10,0,-10
11825,0,0,51,0,-51
11826,0,0,26,0,-26
11827,0,0,69,0,-69
11828,0,0,12,0,-12
11829,1,1,429,1861,1432
11830,0,0,137,0,-137
11831,1,0,114,0,-114
11832,1,1,1501,1248,-253
11833,1,0,26,0,-26
11834,1,1,87,1243,1156
11835,1,1,1108,1586,478
11836,0,0,4,0,-4
11837,0,0,16,0,-16
11838,1,0,19,0,-19
11839,0,0,14,0,-14
11840,1,1,1020,2430,1410
11841,1,0,25,0,-25
11842,1,1,392,1271,879
11843,0,0,119,0,-119
11844,1,0,20,0,-20
11845,0,0,29,0,-29
11846,1,1,1943,1401,-542
11847,1,1,19,1281,1262
11848,0,0,80,0,-80
11849,1,0,206,0,-206
11850,1,0,21,0,-21
11851,1,0,60,0,-60
11852,0,0,50,0,-50
11853,1,0,74,0,-74
11854,1,0,71,0,-71
11855,0,0,45,0,-45
11856,1,1,329,1424,1095
11857,1,0,5,0,-5
11858,1,0,11,0,-11
11859,1,0,49,0,-49
11860,0,0,100,0,-100
11861,0,0,137,0,-137
11862,1,1,217,2009,1792
11863,1,0,34,0,-34
11864,1,0,14,0,-14
11865,1,1,837,1221,384
11866,1,0,36,0,-36
11867,0,0,77,0,-77
11868,0,0,8,0,-8
11869,1,1,314,1658,1344
11870,1,1,112,1307,1195
11871,1,1,859,1313,454
11872,0,0,14,0,-14
11873,1,1,60,1416,1356
11874,1,1,79,2313,2234
11875,0,0,102,0,-102
11876,0,0,61,0,-61
11877,1,1,498,2593,2095
11878,0,0,104,0,-104
11879,0,0,19,0,-19
11880,0,0,8,0,-8
11881,1,1,238,1961,1723
11882,0,0,30,0,-30
11883,1,1,528,1745,1217
11884,0,0,128,0,-128
11885,1,1,99,1241,1142
11886,0,0,8,0,-8
11887,0,0,46,0,-46
11888,1,1,393,1435,1042
11889,1,0,24,0,-24
11890,1,0,77,0,-77
11891,1,1,720,1370,650
11892,0,0,10,0,-10
11893,1,1,141,1679,1538
11894,1,0,51,0,-51
11895,0,0,3,0,-3
11896,1,1,745,1559,814
11897,1,0,36,0,-36
11898,1,0,64,0,-64
11899,1,1,661,2198,1537
11900,0,0,108,0,-108
11901,1,0,127,0,-127
11902,1,1,698,1314,616
11903,1,1,106,1748,1642
11904,1,0,16,0,-16
11905,1,0,88,0,-88
11906,1,1,742,1662,920
11907,1,1,1722,2207,485
11908,1,1,175,1994,1819
11909,1,0,23,0,-23
11910,1,0,56,0,-56
11911,0,0,16,0,-16
11912,1,0,29,0,-29
11913,1,1,194,1256,1062
11914,0,0,52,0,-52
11915,1,0,13,0,-13
11916,0,0,8,0,-8
11917,0,0,9,0,-9
11918,1,1,108,1346,1238
11919,1,1,818,2025,1207
11920,1,1,129,1323,1194
11921,0,0,86,0,-86
11922,0,0,54,0,-54
11923,1,1,395,1472,1077
11924,1,1,263,1247,984
11925,1,1,81,1375,1294
11926,1,1,313,1304,991
11927,1,1,830,1662,832
11928,0,0,120,0,-120
11929,1,1,427,1207,780
11930,0,0,1,0,-1
11931,1,1,349,2661,2312
11932,1,0,150,0,-150
11933,1,1,360,1538,1178
11934,1,0,32,0,-32
11935,0,0,16,0,-16
11936,0,0,49,0,-49
11937,0,0,9,0,-9
11938,1,0,26,0,-26
11939,1,0,90,0,-90
11940,0,0,44,0,-44
11941,1,0,56,0,-56
11942,1,0,29,0,-29
11943,1,0,1,0,-1
11944,1,1,408,1268,860
11945,0,0,45,0,-45
11946,1,0,52,0,-52
11947,1,0,0,0,0
11948,1,0,29,0,-29
11949,0,0,113,0,-113
11950,1,0,75,0,-75
11951,1,0,5,0,-5
11952,0,0,12,0,-12
11953,1,0,183,0,-183
11954,1,0,0,0,0
11955,0,0,15,0,-15
11956,1,0,50,0,-50
11957,0,0,33,0,-33
11958,1,1,171,1241,1070
11959,1,0,10,0,-10
11960,1,0,65,0,-65
11961,0,0,18,0,-18
11962,1,1,584,1309,725
11963,1,1,143,1281,1138
11964,1,0,50,0,-50
11965,1,1,325,1209,884
11966,1,1,103,1381,1278
11967,1,0,8,0,-8
11968,1,0,22,0,-22
11969,0,0,59,0,-59
11970,1,1,702,1223,521
11971,1,1,882,1261,379
11972,0,0,11,0,-11
11973,1,1,1045,1242,197
11974,1,0,18,0,-18
11975,1,1,120,1386,1266
11976,0,0,20,0,-20
11977,0,0,20,0,-20
11978,1,1,527,1336,809
11979,1,1,24,1406,1382
11980,1,0,39,0,-39
11981,0,0,37,0,-37
11982,1,0,33,0,-33
11983,0,0,58,0,-58
11984,1,1,291,1204,913
11985,1,0,108,0,-108
11986,1,0,50,0,-50
11987,1,1,120,1250,1130
11988,1,0,70,0,-70
11989,1,1,120,1594,1474
11990,1,0,63,0,-63
11991,1,0,29,0,-29
11992,0,0,23,0,-23
11993,1,1,527,1585,1058
11994,1,0,34,0,-34
11995,1,0,11,0,-11
11996,0,0,50,0,-50
11997,1,1,1000,1782,782
11998,0,0,13,0,-13
11999,0,0,19,0,-19
12000,0,0,87,0,-87
12001,1,0,43,0,-43
12002,0,0,45,0,-45
12003,0,0,13,0,-13
12004,0,0,47,0,-47
12005,1,0,3,0,-3
12006,1,0,2,0,-2
12007,1,1,242,1207,965
12008,1,1,36,1242,1206
12009,1,1,127,1248,1121
12010,1,0,142,0,-142
12011,0,0,70,0,-70
12012,1,0,85,0,-85
12013,0,0,15,0,-15
12014,0,0,108,0,-108
12015,1,0,75,0,-75
12016,0,0,9,0,-9
12017,0,0,34,0,-34
12018,0,0,0,0,0
12019,0,0,96,0,-96
12020,1,1,260,1348,1088
12021,0,0,139,0,-139
12022,0,0,107,0,-107
12023,1,1,135,1237,1102
12024,1,0,62,0,-62
12025,0,0,64,0,-64
12026,0,0,69,0,-69
12027,0,0,99,0,-99
12028,1,1,918,1230,312
12029,0,0,23,0,-23
12030,0,0,53,0,-53
12031,1,1,1993,1876,-117
12032,1,0,43,0,-43
12033,1,1,126,2341,2215
12034,1,0,121,0,-121
12035,1,1,195,1350,1155
12036,0,0,97,0,-97
12037,0,0,65,0,-65
12038,1,0,33,0,-33
12039,1,1,870,1342,472
12040,1,0,168,0,-168
12041,0,0,111,0,-111
12042,1,1,856,1248,392
12043,1,1,439,1298,859
12044,0,0,29,0,-29
12045,0,0,1,0,-1
12046,0,0,59,0,-59
12047,1,0,10,0,-10
12048,1,1,1057,1416,359
12049,1,0,63,0,-63
12050,1,0,169,0,-169
12051,1,1,253,1879,1626
12052,1,0,77,0,-77
12053,0,0,48,0,-48
12054,1,1,764,2214,1450
12055,1,0,15,0,-15
12056,1,1,622,1478,856
12057,0,0,26,0,-26
12058,0,0,10,0,-10
12059,1,0,64,0,-64
12060,0,0,4,0,-4
12061,1,1,176,2613,2437
12062,1,0,0,0,0
12063,0,0,10,0,-10
12064,1,0,24,0,-24
12065,1,0,7,0,-7
12066,1,0,2,0,-2
12067,1,1,557,2196,1639
12068,1,1,239,1266,1027
12069,0,0,31,0,-31
12070,1,1,182,1219,1037
12071,0,0,17,0,-17
12072,0,0,48,0,-48
12073,1,1,181,1223,1042
12074,0,0,96,0,-96
12075,1,1,367,1234,867
12076,0,0,47,0,-47
12077,1,1,1956,1415,-541
12078,1,0,51,0,-51
12079,1,1,354,3656,3302
12080,1,1,199,1230,1031
12081,0,0,24,0,-24
12082,0,0,39,0,-39
12083,1,1,112,1305,1193
12084,1,0,11,0,-11
12085,1,0,25,0,-25
12086,0,0,125,0,-125
12087,1,0,17,0,-17
12088,1,1,286,1706,1420
12089,0,0,19,0,-19
12090,1,1,178,1209,1031
12091,1,1,118,1590,1472
12092,1,0,41,0,-41
12093,1,1,149,1261,1112
12094,1,0,9,0,-9
12095,1,1,104,1712,1608
12096,1,0,3,0,-3
12097,0,0,20,0,-20
12098,0,0,58,0,-58
12099,0,0,61,0,-61
12100,1,0,16,0,-16
12101,1,0,43,0,-43
12102,0,0,22,0,-22
12103,1,0,118,0,-118
12104,1,1,1360,1468,108
12105,1,1,212,1219,1007
12106,0,0,37,0,-37
12107,1,0,3,0,-3
12108,1,0,49,0,-49
12109,1,0,28,0,-28
12110,1,1,351,1652,1301
12111,0,0,109,0,-109
12112,0,0,37,0,-37
12113,0,0,49,0,-49
12114,1,0,13,0,-13
12115,1,0,66,0,-66
12116,1,0,23,0,-23
12117,0,0,62,0,-62
12118,0,0,8,0,-8
12119,0,0,2,0,-2
12120,1,0,303,0,-303
12121,1,0,128,0,-128
12122,1,0,58,0,-58
12123,0,0,54,0,-54
12124,1,1,761,1474,713
12125,0,0,49,0,-49
12126,1,1,758,1213,455
12127,1,0,14,0,-14
12128,0,0,175,0,-175
12129,0,0,155,0,-155
12130,0,0,6,0,-6
12131,0,0,21,0,-21
12132,0,0,45,0,-45
12133,0,0,60,0,-60
12134,0,0,104,0,-104
12135,1,0,194,0,-194
12136,1,0,32,0,-32
12137,1,0,89,0,-89
12138,0,0,19,0,-19
12139,0,0,3,0,-3
12140,1,1,210,1404,1194
12141,0,0,14,0,-14
12142,1,0,23,0,-23
12143,1,0,71,0,-71
12144,1,1,119,1346,1227
12145,1,0,22,0,-22
12146,0,0,41,0,-41
12147,1,0,72,0,-72
12148,0,0,26,0,-26
12149,1,0,19,0,-19
12150,0,0,34,0,-34
12151,0,0,14,0,-14
12152,1,0,66,0,-66
12153,0,0,17,0,-17
12154,1,0,16,0,-16
12155,1,0,36,0,-36
12156,0,0,26,0,-26
12157,1,0,32,0,-32
12158,1,0,41,0,-41
12159,0,0,48,0,-48
12160,0,0,19,0,-19
12161,0,0,8,0,-8
12162,0,0,153,0,-153
12163,0,0,42,0,-42
12164,0,0,43,0,-43
12165,0,0,9,0,-9
12166,1,1,1121,1432,311
12167,1,0,19,0,-19
12168,1,0,6,0,-6
12169,1,0,54,0,-54
12170,1,0,52,0,-52
12171,0,0,12,0,-12
12172,1,0,66,0,-66
12173,0,0,49,0,-49
12174,1,0,38,0,-38
12175,1,1,364,3498,3134
12176,1,0,16,0,-16
12177,1,1,485,1588,1103
12178,0,0,62,0,-62
12179,1,0,22,0,-22
12180,1,0,62,0,-62
12181,1,0,11,0,-11
12182,0,0,33,0,-33
12183,0,0,24,0,-24
12184,1,0,32,0,-32
12185,1,1,623,1485,862
12186,1,1,205,2044,1839
12187,1,0,13,0,-13
12188,1,1,761,1509,748
12189,0,0,27,0,-27
12190,1,1,823,1446,623
12191,1,0,1,0,-1
12192,1,0,4,0,-4
12193,0,0,7,0,-7
12194,1,0,6,0,-6
12195,0,0,26,0,-26
12196,1,1,544,1604,1060
12197,1,1,288,1356,1068
12198,0,0,25,0,-25
12199,1,1,606,1282,676
12200,1,1,838,1700,862
12201,0,0,95,0,-95
12202,1,1,622,1780,1158
12203,1,0,61,0,-61
12204,1,0,34,0,-34
12205,1,1,1390,1644,254
12206,0,0,29,0,-29
12207,1,0,21,0,-21
12208,1,0,132,0,-132
12209,1,0,4,0,-4
12210,1,0,27,0,-27
12211,1,1,145,1798,1653
12212,0,0,13,0,-13
12213,0,0,45,0,-45
12214,1,1,311,1519,1208
12215,0,0,77,0,-77
12216,0,0,19,0,-19
12217,1,1,264,3655,3391
12218,0,0,18,0,-18
12219,0,0,19,0,-19
12220,0,0,158,0,-158
12221,1,1,338,1625,1287
12222,0,0,11,0,-11
12223,1,0,17,0,-17
12224,1,1,306,1836,1530
12225,1,1,416,1851,1435
12226,0,0,84,0,-84
12227,1,0,28,0,-28
12228,0,0,134,0,-134
12229,0,0,11,0,-11
12230,1,0,2,0,-2
12231,1,1,341,1320,979
12232,0,0,6,0,-6
12233,0,0,94,0,-94
12234,0,0,8,0,-8
12235,1,0,89,0,-89
12236,1,1,781,1222,441
12237,1,1,72,1357,1285
12238,1,0,13,0,-13
12239,1,1,1083,1481,398
12240,1,0,11,0,-11
12241,0,0,22,0,-22
12242,1,1,758,1810,1052
12243,0,0,255,0,-255
12244,0,0,51,0,-51
12245,1,1,53,1298,1245
12246,1,0,107,0,-107
12247,0,0,5,0,-5
12248,1,0,27,0,-27
12249,1,1,1781,1254,-527
12250,1,0,11,0,-11
12251,1,1,1433,1391,-42
12252,0,0,12,0,-12
12253,0,0,7,0,-7
12254,1,0,45,0,-45
12255,0,0,37,0,-37
12256,0,0,184,0,-184
12257,0,0,37,0,-37
12258,1,1,325,2042,1717
12259,1,1,152,1292,1140
12260,1,0,114,0,-114
12261,0,0,7,0,-7
12262,0,0,83,0,-83
12263,1,0,174,0,-174
12264,1,0,160,0,-160
12265,0,0,32,0,-32
12266,1,0,12,0,-12
12267,1,0,197,0,-197
12268,0,0,23,0,-23
12269,1,0,41,0,-41
12270,0,0,14,0,-14
12271,0,0,98,0,-98
12272,1,0,39,0,-39
12273,0,0,32,0,-32
12274,1,0,52,0,-52
12275,0,0,10,0,-10
12276,0,0,174,0,-174
12277,1,1,326,1318,992
12278,0,0,39,0,-39
12279,1,0,18,0,-18
12280,1,0,98,0,-98
12281,1,0,42,0,-42
12282,1,0,27,0,-27
12283,1,0,18,0,-18
12284,1,0,166,0,-166
12285,0,0,38,0,-38
12286,1,1,386,1232,846
12287,0,0,17,0,-17
12288,1,1,373,1262,889
12289,1,1,457,1356,899
12290,1,0,93,0,-93
12291,1,1,949,1211,262
12292,0,0,160,0,-160
12293,0,0,58,0,-58
12294,0,0,71,0,-71
12295,1,0,30,0,-30
12296,1,1,602,1339,737
12297,1,0,47,0,-47
12298,1,1,184,1277,1093
12299,0,0,98,0,-98
12300,1,1,1184,1217,33
12301,0,0,8,0,-8
12302,1,1,653,1528,875
12303,1,0,67,0,-67
12304,0,0,45,0,-45
12305,0,0,0,0,0
12306,1,0,2,0,-2
12307,1,0,6,0,-6
12308,1,0,109,0,-109
12309,0,0,10,0,-10
12310,1,1,254,1209,955
12311,0,0,3,0,-3
12312,1,1,291,1212,921
12313,0,0,76,0,-76
12314,1,0,104,0,-104
12315,0,0,34,0,-34
12316,1,1,218,1327,1109
12317,1,1,627,1425,798
12318,1,0,98,0,-98
12319,0,0,45,0,-45
12320,1,1,298,1371,1073
12321,0,0,18,0,-18
12322,1,1,158,1280,1122
12323,1,1,967,1722,755
12324,1,0,157,0,-157
12325,0,0,3,0,-3
12326,0,0,160,0,-160
12327,1,0,90,0,-90
12328,1,0,82,0,-82
12329,1,1,733,1755,1022
12330,1,0,38,0,-38
12331,0,0,23,0,-23
12332,1,1,642,1230,588
12333,0,0,68,0,-68
12334,0,0,154,0,-154
12335,0,0,60,0,-60
12336,0,0,25,0,-25
12337,0,0,1,0,-1
12338,1,0,55,0,-55
12339,1,0,24,0,-24
12340,0,0,110,0,-110
12341,0,0,142,0,-142
12342,1,0,67,0,-67
12343,0,0,32,0,-32
12344,1,1,337,1267,930
12345,1,0,46,0,-46
12346,0,0,36,0,-36
12347,0,0,21,0,-21
12348,0,0,22,0,-22
12349,1,1,1636,1445,-191
12350,0,0,174,0,-174
12351,1,0,93,0,-93
12352,0,0,73,0,-73
12353,0,0,12,0,-12
12354,1,1,392,1371,979
12355,0,0,10,0,-10
12356,1,0,11,0,-11
12357,1,0,34,0,-34
12358,0,0,6,0,-6
12359,0,0,111,0,-111
12360,0,0,25,0,-25
12361,1,0,8,0,-8
12362,0,0,29,0,-29
12363,0,0,22,0,-22
12364,1,0,72,0,-72
12365,0,0,2,0,-2
12366,0,0,18,0,-18
12367,1,1,303,1407,1104
12368,1,0,25,0,-25
12369,1,1,901,1462,561
12370,1,0,6,0,-6
12371,0,0,89,0,-89
12372,0,0,12,0,-12
12373,1,1,532,1245,713
12374,0,0,68,0,-68
12375,1,0,90,0,-90
12376,1,0,76,0,-76
12377,1,1,3145,1460,-1685
12378,0,0,28,0,-28
12379,0,0,212,0,-212
12380,1,1,682,1688,1006
12381,0,0,96,0,-96
12382,1,1,446,1335,889
12383,1,1,162,1805,1643
12384,1,1,326,1776,1450
12385,1,0,106,0,-106
12386,1,0,179,0,-179
12387,1,0,58,0,-58
12388,1,0,137,0,-137
12389,0,0,17,0,-17
12390,1,0,71,0,-71
12391,1,0,0,0,0
12392,0,0,6,0,-6
12393,0,0,57,0,-57
12394,1,0,138,0,-138
12395,1,0,33,0,-33
12396,0,0,106,0,-106
12397,0,0,22,0,-22
12398,0,0,1,0,-1
12399,0,0,117,0,-117
12400,0,0,67,0,-67
12401,0,0,32,0,-32
12402,1,1,283,1224,941
12403,1,0,4,0,-4
12404,0,0,49,0,-49
12405,0,0,4,0,-4
12406,1,1,110,1728,1618
12407,1,0,32,0,-32
12408,1,1,464,1881,1417
12409,1,1,778,1687,909
12410,1,0,50,0,-50
12411,0,0,5,0,-5
12412,1,0,62,0,-62
12413,1,1,1040,2131,1091
12414,0,0,2,0,-2
12415,1,1,80,1298,1218
12416,1,0,83,0,-83
12417,1,1,384,2564,2180
12418,1,1,832,1405,573
12419,0,0,39,0,-39
12420,1,0,10,0,-10
12421,1,0,140,0,-140
12422,1,0,52,0,-52
12423,0,0,40,0,-40
12424,1,1,667,1502,835
12425,1,1,1161,4034,2873
12426,1,0,37,0,-37
12427,0,0,37,0,-37
12428,1,1,349,3168,2819
12429,0,0,22,0,-22
12430,1,1,247,2507,2260
12431,1,0,1,0,-1
12432,0,0,1,0,-1
12433,0,0,67,0,-67
12434,1,0,0,0,0
12435,0,0,262,0,-262
12436,1,1,726,1599,873
12437,1,1,396,1420,1024
12438,1,1,300,1685,1385
12439,0,0,47,0,-47
12440,1,0,2,0,-2
12441,1,1,266,1238,972
12442,0,0,15,0,-15
12443,1,1,80,2174,2094
12444,1,1,1148,1439,291
12445,1,1,63,1226,1163
12446,0,0,44,0,-44
12447,1,0,13,0,-13
12448,1,1,247,1884,1637
12449,1,0,78,0,-78
12450,0,0,90,0,-90
12451,1,0,66,0,-66
12452,1,1,682,1299,617
12453,0,0,9,0,-9
12454,0,0,62,0,-62
12455,1,1,87,1353,1266
12456,1,0,27,0,-27
12457,1,1,513,1402,889
12458,0,0,22,0,-22
12459,1,1,512,1334,822
12460,0,0,142,0,-142
12461,1,1,264,1400,1136
12462,0,0,134,0,-134
12463,0,0,0,0,0
12464,0,0,27,0,-27
12465,1,0,158,0,-158
12466,1,0,13,0,-13
12467,1,0,76,0,-76
12468,1,1,200,1278,1078
12469,1,0,6,0,-6
12470,1,0,0,0,0
12471,1,1,1156,1501,345
12472,1,0,33,0,-33
12473,1,1,166,1585,1419
12474,1,1,246,1466,1220
12475,0,0,116,0,-116
12476,1,1,459,1355,896
12477,1,0,58,0,-58
12478,0,0,4,0,-4
12479,1,1,476,1748,1272
12480,0,0,169,0,-169
12481,1,0,8,0,-8
12482,0,0,28,0,-28
12483,0,0,4,0,-4
12484,1,1,580,1205,625
12485,0,0,63,0,-63
12486,1,1,575,1203,628
12487,0,0,0,0,0
12488,1,0,86,0,-86
12489,1,0,42,0,-42
12490,0,0,32,0,-32
12491,0,0,129,0,-129
12492,0,0,8,0,-8
12493,1,0,2,0,-2
12494,0,0,4,0,-4
12495,0,0,8,0,-8
12496,0,0,13,0,-13
12497,1,0,97,0,-97
12498,0,0,60,0,-60
12499,0,0,17,0,-17
12500,1,0,16,0,-16
12501,1,1,1047,2059,1012
12502,1,1,1436,1982,546
12503,1,1,235,2621,2386
12504,0,0,32,0,-32
12505,1,1,181,2092,1911
12506,0,0,81,0,-81
12507,0,0,85,0,-85
12508,0,0,121,0,-121
12509,0,0,49,0,-49
12510,1,1,77,1285,1208
12511,0,0,81,0,-81
12512,0,0,184,0,-184
12513,0,0,9,0,-9
12514,0,0,83,0,-83
12515,0,0,31,0,-31
12516,1,0,1,0,-1
12517,0,0,52,0,-52
12518,1,0,9,0,-9
12519,0,0,67,0,-67
12520,0,0,90,0,-90
12521,1,1,143,1209,1066
12522,1,1,482,1204,722
12523,0,0,22,0,-22
12524,0,0,88,0,-88
12525,0,0,62,0,-62
12526,1,0,2,0,-2
12527,0,0,34,0,-34
12528,1,1,946,1319,373
12529,1,1,171,1340,1169
12530,0,0,136,0,-136
12531,1,1,884,1275,391
12532,0,0,5,0,-5
12533,1,0,41,0,-41
12534,0,0,51,0,-51
12535,0,0,22,0,-22
12536,1,1,525,1324,799
12537,0,0,80,0,-80
12538,0,0,26,0,-26
12539,0,0,36,0,-36
12540,1,0,104,0,-104
12541,0,0,29,0,-29
12542,1,1,599,1426,827
12543,1,1,18,1352,1334
12544,1,1,172,1789,1617
12545,0,0,121,0,-121
12546,1,1,269,2052,1783
12547,1,0,5,0,-5
12548,1,1,1182,1529,347
12549,1,1,472,1981,1509
12550,0,0,7,0,-7
12551,1,0,101,0,-101
12552,0,0,119,0,-119
12553,1,0,72,0,-72
12554,1,1,307,1306,999
12555,1,0,61,0,-61
12556,1,1,937,1625,688
12557,0,0,5,0,-5
12558,0,0,43,0,-43
12559,0,0,87,0,-87
12560,0,0,28,0,-28
12561,1,1,759,1370,611
12562,1,1,268,1357,1089
12563,1,1,190,1487,1297
12564,1,0,14,0,-14
12565,1,1,326,1308,982
12566,0,0,115,0,-115
12567,1,0,99,0,-99
12568,1,1,2212,1460,-752
12569,1,0,77,0,-77
12570,0,0,31,0,-31
12571,1,0,0,0,0
12572,0,0,34,0,-34
12573,1,0,60,0,-60
12574,1,1,1770,1596,-174
12575,1,1,92,1321,1229
12576,0,0,6,0,-6
12577,1,1,282,1233,951
12578,1,0,77,0,-77
12579,0,0,78,0,-78
12580,1,0,37,0,-37
12581,0,0,372,0,-372
12582,0,0,28,0,-28
12583,1,0,46,0,-46
12584,0,0,26,0,-26
12585,1,0,203,0,-203
12586,1,1,2090,1276,-814
12587,1,0,124,0,-124
12588,0,0,45,0,-45
12589,0,0,0,0,0
12590,1,0,36,0,-36
12591,1,0,64,0,-64
12592,1,1,188,1212,1024
12593,1,1,1204,1413,209
12594,0,0,21,0,-21
12595,1,0,5,0,-5
12596,0,0,34,0,-34
12597,0,0,31,0,-31
12598,1,0,2,0,-2
12599,1,0,9,0,-9
12600,0,0,57,0,-57
12601,1,1,203,1502,1299
12602,0,0,64,0,-64
12603,0,0,24,0,-24
12604,1,1,86,1414,1328
12605,1,0,4,0,-4
12606,1,1,432,1571,1139
12607,0,0,40,0,-40
12608,1,1,261,1471,1210
12609,1,1,1467,1536,69
12610,1,1,233,1609,1376
12611,0,0,23,0,-23
12612,1,0,121,0,-121
12613,1,1,718,1339,621
12614,1,1,728,1447,719
12615,0,0,4,0,-4
12616,1,0,24,0,-24
12617,1,1,61,1238,1177
12618,1,0,30,0,-30
12619,1,1,611,1590,979
12620,0,0,5,0,-5
12621,1,1,1062,1398,336
12622,1,1,638,1375,737
12623,0,0,63,0,-63
12624,0,0,27,0,-27
12625,1,0,56,0,-56
12626,0,0,246,0,-246
12627,1,1,1620,1777,157
12628,1,1,165,1714,1549
12629,1,0,78,0,-78
12630,1,0,107,0,-107
12631,1,0,177,0,-177
12632,1,1,818,1273,455
12633,0,0,15,0,-15
12634,0,0,7,0,-7
12635,1,1,488,2073,1585
12636,0,0,33,0,-33
12637,1,0,0,0,0
12638,1,0,15,0,-15
12639,1,1,205,1421,1216
12640,0,0,159,0,-159
12641,1,0,28,0,-28
12642,0,0,5,0,-5
12643,0,0,125,0,-125
12644,0,0,73,0,-73
12645,0,0,23,0,-23
12646,1,0,159,0,-159
12647,0,0,7,0,-7
12648,1,0,6,0,-6
12649,1,1,145,1617,1472
12650,1,1,300,1289,989
12651,1,1,675,1382,707
12652,0,0,150,0,-150
12653,1,1,597,1779,1182
12654,0,0,3,0,-3
12655,1,1,42,1201,1159
12656,1,0,13,0,-13
12657,1,1,436,1422,986
12658,1,1,226,1203,977
12659,1,1,213,1398,1185
12660,0,0,16,0,-16
12661,0,0,27,0,-27
12662,1,1,601,4345,3744
12663,1,1,1325,1638,313
12664,1,1,273,2484,2211
12665,1,0,84,0,-84
12666,1,0,3,0,-3
12667,0,0,66,0,-66
12668,1,0,26,0,-26
12669,0,0,56,0,-56
12670,1,1,18,1510,1492
12671,1,0,9,0,-9
12672,0,0,18,0,-18
12673,0,0,32,0,-32
12674,1,0,9,0,-9
12675,0,0,12,0,-12
12676,0,0,8,0,-8
12677,1,1,207,1434,1227
12678,0,0,177,0,-177
12679,1,0,9,0,-9
12680,1,1,2430,1338,-1092
12681,0,0,5,0,-5
12682,0,0,28,0,-28
12683,1,1,454,2077,1623
12684,0,0,144,0,-144
12685,1,1,652,1438,786
12686,0,0,17,0,-17
12687,1,0,74,0,-74
12688,1,0,17,0,-17
12689,1,1,309,1658,1349
12690,0,0,144,0,-144
12691,1,0,18,0,-18
12692,0,0,125,0,-125
12693,0,0,18,0,-18
12694,1,1,111,1232,1121
12695,1,0,83,0,-83
12696,1,0,50,0,-50
12697,1,0,7,0,-7
12698,0,0,32,0,-32
12699,1,0,96,0,-96
12700,0,0,15,0,-15
12701,1,1,386,1749,1363
12702,1,1,421,1308,887
12703,1,0,52,0,-52
12704,0,0,4,0,-4
12705,1,0,35,0,-35
12706,0,0,15,0,-15
12707,0,0,0,0,0
12708,1,1,182,1429,1247
12709,0,0,0,0,0
12710,0,0,29,0,-29
12711,0,0,120,0,-120
12712,1,0,41,0,-41
12713,0,0,74,0,-74
12714,0,0,27,0,-27
12715,1,1,171,5612,5441
12716,0,0,46,0,-46
12717,0,0,3,0,-3
12718,0,0,50,0,-50
12719,1,1,207,1465,1258
12720,1,1,584,1324,740
12721,1,0,25,0,-25
12722,0,0,42,0,-42
12723,0,0,62,0,-62
12724,1,1,272,1315,1043
12725,0,0,25,0,-25
12726,0,0,43,0,-43
12727,1,0,180,0,-180
12728,1,1,194,1536,1342
12729,1,1,97,1877,1780
12730,0,0,5,0,-5
12731,0,0,197,0,-197
12732,1,0,43,0,-43
12733,1,1,1996,1507,-489
12734,1,1,356,1674,1318
12735,1,1,774,1463,689
12736,1,0,3,0,-3
12737,1,1,263,1230,967
12738,0,0,130,0,-130
12739,0,0,0,0,0
12740,1,0,0,0,0
12741,1,1,1125,1474,349
12742,1,0,22,0,-22
12743,1,0,11,0,-11
12744,1,0,98,0,-98
12745,1,0,12,0,-12
12746,0,0,79,0,-79
12747,1,1,318,1275,957
12748,1,0,150,0,-150
12749,1,1,231,1286,1055
12750,0,0,35,0,-35
12751,1,1,449,1202,753
12752,0,0,8,0,-8
12753,0,0,65,0,-65
12754,1,1,967,1657,690
12755,1,0,57,0,-57
12756,0,0,105,0,-105
12757,0,0,88,0,-88
12758,0,0,15,0,-15
12759,0,0,1,0,-1
12760,1,0,40,0,-40
12761,0,0,47,0,-47
12762,0,0,18,0,-18
12763,1,1,353,1333,980
12764,1,0,12,0,-12
12765,1,0,72,0,-72
12766,1,0,134,0,-134
12767,1,0,99,0,-99
12768,1,1,594,1741,1147
12769,0,0,1,0,-1
12770,1,1,399,1552,1153
12771,0,0,0,0,0
12772,0,0,4,0,-4
12773,0,0,28,0,-28
12774,0,0,82,0,-82
12775,1,0,169,0,-169
12776,1,1,1420,1293,-127
12777,1,1,518,1211,693
12778,1,1,560,1206,646
12779,1,0,32,0,-32
12780,0,0,99,0,-99
12781,1,1,56,2000,1944
12782,0,0,82,0,-82
12783,0,0,115,0,-115
12784,0,0,11,0,-11
12785,0,0,14,0,-14
12786,0,0,106,0,-106
12787,0,0,78,0,-78
12788,0,0,50,0,-50
12789,0,0,18,0,-18
12790,1,0,25,0,-25
12791,1,0,151,0,-151
12792,1,0,40,0,-40
12793,1,1,110,1218,1108
12794,0,0,9,0,-9
12795,1,1,480,1470,990
12796,0,0,2,0,-2
12797,1,0,34,0,-34
12798,1,1,312,1641,1329
12799,1,0,48,0,-48
12800,0,0,46,0,-46
12801,1,1,1070,1656,586
12802,1,0,55,0,-55
12803,0,0,56,0,-56
12804,1,1,89,1562,1473
12805,1,0,195,0,-195
12806,1,0,179,0,-179
12807,1,0,36,0,-36
12808,0,0,11,0,-11
12809,0,0,55,0,-55
12810,1,1,485,1472,987
12811,1,0,67,0,-67
12812,1,0,70,0,-70
12813,1,1,617,1513,896
12814,0,0,29,0,-29
12815,0,0,19,0,-19
12816,1,1,1398,1906,508
12817,0,0,20,0,-20
12818,1,1,650,1411,761
12819,1,0,70,0,-70
12820,1,0,79,0,-79
12821,1,1,513,5305,4792
12822,1,0,4,0,-4
12823,0,0,109,0,-109
12824,0,0,30,0,-30
12825,1,1,1497,2453,956
12826,0,0,3,0,-3
12827,1,0,19,0,-19
12828,1,1,604,1471,867
12829,1,0,88,0,-88
12830,0,0,83,0,-83
12831,1,0,26,0,-26
12832,1,0,75,0,-75
12833,0,0,13,0,-13
12834,1,1,653,2024,1371
12835,1,0,8,0,-8
12836,1,0,9,0,-9
12837,1,0,19,0,-19
12838,1,0,10,0,-10
12839,1,1,39,2004,1965
12840,0,0,82,0,-82
12841,1,0,50,0,-50
12842,0,0,51,0,-51
12843,1,0,53,0,-53
12844,0,0,52,0,-52
12845,1,1,258,1554,1296
12846,1,1,357,1364,1007
12847,0,0,14,0,-14
12848,1,0,82,0,-82
12849,1,1,921,1406,485
12850,1,1,34,1945,1911
12851,1,0,13,0,-13
12852,1,0,63,0,-63
12853,1,1,88,1202,1114
12854,1,0,92,0,-92
12855,1,0,100,0,-100
12856,0,0,9,0,-9
12857,0,0,44,0,-44
12858,1,1,515,1560,1045
12859,1,1,668,1422,754
12860,1,1,335,1639,1304
12861,0,0,10,0,-10
12862,1,1,1061,1462,401
12863,1,0,28,0,-28
12864,0,0,96,0,-96
12865,0,0,138,0,-138
12866,1,1,1253,1274,21
12867,0,0,165,0,-165
12868,1,0,111,0,-111
12869,1,1,42,1204,1162
12870,1,0,0,0,0
12871,1,1,844,1490,646
12872,0,0,20,0,-20
12873,1,1,47,1362,1315
12874,1,0,44,0,-44
12875,1,1,526,1466,940
12876,1,1,226,2640,2414
12877,0,0,151,0,-151
12878,1,0,147,0,-147
12879,0,0,8,0,-8
12880,0,0,55,0,-55
12881,1,1,140,1223,1083
12882,1,0,21,0,-21
12883,0,0,195,0,-195
12884,1,0,7,0,-7
12885,1,1,422,1319,897
12886,1,0,0,0,0
12887,1,1,40,2045,2005
12888,1,1,25,1485,1460
12889,1,1,114,1284,1170
12890,1,0,65,0,-65
12891,1,1,103,1207,1104
12892,1,1,108,1343,1235
12893,1,0,33,0,-33
12894,1,1,224,3614,3390
12895,1,0,115,0,-115
12896,0,0,6,0,-6
12897,0,0,11,0,-11
12898,1,1,295,1234,939
12899,1,1,208,2107,1899
12900,0,0,75,0,-75
12901,0,0,78,0,-78
12902,1,1,118,1766,1648
12903,1,1,251,1321,1070
12904,1,1,933,1319,386
12905,1,0,156,0,-156
12906,0,0,0,0,0
12907,1,0,43,0,-43
12908,1,0,30,0,-30
12909,1,1,245,1736,1491
12910,1,1,195,1235,1040
12911,1,1,520,1324,804
12912,1,1,131,1240,1109
12913,0,0,4,0,-4
12914,1,0,70,0,-70
12915,1,1,2492,1399,-1093
12916,0,0,90,0,-90
12917,0,0,10,0,-10
12918,1,0,31,0,-31
12919,0,0,34,0,-34
12920,0,0,59,0,-59
12921,1,0,196,0,-196
12922,0,0,21,0,-21
12923,1,1,79,1210,1131
12924,1,0,124,0,-124
12925,0,0,88,0,-88
12926,1,0,270,0,-270
12927,0,0,63,0,-63
12928,1,0,19,0,-19
12929,1,1,508,1668,1160
12930,0,0,0,0,0
12931,1,1,380,1493,1113
12932,0,0,79,0,-79
12933,0,0,41,0,-41
12934,1,1,170,1465,1295
12935,1,0,74,0,-74
12936,0,0,83,0,-83
12937,0,0,53,0,-53
12938,0,0,13,0,-13
12939,0,0,7,0,-7
12940,1,1,57,1672,1615
12941,1,0,151,0,-151
12942,1,0,123,0,-123
12943,1,0,58,0,-58
12944,0,0,92,0,-92
12945,0,0,14,0,-14
12946,1,1,939,1495,556
12947,1,1,198,1210,1012
12948,1,0,49,0,-49
12949,0,0,115,0,-115
12950,1,0,21,0,-21
12951,0,0,34,0,-34
12952,0,0,3,0,-3
12953,0,0,20,0,-20
12954,0,0,13,0,-13
12955,1,1,1624,2395,771
12956,0,0,14,0,-14
12957,0,0,1,0,-1
12958,1,0,2,0,-2
12959,1,1,630,2026,1396
12960,0,0,44,0,-44
12961,0,0,36,0,-36
12962,0,0,59,0,-59
12963,0,0,17,0,-17
12964,1,1,874,1759,885
12965,1,1,223,1236,1013
12966,0,0,82,0,-82
12967,0,0,22,0,-22
12968,0,0,10,0,-10
12969,1,0,15,0,-15
12970,1,1,260,4055,3795
12971,0,0,11,0,-11
12972,1,0,17,0,-17
12973,1,0,26,0,-26
12974,0,0,52,0,-52
12975,0,0,10,0,-10
12976,1,1,218,1335,1117
12977,1,1,1101,1231,130
12978,0,0,43,0,-43
12979,1,1,856,1508,652
12980,1,0,59,0,-59
12981,0,0,22,0,-22
12982,1,1,309,1205,896
12983,0,0,124,0,-124
12984,0,0,15,0,-15
12985,0,0,4,0,-4
12986,1,0,30,0,-30
12987,0,0,139,0,-139
12988,0,0,18,0,-18
12989,1,0,19,0,-19
12990,1,0,44,0,-44
12991,1,1,733,2370,1637
12992,1,1,178,1371,1193
12993,0,0,4,0,-4
12994,1,0,51,0,-51
12995,0,0,22,0,-22
12996,0,0,48,0,-48
12997,1,1,406,1438,1032
12998,0,0,170,0,-170
12999,0,0,19,0,-19
13000,1,1,528,1301,773
13001,1,0,2,0,-2
13002,0,0,51,0,-51
13003,0,0,33,0,-33
13004,1,0,85,0,-85
13005,0,0,88,0,-88
13006,1,1,107,1381,1274
13007,0,0,36,0,-36
13008,0,0,139,0,-139
13009,1,0,16,0,-16
13010,0,0,2,0,-2
13011,0,0,186,0,-186
13012,0,0,4,0,-4
13013,0,0,8,0,-8
13014,0,0,61,0,-61
13015,1,0,15,0,-15
13016,1,0,21,0,-21
13017,0,0,95,0,-95
13018,1,1,388,1239,851
13019,1,1,298,1547,1249
13020,1,1,1984,2200,216
13021,0,0,55,0,-55
13022,1,1,357,1209,852
13023,0,0,12,0,-12
13024,0,0,61,0,-61
13025,0,0,2,0,-2
13026,1,1,30,1689,1659
13027,0,0,9,0,-9
13028,0,0,19,0,-19
13029,1,1,646,1207,561
13030,1,1,231,1493,1262
13031,0,0,22,0,-22
13032,0,0,69,0,-69
13033,1,1,758,1321,563
13034,1,1,1176,1333,157
13035,0,0,177,0,-177
13036,1,1,1058,1477,419
13037,1,1,37,1203,1166
13038,1,1,262,2140,1878
13039,1,1,175,1757,1582
13040,0,0,12,0,-12
13041,1,0,32,0,-32
13042,0,0,17,0,-17
13043,0,0,11,0,-11
13044,1,1,606,1720,1114
13045,1,1,607,1238,631
13046,1,1,213,1222,1009
13047,0,0,19,0,-19
13048,0,0,30,0,-30
13049,1,0,12,0,-12
13050,1,1,681,1320,639
13051,0,0,19,0,-19
13052,1,0,84,0,-84
13053,1,1,1058,1255,197
13054,1,1,803,1659,856
13055,1,0,64,0,-64
13056,1,0,3,0,-3
13057,0,0,19,0,-19
13058,1,0,4,0,-4
13059,0,0,12,0,-12
13060,0,0,15,0,-15
13061,0,0,10,0,-10
13062,1,1,114,1342,1228
13063,1,1,92,1208,1116
13064,0,0,39,0,-39
13065,1,1,274,1262,988
13066,0,0,0,0,0
13067,1,0,24,0,-24
13068,0,0,27,0,-27
13069,1,0,44,0,-44
13070,0,0,3,0,-3
13071,0,0,19,0,-19
13072,1,0,103,0,-103
13073,0,0,24,0,-24
13074,1,0,20,0,-20
13075,1,1,121,1220,1099
13076,1,0,16,0,-16
13077,0,0,8,0,-8
13078,0,0,56,0,-56
13079,0,0,152,0,-152
13080,1,0,8,0,-8
13081,1,0,11,0,-11
13082,1,0,34,0,-34
13083,0,0,14,0,-14
13084,1,1,196,1322,1126
13085,0,0,87,0,-87
13086,1,0,41,0,-41
13087,0,0,7,0,-7
13088,1,0,49,0,-49
13089,0,0,169,0,-169
13090,0,0,64,0,-64
13091,0,0,57,0,-57
13092,1,0,0,0,0
13093,1,0,62,0,-62
13094,1,0,67,0,-67
13095,1,0,51,0,-51
13096,1,1,1092,1357,265
13097,1,0,18,0,-18
13098,0,0,51,0,-51
13099,1,1,91,1795,1704
13100,0,0,125,0,-125
13101,1,0,31,0,-31
13102,0,0,113,0,-113
13103,1,1,449,1480,1031
13104,1,1,737,1351,614
13105,0,0,1,0,-1
13106,0,0,31,0,-31
13107,0,0,35,0,-35
13108,0,0,28,0,-28
13109,1,1,227,1204,977
13110,0,0,100,0,-100
13111,0,0,135,0,-135
13112,0,0,13,0,-13
13113,1,0,11,0,-11
13114,1,0,22,0,-22
13115,1,1,1065,1274,209
13116,1,1,236,1587,1351
13117,0,0,153,0,-153
13118,1,1,409,1244,835
13119,1,0,108,0,-108
13120,0,0,24,0,-24
13121,1,0,128,0,-128
13122,0,0,77,0,-77
13123,0,0,150,0,-150
13124,0,0,46,0,-46
13125,1,0,70,0,-70
13126,1,1,778,1709,931
13127,0,0,91,0,-91
13128,1,0,151,0,-151
13129,0,0,24,0,-24
13130,1,1,249,1235,986
13131,1,0,28,0,-28
13132,1,1,707,2802,2095
13133,1,0,48,0,-48
13134,1,1,380,1994,1614
13135,0,0,0,0,0
13136,1,0,61,0,-61
13137,1,1,688,1282,594
13138,1,1,116,1436,1320
13139,0,0,5,0,-5
13140,0,0,7,0,-7
13141,1,0,19,0,-19
13142,1,1,313,1240,927
13143,0,0,23,0,-23
13144,1,1,433,1348,915
13145,1,0,15,0,-15
13146,0,0,280,0,-280
13147,0,0,17,0,-17
13148,1,1,179,1418,1239
13149,1,1,256,1361,1105
13150,0,0,42,0,-42
13151,1,0,141,0,-141
13152,0,0,7,0,-7
13153,1,1,377,1227,850
13154,0,0,4,0,-4
13155,1,0,7,0,-7
13156,1,0,50,0,-50
13157,0,0,96,0,-96
13158,1,0,190,0,-190
13159,1,1,714,2217,1503
13160,0,0,10,0,-10
13161,0,0,10,0,-10
13162,1,1,1559,1344,-215
13163,1,0,21,0,-21
13164,1,0,61,0,-61
13165,0,0,57,0,-57
13166,0,0,8,0,-8
13167,0,0,34,0,-34
13168,0,0,54,0,-54
13169,1,1,154,1468,1314
13170,0,0,40,0,-40
13171,0,0,90,0,-90
13172,1,1,476,1256,780
13173,1,0,90,0,-90
13174,0,0,112,0,-112
13175,0,0,66,0,-66
13176,1,1,1017,1865,848
13177,1,0,12,0,-12
13178,0,0,4,0,-4
13179,1,1,163,2514,2351
13180,1,0,1,0,-1
13181,1,0,54,0,-54
13182,0,0,67,0,-67
13183,1,0,19,0,-19
13184,1,1,318,1295,977
13185,1,1,243,1789,1546
13186,1,1,660,1528,868
13187,0,0,123,0,-123
13188,0,0,92,0,-92
13189,0,0,36,0,-36
13190,1,0,4,0,-4
13191,1,1,1373,1428,55
13192,1,1,308,1258,950
13193,1,1,44,1541,1497
13194,1,0,61,0,-61
13195,1,0,32,0,-32
13196,0,0,53,0,-53
13197,1,1,617,1645,1028
13198,1,0,212,0,-212
13199,1,1,821,1729,908
13200,1,1,820,1480,660
13201,1,0,75,0,-75
13202,1,0,56,0,-56
13203,0,0,3,0,-3
13204,0,0,24,0,-24
13205,0,0,15,0,-15
13206,1,1,64,1334,1270
13207,1,1,248,1353,1105
13208,0,0,49,0,-49
13209,1,0,73,0,-73
13210,0,0,34,0,-34
13211,1,1,384,1309,925
13212,1,0,98,0,-98
13213,1,0,50,0,-50
13214,0,0,148,0,-148
13215,0,0,100,0,-100
13216,1,1,696,1702,1006
13217,1,1,1123,1308,185
13218,0,0,30,0,-30
13219,1,0,12,0,-12
13220,0,0,0,0,0
13221,1,0,197,0,-197
13222,1,0,12,0,-12
13223,1,1,255,1381,1126
13224,0,0,7,0,-7
13225,1,1,178,1228,1050
13226,1,1,93,1386,1293
13227,1,0,56,0,-56
13228,0,0,159,0,-159
13229,0,0,40,0,-40
13230,0,0,45,0,-45
13231,1,0,75,0,-75
13232,1,1,308,2309,2001
13233,1,0,28,0,-28
13234,0,0,37,0,-37
13235,0,0,99,0,-99
13236,1,0,25,0,-25
13237,1,1,2058,1227,-831
13238,0,0,1,0,-1
13239,1,0,184,0,-184
13240,1,0,19,0,-19
13241,1,1,328,1225,897
13242,1,0,3,0,-3
13243,1,0,17,0,-17
13244,1,1,292,1555,1263
13245,0,0,4,0,-4
13246,1,1,1007,1415,408
13247,1,0,88,0,-88
13248,1,1,1609,1376,-233
13249,1,1,12,1503,1491
13250,0,0,97,0,-97
13251,1,0,21,0,-21
13252,1,1,328,1244,916
13253,1,0,23,0,-23
13254,1,0,6,0,-6
13255,1,1,898,1403,505
13256,0,0,22,0,-22
13257,1,0,16,0,-16
13258,1,0,17,0,-17
13259,0,0,181,0,-181
13260,1,1,554,1363,809
13261,1,1,363,1389,1026
13262,1,0,64,0,-64
13263,0,0,8,0,-8
13264,0,0,6,0,-6
13265,1,0,45,0,-45
13266,1,0,115,0,-115
13267,1,0,7,0,-7
13268,0,0,29,0,-29
13269,0,0,25,0,-25
13270,1,1,1597,1258,-339
13271,0,0,157,0,-157
13272,1,1,305,1681,1376
13273,1,1,231,2922,2691
13274,0,0,28,0,-28
13275,1,1,30,1451,1421
13276,1,1,146,1597,1451
13277,1,1,81,1837,1756
13278,1,0,22,0,-22
13279,0,0,31,0,-31
13280,1,0,100,0,-100
13281,0,0,50,0,-50
13282,0,0,8,0,-8
13283,0,0,18,0,-18
13284,1,0,8,0,-8
13285,0,0,23,0,-23
13286,1,1,411,2176,1765
13287,0,0,18,0,-18
13288,0,0,17,0,-17
13289,1,0,46,0,-46
13290,0,0,28,0,-28
13291,1,1,2874,1413,-1461
13292,1,0,29,0,-29
13293,0,0,114,0,-114
13294,1,1,543,1726,1183
13295,1,0,155,0,-155
13296,1,1,134,1201,1067
13297,0,0,15,0,-15
13298,0,0,113,0,-113
13299,0,0,204,0,-204
13300,1,0,60,0,-60
13301,0,0,22,0,-22
13302,1,1,819,2189,1370
13303,1,0,7,0,-7
13304,0,0,1,0,-1
13305,0,0,32,0,-32
13306,0,0,33,0,-33
13307,1,0,19,0,-19
13308,0,0,28,0,-28
13309,0,0,57,0,-57
13310,1,0,2,0,-2
13311,1,1,947,1245,298
13312,0,0,2,0,-2
13313,1,0,10,0,-10
13314,1,0,19,0,-19
13315,1,0,105,0,-105
13316,0,0,14,0,-14
13317,0,0,46,0,-46
13318,0,0,10,0,-10
13319,1,0,3,0,-3
13320,0,0,37,0,-37
13321,1,0,188,0,-188
13322,1,0,31,0,-31
13323,1,1,1438,1572,134
13324,0,0,45,0,-45
13325,0,0,44,0,-44
13326,1,1,451,1509,1058
13327,1,1,681,1229,548
13328,1,1,1398,2282,884
13329,1,1,238,1298,1060
13330,1,0,5,0,-5
13331,1,0,33,0,-33
13332,0,0,21,0,-21
13333,1,0,78,0,-78
13334,1,1,713,1767,1054
13335,1,1,1158,1295,137
13336,1,1,411,1321,910
13337,1,0,48,0,-48
13338,1,1,116,1629,1513
13339,0,0,34,0,-34
13340,1,1,313,1236,923
13341,0,0,52,0,-52
13342,1,0,4,0,-4
13343,1,0,241,0,-241
13344,1,1,423,1567,1144
13345,1,0,26,0,-26
13346,1,1,834,1507,673
13347,0,0,11,0,-11
13348,0,0,250,0,-250
13349,1,0,39,0,-39
13350,0,0,70,0,-70
13351,1,1,680,1516,836
13352,1,0,16,0,-16
13353,1,1,419,1286,867
13354,1,0,79,0,-79
13355,0,0,137,0,-137
13356,0,0,284,0,-284
13357,1,1,343,1685,1342
13358,0,0,5,0,-5
13359,0,0,8,0,-8
13360,0,0,68,0,-68
13361,0,0,59,0,-59
13362,1,0,32,0,-32
13363,0,0,21,0,-21
13364,1,1,17,1545,1528
13365,1,0,41,0,-41
13366,1,0,37,0,-37
13367,1,1,255,1524,1269
13368,0,0,33,0,-33
13369,1,0,16,0,-16
13370,0,0,188,0,-188
13371,1,1,475,1394,919
13372,1,0,110,0,-110
13373,1,0,16,0,-16
13374,0,0,1,0,-1
13375,0,0,0,0,0
13376,1,1,481,1576,1095
13377,1,0,56,0,-56
13378,1,0,5,0,-5
13379,1,1,610,1790,1180
13380,1,1,79,1305,1226
13381,1,0,81,0,-81
13382,1,0,96,0,-96
13383,1,1,478,1330,852
13384,1,0,48,0,-48
13385,0,0,109,0,-109
13386,0,0,24,0,-24
13387,0,0,82,0,-82
13388,1,0,7,0,-7
13389,0,0,40,0,-40
13390,1,1,995,1796,801
13391,0,0,88,0,-88
13392,1,0,35,0,-35
13393,0,0,86,0,-86
13394,1,1,425,1325,900
13395,1,0,70,0,-70
13396,1,0,8,0,-8
13397,1,0,13,0,-13
13398,0,0,59,0,-59
13399,1,0,68,0,-68
13400,1,1,152,2195,2043
13401,0,0,33,0,-33
13402,0,0,16,0,-16
13403,0,0,48,0,-48
13404,1,0,102,0,-102
13405,0,0,17,0,-17
13406,1,1,829,1240,411
13407,0,0,14,0,-14
13408,1,0,11,0,-11
13409,1,1,882,1211,329
13410,0,0,108,0,-108
13411,0,0,135,0,-135
13412,0,0,14,0,-14
13413,1,1,1076,1646,570
13414,1,0,60,0,-60
13415,1,1,1104,1240,136
13416,0,0,3,0,-3
13417,1,1,650,1335,685
13418,0,0,8,0,-8
13419,1,1,164,1325,1161
13420,1,1,1212,1481,269
13421,0,0,9,0,-9
13422,0,0,61,0,-61
13423,1,1,74,1226,1152
13424,1,0,122,0,-122
13425,1,0,34,0,-34
13426,0,0,21,0,-21
13427,1,0,55,0,-55
13428,1,0,21,0,-21
13429,1,0,32,0,-32
13430,1,1,234,1984,1750
13431,1,0,21,0,-21
13432,1,0,1,0,-1
13433,1,1,77,1259,1182
13434,1,0,16,0,-16
13435,0,0,6,0,-6
13436,1,1,795,1318,523
13437,0,0,52,0,-52
13438,1,1,80,1601,1521
13439,1,1,393,1437,1044
13440,0,0,11,0,-11
13441,1,0,114,0,-114
13442,1,0,0,0,0
13443,1,0,116,0,-116
13444,0,0,114,0,-114
13445,0,0,112,0,-112
13446,1,1,495,1388,893
13447,1,1,171,1412,1241
13448,1,0,23,0,-23
13449,1,0,42,0,-42
13450,0,0,19,0,-19
13451,0,0,85,0,-85
13452,0,0,20,0,-20
13453,1,0,61,0,-61
13454,1,0,3,0,-3
13455,0,0,55,0,-55
13456,1,1,496,2949,2453
13457,1,0,105,0,-105
13458,1,1,445,2042,1597
13459,0,0,6,0,-6
13460,1,1,484,1305,821
13461,1,0,38,0,-38
13462,0,0,15,0,-15
13463,1,0,6,0,-6
13464,0,0,84,0,-84
13465,1,0,52,0,-52
13466,1,0,0,0,0
13467,1,1,82,1430,1348
13468,0,0,53,0,-53
13469,0,0,14,0,-14
13470,1,1,300,1485,1185
13471,0,0,173,0,-173
13472,1,0,17,0,-17
13473,0,0,51,0,-51
13474,1,0,107,0,-107
13475,1,0,52,0,-52
13476,1,0,10,0,-10
13477,0,0,38,0,-38
13478,0,0,10,0,-10
13479,0,0,135,0,-135
13480,0,0,82,0,-82
13481,1,1,1171,1216,45
13482,0,0,97,0,-97
13483,1,1,952,1261,309
13484,0,0,0,0,0
13485,1,1,702,1210,508
13486,1,1,636,1391,755
13487,1,0,29,0,-29
13488,1,1,222,1298,1076
13489,1,1,194,2289,2095
13490,0,0,123,0,-123
13491,1,1,114,1547,1433
13492,0,0,67,0,-67
13493,1,1,198,1313,1115
13494,0,0,24,0,-24
13495,1,1,591,1241,650
13496,1,1,1066,1293,227
13497,1,0,26,0,-26
13498,0,0,66,0,-66
13499,1,0,28,0,-28
13500,1,0,47,0,-47
13501,1,0,72,0,-72
13502,1,1,414,1794,1380
13503,1,0,9,0,-9
13504,1,0,18,0,-18
13505,0,0,24,0,-24
13506,1,1,223,1826,1603
13507,0,0,6,0,-6
13508,1,0,14,0,-14
13509,1,0,81,0,-81
13510,0,0,76,0,-76
13511,1,0,29,0,-29
13512,0,0,34,0,-34
13513,1,0,16,0,-16
13514,0,0,81,0,-81
13515,0,0,14,0,-14
13516,0,0,54,0,-54
13517,1,0,19,0,-19
13518,0,0,60,0,-60
13519,0,0,60,0,-60
13520,1,1,2107,1237,-870
13521,1,0,11,0,-11
13522,0,0,21,0,-21
13523,1,1,1222,1531,309
13524,1,0,1,0,-1
13525,1,0,26,0,-26
13526,1,1,1019,3288,2269
13527,0,0,7,0,-7
13528,1,0,48,0,-48
13529,1,1,594,1629,1035
13530,0,0,59,0,-59
13531,0,0,107,0,-107
13532,1,1,91,1510,1419
13533,1,0,86,0,-86
13534,0,0,17,0,-17
13535,0,0,0,0,0
13536,0,0,20,0,-20
13537,1,0,32,0,-32
13538,0,0,33,0,-33
13539,0,0,95,0,-95
13540,0,0,18,0,-18
13541,1,0,61,0,-61
13542,0,0,20,0,-20
13543,0,0,119,0,-119
13544,1,0,34,0,-34
13545,1,1,213,3087,2874
13546,1,1,202,1491,1289
13547,1,0,26,0,-26
13548,1,0,8,0,-8
13549,0,0,11,0,-11
13550,1,1,214,1730,1516
13551,0,0,288,0,-288
13552,0,0,57,0,-57
13553,1,0,16,0,-16
13554,0,0,88,0,-88
13555,1,0,8,0,-8
13556,0,0,33,0,-33
13557,1,0,68,0,-68
13558,0,0,46,0,-46
13559,1,1,1004,1734,730
13560,0,0,39,0,-39
13561,1,0,8,0,-8
13562,0,0,38,0,-38
13563,0,0,100,0,-100
13564,1,1,392,1596,1204
13565,0,0,57,0,-57
13566,1,0,4,0,-4
13567,1,0,134,0,-134
13568,0,0,0,0,0
13569,1,1,177,1258,1081
13570,1,0,86,0,-86
13571,0,0,16,0,-16
13572,1,0,205,0,-205
13573,0,0,53,0,-53
13574,1,1,407,1975,1568
13575,1,1,517,2504,1987
13576,1,0,43,0,-43
13577,1,1,219,1343,1124
13578,1,1,451,1904,1453
13579,1,0,62,0,-62
13580,1,1,709,1273,564
13581,1,1,206,1292,1086
13582,0,0,9,0,-9
13583,1,0,134,0,-134
13584,1,1,265,2122,1857
13585,1,0,30,0,-30
13586,1,0,123,0,-123
13587,1,0,48,0,-48
13588,1,1,433,1633,1200
13589,1,1,333,1486,1153
13590,1,0,23,0,-23
13591,1,0,1,0,-1
13592,0,0,24,0,-24
13593,1,1,886,1234,348
13594,0,0,30,0,-30
13595,1,1,146,1518,1372
13596,1,0,6,0,-6
13597,1,0,64,0,-64
13598,0,0,15,0,-15
13599,0,0,1,0,-1
13600,1,0,0,0,0
13601,0,0,71,0,-71
13602,1,0,60,0,-60
13603,1,1,136,1782,1646
13604,1,1,310,1768,1458
13605,1,0,25,0,-25
13606,1,0,50,0,-50
13607,1,1,262,1292,1030
13608,0,0,89,0,-89
13609,0,0,38,0,-38
13610,1,0,66,0,-66
13611,0,0,20,0,-20
13612,0,0,16,0,-16
13613,0,0,4,0,-4
13614,0,0,8,0,-8
13615,1,1,474,1578,1104
13616,1,0,30,0,-30
13617,1,0,37,0,-37
13618,1,1,249,1205,956
13619,0,0,11,0,-11
13620,1,1,180,1246,1066
13621,1,0,12,0,-12
13622,1,0,3,0,-3
13623,0,0,15,0,-15
13624,1,0,3,0,-3
13625,1,0,41,0,-41
13626,0,0,29,0,-29
13627,1,1,3635,1309,-2326
13628,0,0,41,0,-41
13629,1,0,34,0,-34
13630,1,1,499,1300,801
13631,1,1,284,1385,1101
13632,1,1,255,2087,1832
13633,1,1,86,1551,1465
13634,1,1,327,2406,2079
13635,1,1,50,3522,3472
13636,1,1,347,1480,1133
13637,1,1,352,1613,1261
13638,0,0,0,0,0
13639,0,0,46,0,-46
13640,0,0,48,0,-48
13641,1,1,82,2329,2247
13642,1,1,329,1319,990
13643,1,0,8,0,-8
13644,1,0,101,0,-101
13645,1,1,611,1339,728
13646,1,0,30,0,-30
13647,0,0,28,0,-28
13648,0,0,8,0,-8
13649,1,0,17,0,-17
13650,0,0,59,0,-59
13651,0,0,2,0,-2
13652,1,0,28,0,-28
13653,0,0,50,0,-50
13654,0,0,30,0,-30
13655,1,0,28,0,-28
13656,0,0,15,0,-15
13657,1,0,18,0,-18
13658,0,0,86,0,-86
13659,0,0,6,0,-6
13660,1,0,61,0,-61
13661,0,0,253,0,-253
13662,0,0,6,0,-6
13663,0,0,53,0,-53
13664,1,1,1130,1376,246
13665,0,0,149,0,-149
13666,0,0,96,0,-96
13667,0,0,5,0,-5
13668,0,0,1,0,-1
13669,1,0,35,0,-35
13670,1,1,1056,1305,249
13671,1,1,913,1383,470
13672,0,0,1,0,-1
13673,1,1,170,1582,1412
13674,1,0,13,0,-13
13675,1,0,12,0,-12
13676,1,1,404,1243,839
13677,1,1,696,1266,570
13678,1,0,2,0,-2
13679,0,0,40,0,-40
13680,0,0,77,0,-77
13681,1,1,175,1225,1050
13682,1,1,68,1480,1412
13683,0,0,22,0,-22
13684,0,0,77,0,-77
13685,1,0,138,0,-138
13686,1,0,47,0,-47
13687,0,0,78,0,-78
13688,0,0,19,0,-19
13689,0,0,15,0,-15
13690,0,0,34,0,-34
13691,1,0,22,0,-22
13692,1,1,1958,1326,-632
13693,1,0,23,0,-23
13694,0,0,87,0,-87
13695,0,0,38,0,-38
13696,1,0,52,0,-52
13697,1,0,25,0,-25
13698,1,0,29,0,-29
13699,0,0,31,0,-31
13700,1,0,21,0,-21
13701,0,0,163,0,-163
13702,1,1,1140,1688,548
13703,1,0,71,0,-71
13704,1,1,752,1542,790
13705,1,0,88,0,-88
13706,0,0,8,0,-8
13707,1,1,105,1984,1879
13708,1,1,59,1635,1576
13709,1,1,769,1247,478
13710,0,0,66,0,-66
13711,1,1,513,1497,984
13712,1,0,68,0,-68
13713,1,0,16,0,-16
13714,1,0,35,0,-35
13715,1,0,8,0,-8
13716,1,0,37,0,-37
13717,1,0,84,0,-84
13718,0,0,14,0,-14
13719,0,0,17,0,-17
13720,0,0,34,0,-34
13721,1,0,9,0,-9
13722,1,0,33,0,-33
13723,1,0,21,0,-21
13724,0,0,48,0,-48
13725,1,0,33,0,-33
13726,1,1,75,1221,1146
13727,0,0,48,0,-48
13728,0,0,81,0,-81
13729,1,1,105,1537,1432
13730,1,1,52,2016,1964
13731,0,0,41,0,-41
13732,1,0,39,0,-39
13733,1,1,474,1708,1234
13734,1,0,236,0,-236
13735,1,0,9,0,-9
13736,1,1,208,3107,2899
13737,0,0,35,0,-35
13738,0,0,38,0,-38
13739,1,1,401,1360,959
13740,1,1,263,1836,1573
13741,0,0,49,0,-49
13742,1,1,1704,1613,-91
13743,0,0,21,0,-21
13744,1,0,43,0,-43
13745,1,1,859,1378,519
13746,0,0,26,0,-26
13747,1,1,816,1441,625
13748,0,0,125,0,-125
13749,1,1,190,1216,1026
13750,0,0,7,0,-7
13751,0,0,116,0,-116
13752,0,0,5,0,-5
13753,0,0,89,0,-89
13754,0,0,86,0,-86
13755,1,0,0,0,0
13756,0,0,35,0,-35
13757,0,0,3,0,-3
13758,0,0,39,0,-39
13759,1,0,7,0,-7
13760,1,1,526,1458,932
13761,1,0,86,0,-86
13762,1,1,743,1305,562
13763,0,0,3,0,-3
13764,1,1,1811,1592,-219
13765,1,0,55,0,-55
13766,1,0,40,0,-40
13767,0,0,45,0,-45
13768,1,1,318,1418,1100
13769,0,0,32,0,-32
13770,1,1,938,1638,700
13771,1,0,133,0,-133
13772,1,1,186,1324,1138
13773,1,0,28,0,-28
13774,1,1,97,1206,1109
13775,0,0,48,0,-48
13776,0,0,6,0,-6
13777,0,0,69,0,-69
13778,1,0,39,0,-39
13779,1,1,30,1301,1271
13780,1,0,56,0,-56
13781,1,1,518,1390,872
13782,0,0,16,0,-16
13783,1,0,33,0,-33
13784,0,0,55,0,-55
13785,1,1,296,1224,928
13786,1,1,785,1376,591
13787,0,0,42,0,-42
13788,0,0,210,0,-210
13789,1,0,3,0,-3
13790,1,1,460,2444,1984
13791,1,1,107,1454,1347
13792,1,1,610,1269,659
13793,1,1,866,1227,361
13794,0,0,14,0,-14
13795,0,0,64,0,-64
13796,1,1,253,1368,1115
13797,1,0,0,0,0
13798,0,0,34,0,-34
13799,0,0,105,0,-105
13800,1,0,11,0,-11
13801,1,1,189,1745,1556
13802,1,0,144,0,-144
13803,0,0,67,0,-67
13804,1,1,508,2217,1709
13805,0,0,120,0,-120
13806,0,0,67,0,-67
13807,0,0,107,0,-107
13808,1,0,18,0,-18
13809,1,0,62,0,-62
13810,1,1,1278,1596,318
13811,1,1,405,2152,1747
13812,1,0,211,0,-211
13813,1,1,188,2003,1815
13814,0,0,6,0,-6
13815,1,0,1,0,-1
13816,1,0,32,0,-32
13817,0,0,41,0,-41
13818,1,1,214,3163,2949
13819,0,0,48,0,-48
13820,1,0,21,0,-21
13821,1,0,14,0,-14
13822,0,0,105,0,-105
13823,0,0,9,0,-9
13824,0,0,58,0,-58
13825,0,0,6,0,-6
13826,1,1,317,1384,1067
13827,1,0,95,0,-95
13828,1,1,259,1222,963
13829,1,0,92,0,-92
13830,0,0,25,0,-25
13831,1,1,266,4202,3936
13832,1,0,52,0,-52
13833,0,0,63,0,-63
13834,0,0,37,0,-37
13835,1,0,18,0,-18
13836,1,1,539,3161,2622
13837,1,0,123,0,-123
13838,0,0,3,0,-3
13839,1,0,15,0,-15
13840,0,0,2,0,-2
13841,1,1,47,1508,1461
13842,1,0,37,0,-37
13843,1,1,77,1358,1281
13844,0,0,37,0,-37
13845,1,0,20,0,-20
13846,0,0,158,0,-158
13847,1,0,55,0,-55
13848,0,0,0,0,0
13849,0,0,57,0,-57
13850,1,0,44,0,-44
13851,0,0,91,0,-91
13852,0,0,148,0,-148
13853,0,0,1,0,-1
13854,0,0,3,0,-3
13855,1,1,1710,1956,246
13856,0,0,100,0,-100
13857,0,0,25,0,-25
13858,1,1,841,1312,471
13859,0,0,39,0,-39
13860,1,0,45,0,-45
13861,0,0,25,0,-25
13862,1,1,71,1240,1169
13863,1,1,1553,1429,-124
13864,1,0,0,0,0
13865,0,0,137,0,-137
13866,0,0,19,0,-19
13867,0,0,15,0,-15
13868,1,0,39,0,-39
13869,0,0,9,0,-9
13870,0,0,110,0,-110
13871,1,0,3,0,-3
13872,1,0,29,0,-29
13873,1,0,124,0,-124
13874,1,0,74,0,-74
13875,0,0,31,0,-31
13876,0,0,81,0,-81
13877,1,0,191,0,-191
13878,0,0,9,0,-9
13879,0,0,138,0,-138
13880,1,0,11,0,-11
13881,0,0,5,0,-5
13882,1,1,1643,1486,-157
13883,1,0,69,0,-69
13884,1,0,113,0,-113
13885,0,0,22,0,-22
13886,1,0,56,0,-56
13887,0,0,101,0,-101
13888,0,0,9,0,-9
13889,1,0,93,0,-93
13890,0,0,16,0,-16
13891,1,0,57,0,-57
13892,1,0,5,0,-5
13893,1,0,5,0,-5
13894,1,1,549,1369,820
13895,1,0,28,0,-28
13896,0,0,145,0,-145
13897,1,1,551,1273,722
13898,1,0,6,0,-6
13899,0,0,25,0,-25
13900,0,0,57,0,-57
13901,0,0,5,0,-5
13902,1,1,186,1260,1074
13903,0,0,10,0,-10
13904,1,0,32,0,-32
13905,0,0,2,0,-2
13906,1,0,8,0,-8
13907,1,0,129,0,-129
13908,1,0,2,0,-2
13909,1,0,10,0,-10
13910,1,0,19,0,-19
13911,0,0,21,0,-21
13912,0,0,5,0,-5
13913,1,1,15,1612,1597
13914,1,1,281,1371,1090
13915,1,0,86,0,-86
13916,1,0,19,0,-19
13917,1,1,223,2011,1788
13918,0,0,2,0,-2
13919,0,0,41,0,-41
13920,1,0,15,0,-15
13921,1,1,187,1552,1365
13922,1,1,617,1223,606
13923,1,1,133,1436,1303
13924,1,1,519,1325,806
13925,0,0,11,0,-11
13926,0,0,44,0,-44
13927,1,1,98,1268,1170
13928,1,0,64,0,-64
13929,1,0,13,0,-13
13930,0,0,10,0,-10
13931,1,0,119,0,-119
13932,0,0,36,0,-36
13933,0,0,21,0,-21
13934,0,0,9,0,-9
13935,0,0,163,0,-163
13936,0,0,94,0,-94
13937,1,0,15,0,-15
13938,0,0,36,0,-36
13939,1,0,71,0,-71
13940,0,0,69,0,-69
13941,0,0,6,0,-6
13942,1,1,437,1238,801
13943,1,1,1459,1251,-208
13944,1,1,733,1332,599
13945,1,0,16,0,-16
13946,1,1,935,1241,306
13947,1,0,1,0,-1
13948,0,0,119,0,-119
13949,1,0,10,0,-10
13950,1,1,295,1861,1566
13951,1,1,210,1304,1094
13952,1,1,932,1674,742
13953,0,0,8,0,-8
13954,1,1,259,1377,1118
13955,1,1,129,1269,1140
13956,0,0,38,0,-38
13957,1,1,206,1232,1026
13958,1,0,17,0,-17
13959,1,0,78,0,-78
13960,0,0,41,0,-41
13961,1,1,722,2209,1487
13962,1,1,168,1562,1394
13963,1,0,30,0,-30
13964,0,0,7,0,-7
13965,1,1,200,1465,1265
13966,1,1,425,1226,801
13967,1,1,161,1200,1039
13968,0,0,103,0,-103
13969,0,0,3,0,-3
13970,0,0,3,0,-3
13971,0,0,10,0,-10
13972,0,0,31,0,-31
13973,0,0,3,0,-3
13974,1,1,217,1265,1048
13975,1,0,73,0,-73
13976,1,0,51,0,-51
13977,0,0,44,0,-44
13978,0,0,18,0,-18
13979,1,0,13,0,-13
13980,0,0,1,0,-1
13981,1,1,779,1268,489
13982,0,0,159,0,-159
13983,1,1,1274,1493,219
13984,0,0,150,0,-150
13985,0,0,55,0,-55
13986,1,1,1360,1400,40
13987,1,0,64,0,-64
13988,0,0,50,0,-50
13989,1,1,222,1335,1113
13990,0,0,13,0,-13
13991,1,1,846,1251,405
13992,1,1,205,1349,1144
13993,0,0,3,0,-3
13994,0,0,54,0,-54
13995,0,0,32,0,-32
13996,1,0,87,0,-87
13997,1,1,235,1255,1020
13998,1,0,84,0,-84
13999,1,1,291,1298,1007
14000,1,0,39,0,-39
14001,1,1,573,1401,828
14002,0,0,7,0,-7
14003,0,0,15,0,-15
14004,1,1,1744,1216,-528
14005,1,0,30,0,-30
14006,0,0,9,0,-9
14007,0,0,191,0,-191
14008,1,0,58,0,-58
14009,1,1,546,1224,678
14010,0,0,10,0,-10
14011,1,1,2440,1330,-1110
14012,0,0,1,0,-1
14013,1,1,232,1305,1073
14014,0,0,24,0,-24
14015,0,0,56,0,-56
14016,1,0,21,0,-21
14017,1,0,7,0,-7
14018,0,0,68,0,-68
14019,1,1,328,1385,1057
14020,1,0,91,0,-91
14021,0,0,59,0,-59
14022,1,1,278,1456,1178
14023,0,0,223,0,-223
14024,1,0,67,0,-67
14025,1,0,5,0,-5
14026,1,0,97,0,-97
14027,1,0,13,0,-13
14028,1,0,61,0,-61
14029,0,0,12,0,-12
14030,0,0,15,0,-15
14031,1,1,573,1581,1008
14032,0,0,109,0,-109
14033,1,0,143,0,-143
14034,0,0,23,0,-23
14035,1,1,174,2203,2029
14036,0,0,94,0,-94
14037,0,0,61,0,-61
14038,1,1,33,1210,1177
14039,1,0,93,0,-93
14040,0,0,4,0,-4
14041,0,0,0,0,0
14042,1,1,272,1706,1434
14043,1,1,779,1245,466
14044,1,1,464,1766,1302
14045,0,0,63,0,-63
14046,1,1,567,1307,740
14047,1,0,57,0,-57
14048,0,0,11,0,-11
14049,1,0,11,0,-11
14050,0,0,191,0,-191
14051,1,1,2159,1380,-779
14052,0,0,162,0,-162
14053,1,0,123,0,-123
14054,1,1,1264,1234,-30
14055,1,0,93,0,-93
14056,0,0,89,0,-89
14057,1,0,126,0,-126
14058,1,1,1567,1417,-150
14059,1,0,5,0,-5
14060,1,0,25,0,-25
14061,0,0,16,0,-16
14062,0,0,12,0,-12
14063,1,0,8,0,-8
14064,1,0,4,0,-4
14065,0,0,49,0,-49
14066,0,0,66,0,-66
14067,0,0,81,0,-81
14068,1,1,668,1581,913
14069,0,0,71,0,-71
14070,1,0,147,0,-147
14071,0,0,58,0,-58
14072,1,1,813,1271,458
14073,1,0,70,0,-70
14074,1,0,72,0,-72
14075,1,1,156,1635,1479
14076,0,0,4,0,-4
14077,0,0,36,0,-36
14078,1,0,13,0,-13
14079,1,1,353,1290,937
14080,1,1,1111,1425,314
14081,1,1,33,2554,2521
14082,1,0,41,0,-41
14083,0,0,37,0,-37
14084,1,0,15,0,-15
14085,1,0,21,0,-21
14086,1,1,123,1240,1117
14087,0,0,29,0,-29
14088,1,1,1016,1282,266
14089,1,1,195,1413,1218
14090,0,0,43,0,-43
14091,1,0,24,0,-24
14092,1,1,739,1806,1067
14093,1,0,20,0,-20
14094,1,1,1517,1265,-252
14095,1,0,85,0,-85
14096,1,1,1411,1576,165
14097,0,0,9,0,-9
14098,1,1,426,1428,1002
14099,0,0,71,0,-71
14100,0,0,8,0,-8
14101,1,0,46,0,-46
14102,1,1,294,1826,1532
14103,1,1,404,2420,2016
14104,1,0,12,0,-12
14105,1,1,730,1550,820
14106,0,0,34,0,-34
14107,0,0,37,0,-37
14108,0,0,3,0,-3
14109,1,0,58,0,-58
14110,1,0,94,0,-94
14111,1,0,112,0,-112
14112,1,0,48,0,-48
14113,1,0,95,0,-95
14114,0,0,7,0,-7
14115,0,0,92,0,-92
14116,1,0,64,0,-64
14117,0,0,8,0,-8
14118,0,0,71,0,-71
14119,1,1,991,1210,219
14120,1,1,189,1305,1116
14121,1,0,19,0,-19
14122,1,1,248,1532,1284
14123,1,1,911,1503,592
14124,1,0,3,0,-3
14125,1,0,48,0,-48
14126,0,0,11,0,-11
14127,1,0,135,0,-135
14128,1,1,680,1599,919
14129,0,0,101,0,-101
14130,1,1,307,1326,1019
14131,1,1,446,1503,1057
14132,0,0,11,0,-11
14133,0,0,6,0,-6
14134,1,0,29,0,-29
14135,1,0,19,0,-19
14136,1,0,1,0,-1
14137,1,1,657,1204,547
14138,1,1,1659,1667,8
14139,1,1,365,1573,1208
14140,0,0,32,0,-32
14141,0,0,10,0,-10
14142,1,0,35,0,-35
14143,1,1,401,1519,1118
14144,1,0,11,0,-11
14145,0,0,37,0,-37
14146,1,0,34,0,-34
14147,1,0,9,0,-9
14148,1,0,16,0,-16
14149,1,1,73,1429,1356
14150,0,0,6,0,-6
14151,1,1,256,4951,4695
14152,1,1,498,1270,772
14153,0,0,38,0,-38
14154,1,0,24,0,-24
14155,0,0,20,0,-20
14156,1,1,386,1393,1007
14157,1,0,130,0,-130
14158,1,0,130,0,-130
14159,0,0,21,0,-21
14160,0,0,49,0,-49
14161,1,0,23,0,-23
14162,1,0,90,0,-90
14163,0,0,59,0,-59
14164,0,0,159,0,-159
14165,1,1,244,1917,1673
14166,0,0,48,0,-48
14167,0,0,22,0,-22
14168,0,0,0,0,0
14169,1,0,44,0,-44
14170,0,0,31,0,-31
14171,1,0,36,0,-36
14172,1,0,50,0,-50
14173,0,0,18,0,-18
14174,1,1,60,2346,2286
14175,1,0,72,0,-72
14176,1,0,63,0,-63
14177,0,0,19,0,-19
14178,1,0,18,0,-18
14179,1,0,2,0,-2
14180,0,0,3,0,-3
14181,1,0,45,0,-45
14182,1,0,13,0,-13
14183,1,0,46,0,-46
14184,0,0,42,0,-42
14185,0,0,9,0,-9
14186,1,0,153,0,-153
14187,1,0,12,0,-12
14188,0,0,1,0,-1
14189,0,0,4,0,-4
14190,1,1,305,1553,1248
14191,0,0,12,0,-12
14192,1,1,395,1434,1039
14193,0,0,1,0,-1
14194,1,1,1708,1782,74
14195,1,1,159,1632,1473
14196,1,1,108,1219,1111
14197,1,0,172,0,-172
14198,0,0,85,0,-85
14199,0,0,0,0,0
14200,0,0,243,0,-243
14201,0,0,36,0,-36
14202,1,0,80,0,-80
14203,0,0,6,0,-6
14204,1,0,68,0,-68
14205,1,0,50,0,-50
14206,1,1,663,1321,658
14207,1,0,60,0,-60
14208,1,0,104,0,-104
14209,1,0,78,0,-78
14210,1,1,134,1482,1348
14211,1,1,3218,1201,-2017
14212,0,0,15,0,-15
14213,1,0,99,0,-99
14214,1,1,48,7525,7477
14215,1,1,777,1392,615
14216,0,0,52,0,-52
14217,0,0,3,0,-3
14218,1,1,411,2522,2111
14219,1,1,294,1933,1639
14220,0,0,32,0,-32
14221,0,0,29,0,-29
14222,0,0,0,0,0
14223,0,0,8,0,-8
14224,0,0,76,0,-76
14225,1,1,824,1724,900
14226,0,0,21,0,-21
14227,1,0,83,0,-83
14228,1,0,6,0,-6
14229,1,0,23,0,-23
14230,0,0,34,0,-34
14231,0,0,12,0,-12
14232,0,0,12,0,-12
14233,1,1,392,1724,1332
14234,1,1,320,1826,1506
14235,0,0,24,0,-24
14236,1,0,175,0,-175
14237,1,0,50,0,-50
14238,1,1,275,1344,1069
14239,0,0,15,0,-15
14240,1,0,41,0,-41
14241,0,0,56,0,-56
14242,0,0,23,0,-23
14243,1,1,134,1295,1161
14244,1,1,1030,1615,585
14245,1,1,588,1373,785
14246,1,0,5,0,-5
14247,0,0,44,0,-44
14248,0,0,59,0,-59
14249,1,1,486,1573,1087
14250,0,0,76,0,-76
14251,1,0,120,0,-120
14252,0,0,76,0,-76
14253,0,0,158,0,-158
14254,0,0,85,0,-85
14255,1,1,768,2167,1399
14256,0,0,153,0,-153
14257,0,0,15,0,-15
14258,1,1,257,1201,944
14259,1,1,69,1394,1325
14260,0,0,181,0,-181
14261,1,0,31,0,-31
14262,1,0,14,0,-14
14263,1,0,92,0,-92
14264,1,0,5,0,-5
14265,1,1,763,1210,447
14266,1,1,554,1955,1401
14267,1,1,193,1774,1581
14268,0,0,72,0,-72
14269,0,0,52,0,-52
14270,0,0,28,0,-28
14271,1,0,31,0,-31
14272,1,0,21,0,-21
14273,0,0,7,0,-7
14274,0,0,11,0,-11
14275,0,0,85,0,-85
14276,0,0,14,0,-14
14277,0,0,20,0,-20
14278,0,0,4,0,-4
14279,0,0,50,0,-50
14280,1,1,2656,2969,313
14281,0,0,13,0,-13
14282,1,1,362,1202,840
14283,1,0,11,0,-11
14284,1,0,79,0,-79
14285,0,0,64,0,-64
14286,1,1,226,1739,1513
14287,0,0,42,0,-42
14288,1,1,1396,1473,77
14289,0,0,93,0,-93
14290,1,1,1954,1236,-718
14291,0,0,4,0,-4
14292,0,0,96,0,-96
14293,0,0,6,0,-6
14294,1,1,218,1374,1156
14295,1,0,19,0,-19
14296,1,1,294,4868,4574
14297,1,1,284,1205,921
14298,0,0,20,0,-20
14299,1,1,1183,1269,86
14300,1,0,15,0,-15
14301,1,0,0,0,0
14302,1,0,27,0,-27
14303,0,0,11,0,-11
14304,0,0,43,0,-43
14305,1,1,768,1423,655
14306,0,0,9,0,-9
14307,0,0,121,0,-121
14308,1,1,717,1580,863
14309,1,0,150,0,-150
14310,1,0,55,0,-55
14311,1,1,1275,1308,33
14312,1,0,28,0,-28
14313,1,1,183,2125,1942
14314,0,0,53,0,-53
14315,0,0,6,0,-6
14316,0,0,16,0,-16
14317,1,1,327,1282,955
14318,1,0,2,0,-2
14319,0,0,57,0,-57
14320,1,1,183,1288,1105
14321,1,0,22,0,-22
14322,0,0,19,0,-19
14323,1,1,314,1718,1404
14324,1,1,293,1550,1257
14325,1,1,610,1490,880
14326,1,0,28,0,-28
14327,1,1,41,1551,1510
14328,0,0,6,0,-6
14329,1,1,690,1379,689
14330,1,0,26,0,-26
14331,1,0,35,0,-35
14332,1,0,84,0,-84
14333,1,0,26,0,-26
14334,1,0,66,0,-66
14335,1,0,32,0,-32
14336,0,0,69,0,-69
14337,1,0,9,0,-9
14338,0,0,7,0,-7
14339,0,0,0,0,0
14340,0,0,132,0,-132
14341,0,0,60,0,-60
14342,1,1,219,1689,1470
14343,1,0,0,0,0
14344,0,0,63,0,-63
14345,1,1,378,2190,1812
14346,0,0,85,0,-85
14347,1,1,454,1223,769
14348,0,0,28,0,-28
14349,1,0,47,0,-47
14350,1,0,45,0,-45
14351,1,1,644,1930,1286
14352,1,1,678,1454,776
14353,1,0,208,0,-208
14354,1,0,8,0,-8
14355,0,0,24,0,-24
14356,1,1,514,1718,1204
14357,0,0,0,0,0
14358,0,0,121,0,-121
14359,1,1,903,1289,386
14360,0,0,7,0,-7
14361,0,0,198,0,-198
14362,1,1,74,1305,1231
14363,1,0,121,0,-121
14364,0,0,84,0,-84
14365,0,0,11,0,-11
14366,1,1,2071,1429,-642
14367,1,0,15,0,-15
14368,1,0,41,0,-41
14369,0,0,53,0,-53
14370,1,1,671,1638,967
14371,1,0,20,0,-20
14372,0,0,18,0,-18
14373,0,0,21,0,-21
14374,1,0,29,0,-29
14375,1,0,8,0,-8
14376,1,1,216,1696,1480
14377,1,0,39,0,-39
14378,0,0,19,0,-19
14379,0,0,140,0,-140
14380,1,1,78,1822,1744
14381,0,0,135,0,-135
14382,0,0,38,0,-38
14383,1,1,638,1794,1156
14384,1,1,300,2306,2006
14385,0,0,131,0,-131
14386,1,0,131,0,-131
14387,1,0,155,0,-155
14388,1,1,875,1430,555
14389,1,0,6,0,-6
14390,1,1,1085,1254,169
14391,0,0,19,0,-19
14392,0,0,3,0,-3
14393,1,0,33,0,-33
14394,1,0,19,0,-19
14395,1,0,6,0,-6
14396,1,0,9,0,-9
14397,1,0,34,0,-34
14398,0,0,220,0,-220
14399,1,0,20,0,-20
14400,1,1,528,1209,681
14401,1,1,795,1913,1118
14402,0,0,22,0,-22
14403,0,0,111,0,-111
14404,1,0,7,0,-7
14405,1,0,25,0,-25
14406,1,1,404,1321,917
14407,1,0,20,0,-20
14408,0,0,216,0,-216
14409,0,0,18,0,-18
14410,0,0,40,0,-40
14411,0,0,102,0,-102
14412,1,1,377,2308,1931
14413,0,0,17,0,-17
14414,1,1,746,1230,484
14415,0,0,136,0,-136
14416,0,0,32,0,-32
14417,0,0,35,0,-35
14418,1,0,12,0,-12
14419,0,0,2,0,-2
14420,1,0,12,0,-12
14421,1,1,64,1409,1345
14422,0,0,8,0,-8
14423,1,1,207,1227,1020
14424,1,1,623,1314,691
14425,0,0,16,0,-16
14426,1,1,309,1250,941
14427,0,0,16,0,-16
14428,1,1,508,1712,1204
14429,1,0,7,0,-7
14430,0,0,20,0,-20
14431,0,0,30,0,-30
14432,1,0,49,0,-49
14433,1,0,43,0,-43
14434,0,0,70,0,-70
14435,0,0,56,0,-56
14436,0,0,169,0,-169
14437,0,0,39,0,-39
14438,0,0,5,0,-5
14439,0,0,43,0,-43
14440,1,1,516,1200,684
14441,0,0,88,0,-88
14442,0,0,39,0,-39
14443,0,0,10,0,-10
14444,0,0,6,0,-6
14445,0,0,154,0,-154
14446,0,0,29,0,-29
14447,1,0,87,0,-87
14448,0,0,46,0,-46
14449,0,0,110,0,-110
14450,0,0,68,0,-68
14451,1,0,19,0,-19
14452,1,1,470,1529,1059
14453,1,0,74,0,-74
14454,1,1,1126,1395,269
14455,1,0,3,0,-3
14456,0,0,76,0,-76
14457,1,1,1102,1587,485
14458,1,0,27,0,-27
14459,1,1,79,1946,1867
14460,0,0,29,0,-29
14461,1,0,65,0,-65
14462,0,0,44,0,-44
14463,1,1,571,1748,1177
14464,0,0,119,0,-119
14465,1,0,56,0,-56
14466,1,1,516,2685,2169
14467,1,1,584,1460,876
14468,1,0,111,0,-111
14469,1,0,65,0,-65
14470,1,0,6,0,-6
14471,1,0,25,0,-25
14472,1,0,88,0,-88
14473,1,0,51,0,-51
14474,1,0,74,0,-74
14475,1,0,28,0,-28
14476,1,1,1361,1658,297
14477,0,0,91,0,-91
14478,1,1,6,1455,1449
14479,1,0,8,0,-8
14480,0,0,35,0,-35
14481,0,0,21,0,-21
14482,0,0,152,0,-152
14483,1,0,4,0,-4
14484,1,1,2525,1205,-1320
14485,0,0,10,0,-10
14486,0,0,2,0,-2
14487,1,0,22,0,-22
14488,0,0,44,0,-44
14489,1,1,1252,1552,300
14490,1,1,340,1443,1103
14491,0,0,5,0,-5
14492,0,0,0,0,0
14493,0,0,123,0,-123
14494,1,1,107,1738,1631
14495,0,0,16,0,-16
14496,1,1,667,1211,544
14497,1,1,189,1735,1546
14498,1,0,41,0,-41
14499,1,1,317,1311,994
14500,1,0,178,0,-178
14501,0,0,10,0,-10
14502,1,0,6,0,-6
14503,1,1,482,2088,1606
14504,1,0,40,0,-40
14505,0,0,129,0,-129
14506,0,0,7,0,-7
14507,0,0,29,0,-29
14508,0,0,197,0,-197
14509,1,0,43,0,-43
14510,0,0,31,0,-31
14511,1,1,547,1243,696
14512,1,0,43,0,-43
14513,0,0,111,0,-111
14514,1,0,21,0,-21
14515,1,0,117,0,-117
14516,1,0,19,0,-19
14517,1,1,1992,1703,-289
14518,1,0,5,0,-5
14519,0,0,61,0,-61
14520,1,0,2,0,-2
14521,0,0,49,0,-49
14522,0,0,69,0,-69
14523,1,0,105,0,-105
14524,1,0,37,0,-37
14525,0,0,22,0,-22
14526,1,1,137,1200,1063
14527,0,0,102,0,-102
14528,0,0,3,0,-3
14529,1,0,13,0,-13
14530,0,0,28,0,-28
14531,1,0,30,0,-30
14532,1,1,510,1393,883
14533,1,1,69,2583,2514
14534,1,1,969,1403,434
14535,0,0,33,0,-33
14536,0,0,17,0,-17
14537,1,0,76,0,-76
14538,0,0,72,0,-72
14539,0,0,13,0,-13
14540,1,1,860,1258,398
14541,1,1,202,1653,1451
14542,0,0,117,0,-117
14543,1,1,284,1665,1381
14544,0,0,21,0,-21
14545,0,0,76,0,-76
14546,1,1,344,1244,900
14547,1,1,228,1371,1143
14548,1,1,447,1316,869
14549,1,1,399,1366,967
14550,0,0,37,0,-37
14551,1,1,719,1418,699
14552,0,0,14,0,-14
14553,1,1,2759,1723,-1036
14554,0,0,31,0,-31
14555,1,1,899,1405,506
14556,1,1,286,1352,1066
14557,1,0,7,0,-7
14558,1,0,113,0,-113
14559,1,0,79,0,-79
14560,0,0,150,0,-150
14561,1,1,581,1341,760
14562,1,0,58,0,-58
14563,1,0,162,0,-162
14564,0,0,8,0,-8
14565,1,1,635,1971,1336
14566,1,0,133,0,-133
14567,0,0,66,0,-66
14568,0,0,56,0,-56
14569,0,0,68,0,-68
14570,0,0,17,0,-17
14571,0,0,93,0,-93
14572,1,0,49,0,-49
14573,1,1,417,1628,1211
14574,1,1,285,1298,1013
14575,1,0,59,0,-59
14576,1,0,15,0,-15
14577,1,1,304,1769,1465
14578,1,0,35,0,-35
14579,1,0,16,0,-16
14580,1,0,6,0,-6
14581,0,0,19,0,-19
14582,1,0,71,0,-71
14583,1,1,363,1277,914
14584,0,0,161,0,-161
14585,1,1,931,1713,782
14586,1,0,72,0,-72
14587,1,0,17,0,-17
14588,1,0,7,0,-7
14589,1,0,30,0,-30
14590,1,0,4,0,-4
14591,0,0,4,0,-4
14592,1,1,220,1268,1048
14593,1,0,7,0,-7
14594,1,0,70,0,-70
14595,1,1,133,1470,1337
14596,0,0,13,0,-13
14597,1,0,10,0,-10
14598,0,0,45,0,-45
14599,1,1,345,1345,1000
14600,1,1,822,1297,475
14601,0,0,223,0,-223
14602,0,0,1,0,-1
14603,1,1,246,1264,1018
14604,0,0,36,0,-36
14605,1,0,30,0,-30
14606,1,1,452,1436,984
14607,1,0,36,0,-36
14608,1,1,353,2214,1861
14609,1,0,88,0,-88
14610,1,1,351,1411,1060
14611,0,0,45,0,-45
14612,1,0,116,0,-116
14613,1,1,658,1549,891
14614,0,0,24,0,-24
14615,0,0,98,0,-98
14616,1,1,255,1273,1018
14617,1,0,24,0,-24
14618,0,0,37,0,-37
14619,1,0,36,0,-36
14620,0,0,6,0,-6
14621,1,0,151,0,-151
14622,1,1,2001,1492,-509
14623,1,1,374,1796,1422
14624,1,1,96,1869,1773
14625,1,1,62,1442,1380
14626,1,0,17,0,-17
14627,0,0,70,0,-70
14628,0,0,37,0,-37
14629,1,0,14,0,-14
14630,0,0,42,0,-42
14631,1,1,2127,1715,-412
14632,0,0,34,0,-34
14633,0,0,203,0,-203
14634,0,0,100,0,-100
14635,1,1,1095,1345,250
14636,1,0,36,0,-36
14637,1,0,87,0,-87
14638,0,0,50,0,-50
14639,1,0,9,0,-9
14640,1,1,1945,1576,-369
14641,1,0,65,0,-65
14642,1,1,107,1704,1597
14643,0,0,20,0,-20
14644,1,0,64,0,-64
14645,1,0,134,0,-134
14646,1,1,487,1461,974
14647,0,0,6,0,-6
14648,1,0,13,0,-13
14649,0,0,6,0,-6
14650,1,0,197,0,-197
14651,1,0,4,0,-4
14652,1,1,139,1386,1247
14653,1,1,115,1873,1758
14654,1,1,103,1412,1309
14655,1,1,371,1775,1404
14656,1,1,729,1287,558
14657,0,0,170,0,-170
14658,1,1,221,1837,1616
14659,0,0,177,0,-177
14660,1,1,386,1258,872
14661,0,0,17,0,-17
14662,0,0,13,0,-13
14663,1,0,2,0,-2
14664,0,0,121,0,-121
14665,1,1,333,1262,929
14666,0,0,15,0,-15
14667,0,0,1,0,-1
14668,1,0,3,0,-3
14669,0,0,90,0,-90
14670,0,0,139,0,-139
14671,1,0,49,0,-49
14672,0,0,59,0,-59
14673,0,0,75,0,-75
14674,0,0,47,0,-47
14675,0,0,52,0,-52
14676,1,1,270,1470,1200
14677,1,0,13,0,-13
14678,1,1,158,1268,1110
14679,1,1,157,1753,1596
14680,0,0,67,0,-67
14681,1,0,13,0,-13
14682,1,0,25,0,-25
14683,1,0,13,0,-13
14684,0,0,63,0,-63
14685,1,0,60,0,-60
14686,0,0,63,0,-63
14687,0,0,75,0,-75
14688,1,1,785,1416,631
14689,1,0,35,0,-35
14690,1,0,146,0,-146
14691,0,0,29,0,-29
14692,1,1,671,1220,549
14693,1,1,86,1297,1211
14694,1,1,449,2023,1574
14695,1,1,148,1916,1768
14696,0,0,3,0,-3
14697,0,0,40,0,-40
14698,1,0,5,0,-5
14699,1,1,153,1390,1237
14700,1,1,514,1399,885
14701,0,0,125,0,-125
14702,1,0,78,0,-78
14703,1,0,15,0,-15
14704,1,0,97,0,-97
14705,0,0,109,0,-109
14706,0,0,7,0,-7
14707,1,1,403,1900,1497
14708,0,0,56,0,-56
14709,0,0,88,0,-88
14710,1,0,4,0,-4
14711,0,0,24,0,-24
14712,0,0,51,0,-51
14713,1,0,33,0,-33
14714,0,0,12,0,-12
14715,0,0,5,0,-5
14716,1,1,1125,1271,146
14717,0,0,40,0,-40
14718,0,0,26,0,-26
14719,0,0,6,0,-6
14720,1,1,103,2015,1912
14721,1,0,66,0,-66
14722,0,0,82,0,-82
14723,1,0,11,0,-11
14724,0,0,38,0,-38
14725,1,1,692,1228,536
14726,1,0,11,0,-11
14727,0,0,43,0,-43
14728,0,0,56,0,-56
14729,1,0,38,0,-38
14730,1,1,689,1307,618
14731,1,1,196,1470,1274
14732,1,1,402,1219,817
14733,0,0,70,0,-70
14734,1,1,133,2962,2829
14735,1,1,873,1354,481
14736,1,1,728,1260,532
14737,1,0,42,0,-42
14738,0,0,125,0,-125
14739,1,1,504,1206,702
14740,1,0,204,0,-204
14741,0,0,1,0,-1
14742,0,0,69,0,-69
14743,1,0,38,0,-38
14744,1,1,249,2019,1770
14745,1,1,334,1380,1046
14746,1,1,104,1220,1116
14747,0,0,60,0,-60
14748,1,1,1408,1731,323
14749,1,0,61,0,-61
14750,0,0,25,0,-25
14751,0,0,38,0,-38
14752,0,0,35,0,-35
14753,0,0,5,0,-5
14754,0,0,20,0,-20
14755,0,0,3,0,-3
14756,0,0,6,0,-6
14757,1,1,440,1314,874
14758,1,0,43,0,-43
14759,0,0,1,0,-1
14760,1,1,818,2198,1380
14761,1,1,440,1295,855
14762,1,0,20,0,-20
14763,0,0,22,0,-22
14764,0,0,61,0,-61
14765,1,0,3,0,-3
14766,1,0,88,0,-88
14767,1,0,23,0,-23
14768,0,0,71,0,-71
14769,1,0,4,0,-4
14770,1,1,170,1407,1237
14771,1,1,64,1330,1266
14772,0,0,174,0,-174
14773,0,0,100,0,-100
14774,0,0,59,0,-59
14775,0,0,0,0,0
14776,1,0,7,0,-7
14777,1,1,445,1405,960
14778,0,0,22,0,-22
14779,1,0,16,0,-16
14780,1,1,288,1216,928
14781,1,0,28,0,-28
14782,0,0,38,0,-38
14783,1,1,1045,1210,165
14784,0,0,16,0,-16
14785,1,0,13,0,-13
14786,1,1,843,1230,387
14787,1,0,23,0,-23
14788,1,1,149,1202,1053
14789,0,0,26,0,-26
14790,0,0,6,0,-6
14791,0,0,26,0,-26
14792,0,0,135,0,-135
14793,1,1,175,1424,1249
14794,0,0,196,0,-196
14795,0,0,13,0,-13
14796,1,0,100,0,-100
14797,1,0,1,0,-1
14798,1,0,41,0,-41
14799,0,0,46,0,-46
14800,1,0,41,0,-41
14801,0,0,70,0,-70
14802,1,1,453,1334,881
14803,1,1,45,2353,2308
14804,1,1,338,1848,1510
14805,1,0,232,0,-232
14806,1,1,436,1296,860
14807,1,1,124,1623,1499
14808,1,1,1907,1229,-678
14809,1,1,618,1253,635
14810,1,0,31,0,-31
14811,1,1,175,1568,1393
14812,1,0,25,0,-25
14813,1,1,529,1421,892
14814,1,0,11,0,-11
14815,1,0,8,0,-8
14816,0,0,17,0,-17
14817,0,0,42,0,-42
14818,0,0,3,0,-3
14819,0,0,3,0,-3
14820,1,0,69,0,-69
14821,1,1,811,1761,950
14822,1,0,0,0,0
14823,1,1,431,1272,841
14824,1,1,49,1256,1207
14825,0,0,2,0,-2
14826,1,0,3,0,-3
14827,1,0,85,0,-85
14828,0,0,48,0,-48
14829,1,0,12,0,-12
14830,1,0,125,0,-125
14831,1,1,378,1536,1158
14832,1,0,74,0,-74
14833,1,1,590,2277,1687
14834,1,0,28,0,-28
14835,0,0,5,0,-5
14836,0,0,37,0,-37
14837,0,0,8,0,-8
14838,1,1,1167,1521,354
14839,1,1,286,2022,1736
14840,1,1,89,1348,1259
14841,0,0,91,0,-91
14842,1,0,24,0,-24
14843,1,1,1413,1422,9
14844,0,0,55,0,-55
14845,1,1,46,1218,1172
14846,1,0,2,0,-2
14847,0,0,19,0,-19
14848,0,0,1,0,-1
14849,0,0,98,0,-98
14850,0,0,78,0,-78
14851,0,0,24,0,-24
14852,1,0,48,0,-48
14853,1,0,77,0,-77
14854,1,0,7,0,-7
14855,0,0,9,0,-9
14856,1,1,687,1643,956
14857,0,0,13,0,-13
14858,1,0,33,0,-33
14859,1,1,438,1536,1098
14860,0,0,44,0,-44
14861,0,0,51,0,-51
14862,0,0,79,0,-79
14863,0,0,16,0,-16
14864,1,1,533,1519,986
14865,0,0,36,0,-36
14866,1,0,8,0,-8
14867,1,1,186,1270,1084
14868,1,1,1837,1761,-76
14869,0,0,3,0,-3
14870,0,0,13,0,-13
14871,1,0,22,0,-22
14872,1,0,36,0,-36
14873,0,0,6,0,-6
14874,1,0,40,0,-40
14875,1,0,10,0,-10
14876,1,1,1870,1201,-669
14877,1,1,222,1525,1303
14878,0,0,56,0,-56
14879,0,0,70,0,-70
14880,0,0,1,0,-1
14881,1,0,5,0,-5
14882,1,0,28,0,-28
14883,1,1,648,2012,1364
14884,1,0,243,0,-243
14885,1,1,275,1202,927
14886,1,0,18,0,-18
14887,0,0,11,0,-11
14888,0,0,27,0,-27
14889,0,0,8,0,-8
14890,1,0,24,0,-24
14891,1,0,36,0,-36
14892,0,0,3,0,-3
14893,1,0,1,0,-1
14894,1,0,10,0,-10
14895,0,0,22,0,-22
14896,0,0,28,0,-28
14897,1,1,336,1412,1076
14898,0,0,112,0,-112
14899,1,0,61,0,-61
14900,1,1,1518,1350,-168
14901,1,1,793,1756,963
14902,0,0,57,0,-57
14903,0,0,68,0,-68
14904,1,1,740,1256,516
14905,1,1,40,1206,1166
14906,0,0,21,0,-21
14907,1,0,12,0,-12
14908,1,1,54,2052,1998
14909,0,0,23,0,-23
14910,1,1,656,1212,556
14911,1,1,674,1735,1061
14912,1,1,178,5073,4895
14913,0,0,25,0,-25
14914,0,0,35,0,-35
14915,1,1,177,1471,1294
14916,0,0,15,0,-15
14917,0,0,53,0,-53
14918,1,1,558,1306,748
14919,1,0,41,0,-41
14920,1,1,434,1850,1416
14921,0,0,50,0,-50
14922,1,1,141,3605,3464
14923,0,0,1,0,-1
14924,0,0,210,0,-210
14925,1,1,1367,1514,147
14926,0,0,9,0,-9
14927,1,1,166,1252,1086
14928,1,1,246,1677,1431
14929,1,1,811,1915,1104
14930,0,0,289,0,-289
14931,1,1,672,1556,884
14932,1,0,26,0,-26
14933,0,0,109,0,-109
14934,1,0,56,0,-56
14935,1,0,27,0,-27
14936,1,1,419,2573,2154
14937,1,0,180,0,-180
14938,1,1,1371,1282,-89
14939,0,0,41,0,-41
14940,0,0,17,0,-17
14941,1,0,16,0,-16
14942,0,0,27,0,-27
14943,0,0,59,0,-59
14944,1,1,207,1392,1185
14945,1,1,136,1371,1235
14946,0,0,2,0,-2
14947,1,1,281,1460,1179
14948,0,0,128,0,-128
14949,1,0,24,0,-24
14950,0,0,228,0,-228
14951,0,0,16,0,-16
14952,1,0,15,0,-15
14953,1,0,0,0,0
14954,1,1,126,2051,1925
14955,0,0,97,0,-97
14956,1,0,35,0,-35
14957,1,1,287,1326,1039
14958,1,1,553,1225,672
14959,0,0,11,0,-11
14960,1,1,345,1340,995
14961,0,0,21,0,-21
14962,1,0,90,0,-90
14963,1,1,478,1213,735
14964,0,0,16,0,-16
14965,1,0,1,0,-1
14966,1,0,36,0,-36
14967,1,0,12,0,-12
14968,1,1,203,1237,1034
14969,1,0,32,0,-32
14970,0,0,6,0,-6
14971,1,1,75,1251,1176
14972,1,1,633,1219,586
14973,0,0,25,0,-25
14974,1,0,119,0,-119
14975,1,1,571,1327,756
14976,1,1,275,1302,1027
14977,0,0,143,0,-143
14978,1,1,373,1940,1567
14979,0,0,3,0,-3
14980,0,0,144,0,-144
14981,0,0,72,0,-72
14982,0,0,49,0,-49
14983,1,0,104,0,-104
14984,0,0,51,0,-51
14985,1,1,841,5715,4874
14986,0,0,4,0,-4
14987,1,0,6,0,-6
14988,0,0,37,0,-37
14989,1,1,178,1249,1071
14990,1,1,605,1376,771
14991,1,0,23,0,-23
14992,0,0,1,0,-1
14993,1,0,2,0,-2
14994,1,0,7,0,-7
14995,0,0,11,0,-11
14996,1,0,49,0,-49
14997,1,0,33,0,-33
14998,0,0,54,0,-54
14999,1,0,3,0,-3
15000,1,1,602,1275,673
15001,1,0,74,0,-74
15002,1,1,864,1619,755
15003,1,1,28,1517,1489
15004,0,0,2,0,-2
15005,1,0,185,0,-185
15006,0,0,19,0,-19
15007,1,0,59,0,-59
15008,1,1,468,2202,1734
15009,1,0,122,0,-122
15010,1,0,90,0,-90
15011,1,1,481,2502,2021
15012,1,1,406,1703,1297
15013,1,1,215,2006,1791
15014,1,0,6,0,-6
15015,1,1,453,1312,859
15016,0,0,41,0,-41
15017,1,1,93,1597,1504
15018,0,0,37,0,-37
15019,1,1,322,1371,1049
15020,0,0,67,0,-67
15021,1,0,87,0,-87
15022,1,1,458,1279,821
15023,0,0,2,0,-2
15024,1,1,313,1287,974
15025,1,1,765,1516,751
15026,1,0,3,0,-3
15027,1,1,489,1374,885
15028,0,0,61,0,-61
15029,1,0,44,0,-44
15030,1,0,43,0,-43
15031,1,0,16,0,-16
15032,1,1,188,1351,1163
15033,1,0,30,0,-30
15034,1,1,357,1310,953
15035,0,0,49,0,-49
15036,1,0,3,0,-3
15037,1,0,62,0,-62
15038,1,1,466,1362,896
15039,1,1,394,1944,1550
15040,1,0,15,0,-15
15041,0,0,52,0,-52
15042,1,0,12,0,-12
15043,0,0,18,0,-18
15044,1,0,41,0,-41
15045,1,0,5,0,-5
15046,1,0,13,0,-13
15047,1,0,19,0,-19
15048,0,0,110,0,-110
15049,0,0,86,0,-86
15050,0,0,50,0,-50
15051,0,0,37,0,-37
15052,1,1,140,1613,1473
15053,0,0,95,0,-95
15054,1,1,1786,1259,-527
15055,1,1,356,2054,1698
15056,1,0,8,0,-8
15057,1,0,46,0,-46
15058,1,0,70,0,-70
15059,1,1,148,1791,1643
15060,1,1,23,1216,1193
15061,1,1,650,1222,572
15062,1,0,66,0,-66
15063,0,0,34,0,-34
15064,0,0,69,0,-69
15065,1,0,296,0,-296
15066,1,0,21,0,-21
15067,0,0,14,0,-14
15068,1,0,53,0,-53
15069,0,0,54,0,-54
15070,1,0,12,0,-12
15071,0,0,0,0,0
15072,0,0,61,0,-61
15073,1,1,1417,1245,-172
15074,1,0,27,0,-27
15075,0,0,149,0,-149
15076,1,0,28,0,-28
15077,1,1,323,1435,1112
15078,1,0,27,0,-27
15079,1,0,96,0,-96
15080,0,0,13,0,-13
15081,0,0,17,0,-17
15082,1,1,253,1247,994
15083,1,1,1285,1338,53
15084,0,0,6,0,-6
15085,1,0,12,0,-12
15086,0,0,0,0,0
15087,1,1,1369,1207,-162
15088,1,0,23,0,-23
15089,1,1,370,2201,1831
15090,1,0,2,0,-2
15091,1,0,130,0,-130
15092,1,1,801,1510,709
15093,1,1,442,1515,1073
15094,1,1,651,1285,634
15095,1,0,7,0,-7
15096,1,1,336,1297,961
15097,1,0,44,0,-44
15098,1,1,747,2174,1427
15099,1,1,1265,1247,-18
15100,1,0,38,0,-38
15101,1,1,586,1509,923
15102,1,0,49,0,-49
15103,0,0,17,0,-17
15104,1,0,106,0,-106
15105,0,0,10,0,-10
15106,0,0,0,0,0
15107,1,0,20,0,-20
15108,1,0,6,0,-6
15109,1,0,40,0,-40
15110,0,0,50,0,-50
15111,0,0,26,0,-26
15112,1,0,33,0,-33
15113,0,0,101,0,-101
15114,1,1,431,1535,1104
15115,1,1,251,2135,1884
15116,1,0,79,0,-79
15117,1,1,93,1310,1217
15118,1,0,0,0,0
15119,1,1,83,1364,1281
15120,0,0,38,0,-38
15121,0,0,8,0,-8
15122,1,0,16,0,-16
15123,0,0,26,0,-26
15124,1,1,791,1291,500
15125,1,1,352,1941,1589
15126,1,0,12,0,-12
15127,1,0,39,0,-39
15128,1,1,26,1343,1317
15129,0,0,7,0,-7
15130,1,1,122,1250,1128
15131,1,0,169,0,-169
15132,0,0,4,0,-4
15133,1,1,202,1665,1463
15134,0,0,30,0,-30
15135,1,1,305,1417,1112
15136,1,0,27,0,-27
15137,1,1,833,1577,744
15138,1,1,494,1818,1324
15139,1,0,11,0,-11
15140,0,0,15,0,-15
15141,1,0,30,0,-30
15142,0,0,3,0,-3
15143,1,0,2,0,-2
15144,0,0,31,0,-31
15145,1,1,440,1249,809
15146,0,0,0,0,0
15147,1,0,68,0,-68
15148,0,0,88,0,-88
15149,1,1,372,1257,885
15150,1,0,4,0,-4
15151,1,1,326,1746,1420
15152,1,0,6,0,-6
15153,1,0,45,0,-45
15154,0,0,5,0,-5
15155,0,0,14,0,-14
15156,1,1,180,1643,1463
15157,1,1,65,1232,1167
15158,1,1,585,1413,828
15159,1,0,29,0,-29
15160,1,1,1798,1240,-558
15161,1,0,99,0,-99
15162,0,0,100,0,-100
15163,0,0,30,0,-30
15164,0,0,96,0,-96
15165,1,0,27,0,-27
15166,1,1,810,2160,1350
15167,1,1,1216,1299,83
15168,1,1,565,1427,862
15169,1,0,3,0,-3
15170,1,1,1570,2083,513
15171,0,0,33,0,-33
15172,0,0,7,0,-7
15173,1,0,28,0,-28
15174,1,0,53,0,-53
15175,0,0,30,0,-30
15176,1,1,804,1362,558
15177,0,0,106,0,-106
15178,1,0,9,0,-9
15179,1,1,752,1214,462
15180,0,0,104,0,-104
15181,1,1,599,1225,626
15182,0,0,32,0,-32
15183,1,1,112,1520,1408
15184,1,0,23,0,-23
15185,1,0,50,0,-50
15186,1,1,62,1810,1748
15187,1,0,24,0,-24
15188,1,1,75,1243,1168
15189,1,0,23,0,-23
15190,1,0,150,0,-150
15191,1,0,10,0,-10
15192,1,1,543,1567,1024
15193,0,0,8,0,-8
15194,0,0,8,0,-8
15195,0,0,19,0,-19
15196,1,1,593,1476,883
15197,1,1,334,1230,896
15198,1,0,21,0,-21
15199,1,1,124,1779,1655
15200,1,1,177,1660,1483
15201,0,0,38,0,-38
15202,1,0,126,0,-126
15203,1,1,398,1218,820
15204,1,1,851,1435,584
15205,1,0,24,0,-24
15206,1,0,28,0,-28
15207,0,0,20,0,-20
15208,0,0,4,0,-4
15209,0,0,13,0,-13
15210,0,0,18,0,-18
15211,1,1,1228,1940,712
15212,1,1,484,1540,1056
15213,0,0,7,0,-7
15214,0,0,240,0,-240
15215,1,0,132,0,-132
15216,0,0,53,0,-53
15217,1,0,66,0,-66
15218,0,0,30,0,-30
15219,0,0,10,0,-10
15220,1,0,0,0,0
15221,1,0,62,0,-62
15222,0,0,75,0,-75
15223,1,0,57,0,-57
15224,1,1,1044,1280,236
15225,0,0,41,0,-41
15226,0,0,66,0,-66
15227,0,0,52,0,-52
15228,1,0,0,0,0
15229,1,0,42,0,-42
15230,1,1,269,1308,1039
15231,1,1,137,1397,1260
15232,1,0,10,0,-10
15233,0,0,0,0,0
15234,0,0,74,0,-74
15235,1,1,55,1820,1765
15236,1,0,15,0,-15
15237,1,1,119,1611,1492
15238,0,0,10,0,-10
15239,1,1,95,1292,1197
15240,1,0,2,0,-2
15241,1,0,21,0,-21
15242,1,1,107,1386,1279
15243,1,0,98,0,-98
15244,1,1,728,1245,517
15245,1,1,648,1299,651
15246,1,1,81,1230,1149
15247,1,1,1199,1310,111
15248,0,0,91,0,-91
15249,1,1,566,1634,1068
15250,1,0,23,0,-23
15251,1,0,0,0,0
15252,1,0,25,0,-25
15253,1,1,1037,1469,432
15254,0,0,14,0,-14
15255,0,0,54,0,-54
15256,0,0,114,0,-114
15257,0,0,9,0,-9
15258,0,0,11,0,-11
15259,0,0,144,0,-144
15260,0,0,42,0,-42
15261,1,0,37,0,-37
15262,1,0,47,0,-47
15263,0,0,20,0,-20
15264,1,0,23,0,-23
15265,1,0,11,0,-11
15266,1,0,6,0,-6
15267,0,0,76,0,-76
15268,0,0,41,0,-41
15269,0,0,41,0,-41
15270,1,1,732,1262,530
15271,1,1,368,1953,1585
15272,1,0,37,0,-37
15273,1,1,296,1431,1135
15274,1,0,12,0,-12
15275,0,0,22,0,-22
15276,1,0,16,0,-16
15277,0,0,127,0,-127
15278,1,0,72,0,-72
15279,1,1,1023,1485,462
15280,1,0,40,0,-40
15281,1,0,0,0,0
15282,0,0,128,0,-128
15283,1,1,257,1580,1323
15284,0,0,93,0,-93
15285,1,0,29,0,-29
15286,1,0,13,0,-13
15287,0,0,26,0,-26
15288,1,1,44,1211,1167
15289,1,1,1473,2151,678
15290,0,0,28,0,-28
15291,1,1,224,1227,1003
15292,0,0,4,0,-4
15293,1,1,413,1823,1410
15294,1,0,29,0,-29
15295,1,0,92,0,-92
15296,1,1,339,1281,942
15297,0,0,54,0,-54
15298,1,1,1195,1269,74
15299,0,0,44,0,-44
15300,1,0,34,0,-34
15301,0,0,80,0,-80
15302,0,0,5,0,-5
15303,1,0,232,0,-232
15304,1,1,174,1274,1100
15305,1,0,15,0,-15
15306,1,1,156,3932,3776
15307,0,0,33,0,-33
15308,1,0,4,0,-4
15309,1,1,621,1443,822
15310,1,0,5,0,-5
15311,0,0,145,0,-145
15312,0,0,56,0,-56
15313,0,0,64,0,-64
15314,1,1,1676,1244,-432
15315,1,1,429,1485,1056
15316,1,1,100,1522,1422
15317,1,0,8,0,-8
15318,0,0,107,0,-107
15319,0,0,67,0,-67
15320,0,0,10,0,-10
15321,1,0,66,0,-66
15322,1,0,53,0,-53
15323,0,0,76,0,-76
15324,0,0,97,0,-97
15325,1,0,38,0,-38
15326,0,0,57,0,-57
15327,1,0,69,0,-69
15328,0,0,153,0,-153
15329,0,0,26,0,-26
15330,0,0,21,0,-21
15331,0,0,23,0,-23
15332,1,0,0,0,0
15333,1,0,20,0,-20
15334,1,1,258,1960,1702
15335,0,0,4,0,-4
15336,1,0,26,0,-26
15337,1,0,35,0,-35
15338,0,0,99,0,-99
15339,0,0,176,0,-176
15340,1,1,389,1603,1214
15341,0,0,46,0,-46
15342,1,1,164,1617,1453
15343,1,0,25,0,-25
15344,0,0,47,0,-47
15345,1,0,6,0,-6
15346,0,0,4,0,-4
15347,1,1,374,1643,1269
15348,1,0,26,0,-26
15349,1,1,173,2199,2026
15350,1,0,134,0,-134
15351,1,0,48,0,-48
15352,1,1,469,1317,848
15353,1,0,16,0,-16
15354,1,1,484,1847,1363
15355,0,0,11,0,-11
15356,1,0,12,0,-12
15357,1,0,8,0,-8
15358,0,0,50,0,-50
15359,0,0,22,0,-22
15360,1,1,959,2039,1080
15361,1,1,311,1961,1650
15362,0,0,21,0,-21
15363,0,0,42,0,-42
15364,1,1,159,1838,1679
15365,1,1,226,1844,1618
15366,1,0,31,0,-31
15367,1,1,585,1265,680
15368,0,0,41,0,-41
15369,1,0,32,0,-32
15370,1,1,1459,1375,-84
15371,0,0,121,0,-121
15372,0,0,65,0,-65
15373,0,0,95,0,-95
15374,0,0,23,0,-23
15375,1,0,53,0,-53
15376,0,0,9,0,-9
15377,1,0,86,0,-86
15378,1,1,167,1457,1290
15379,0,0,25,0,-25
15380,0,0,37,0,-37
15381,0,0,35,0,-35
15382,1,1,1125,1458,333
15383,0,0,9,0,-9
15384,1,1,280,1517,1237
15385,1,1,851,1454,603
15386,0,0,64,0,-64
15387,1,1,72,1344,1272
15388,0,0,4,0,-4
15389,1,0,26,0,-26
15390,1,1,121,1359,1238
15391,0,0,132,0,-132
15392,1,0,30,0,-30
15393,0,0,5,0,-5
15394,1,1,71,2493,2422
15395,1,0,68,0,-68
15396,1,1,693,1943,1250
15397,1,0,27,0,-27
15398,0,0,64,0,-64
15399,1,1,609,1269,660
15400,1,1,980,1327,347
15401,1,1,1148,1408,260
15402,1,1,252,1878,1626
15403,1,1,320,1454,1134
15404,0,0,33,0,-33
15405,1,1,75,1565,1490
15406,1,0,16,0,-16
15407,0,0,67,0,-67
15408,1,1,537,1220,683
15409,0,0,91,0,-91
15410,1,0,9,0,-9
15411,1,1,433,1217,784
15412,1,0,43,0,-43
15413,0,0,1,0,-1
15414,0,0,6,0,-6
15415,1,1,428,1258,830
15416,1,1,250,1850,1600
15417,1,1,655,1514,859
15418,0,0,63,0,-63
15419,1,0,5,0,-5
15420,0,0,21,0,-21
15421,1,1,480,1228,748
15422,0,0,55,0,-55
15423,1,1,219,1403,1184
15424,1,0,0,0,0
15425,1,1,295,1504,1209
15426,1,0,80,0,-80
15427,1,1,202,1240,1038
15428,1,1,478,1757,1279
15429,1,0,26,0,-26
15430,0,0,2,0,-2
15431,0,0,7,0,-7
15432,0,0,21,0,-21
15433,1,1,359,1472,1113
15434,1,1,966,1444,478
15435,0,0,28,0,-28
15436,0,0,50,0,-50
15437,0,0,28,0,-28
15438,1,1,805,1252,447
15439,0,0,30,0,-30
15440,0,0,12,0,-12
15441,1,1,248,1447,1199
15442,1,1,779,1456,677
15443,0,0,59,0,-59
15444,1,1,420,1654,1234
15445,1,0,11,0,-11
15446,0,0,53,0,-53
15447,1,1,235,1390,1155
15448,1,1,470,1312,842
15449,0,0,117,0,-117
15450,1,1,107,1526,1419
15451,1,0,4,0,-4
15452,1,0,68,0,-68
15453,0,0,29,0,-29
15454,0,0,25,0,-25
15455,1,0,10,0,-10
15456,0,0,60,0,-60
15457,0,0,161,0,-161
15458,1,0,41,0,-41
15459,1,0,70,0,-70
15460,1,0,15,0,-15
15461,0,0,37,0,-37
15462,0,0,4,0,-4
15463,0,0,64,0,-64
15464,0,0,37,0,-37
15465,0,0,357,0,-357
15466,1,1,881,1778,897
15467,0,0,16,0,-16
15468,1,0,36,0,-36
15469,0,0,0,0,0
15470,0,0,5,0,-5
15471,1,0,53,0,-53
15472,1,0,67,0,-67
15473,0,0,8,0,-8
15474,1,1,1063,1435,372
15475,1,1,40,1251,1211
15476,1,0,28,0,-28
15477,1,0,1,0,-1
15478,1,0,37,0,-37
15479,0,0,0,0,0
15480,1,0,21,0,-21
15481,1,1,153,1368,1215
15482,1,0,32,0,-32
15483,1,0,52,0,-52
15484,0,0,8,0,-8
15485,1,0,53,0,-53
15486,1,1,1201,1908,707
15487,0,0,51,0,-51
15488,1,1,342,1355,1013
15489,0,0,3,0,-3
15490,1,0,7,0,-7
15491,0,0,15,0,-15
15492,1,0,38,0,-38
15493,1,0,13,0,-13
15494,1,1,289,1291,1002
15495,1,1,446,1336,890
15496,1,0,14,0,-14
15497,1,0,27,0,-27
15498,1,0,9,0,-9
15499,1,0,89,0,-89
15500,1,1,200,2714,2514
15501,1,0,45,0,-45
15502,0,0,25,0,-25
15503,0,0,125,0,-125
15504,1,0,3,0,-3
15505,0,0,135,0,-135
15506,1,1,346,1280,934
15507,0,0,103,0,-103
15508,0,0,10,0,-10
15509,0,0,62,0,-62
15510,1,1,583,2051,1468
15511,1,0,39,0,-39
15512,0,0,0,0,0
15513,1,1,1247,1614,367
15514,1,1,1320,1265,-55
15515,0,0,32,0,-32
15516,1,0,73,0,-73
15517,0,0,17,0,-17
15518,1,1,81,2534,2453
15519,1,1,176,1306,1130
15520,1,0,71,0,-71
15521,1,1,379,1345,966
15522,1,0,48,0,-48
15523,1,1,598,1269,671
15524,1,0,28,0,-28
15525,1,1,762,4972,4210
15526,0,0,1,0,-1
15527,1,1,615,2573,1958
15528,1,0,67,0,-67
15529,1,1,340,1254,914
15530,0,0,2,0,-2
15531,1,0,47,0,-47
15532,0,0,13,0,-13
15533,1,1,835,1335,500
15534,0,0,15,0,-15
15535,0,0,76,0,-76
15536,0,0,2,0,-2
15537,1,1,312,1539,1227
15538,0,0,30,0,-30
15539,1,1,452,4224,3772
15540,1,1,418,1658,1240
15541,1,0,128,0,-128
15542,0,0,8,0,-8
15543,1,1,1550,1677,127
15544,1,0,48,0,-48
15545,1,1,248,1434,1186
15546,1,1,820,1435,615
15547,1,0,14,0,-14
15548,0,0,127,0,-127
15549,0,0,42,0,-42
15550,1,0,34,0,-34
15551,1,0,6,0,-6
15552,1,0,32,0,-32
15553,1,0,4,0,-4
15554,1,1,699,1308,609
15555,1,1,98,1655,1557
15556,1,1,364,2670,2306
15557,0,0,13,0,-13
15558,1,1,960,1415,455
15559,1,0,7,0,-7
15560,0,0,1,0,-1
15561,1,0,3,0,-3
15562,0,0,39,0,-39
15563,1,1,198,2090,1892
15564,1,1,764,1554,790
15565,1,0,18,0,-18
15566,1,0,46,0,-46
15567,1,1,446,1347,901
15568,0,0,37,0,-37
15569,0,0,42,0,-42
15570,1,0,106,0,-106
15571,0,0,223,0,-223
15572,1,0,29,0,-29
15573,0,0,33,0,-33
15574,1,1,1542,1510,-32
15575,1,1,120,1330,1210
15576,1,1,296,1213,917
15577,0,0,34,0,-34
15578,1,1,529,1311,782
15579,1,0,35,0,-35
15580,1,1,149,1581,1432
15581,1,0,54,0,-54
15582,1,0,9,0,-9
15583,1,1,1126,2319,1193
15584,0,0,41,0,-41
15585,0,0,0,0,0
15586,1,0,1,0,-1
15587,1,0,108,0,-108
15588,0,0,9,0,-9
15589,0,0,95,0,-95
15590,1,1,90,1399,1309
15591,1,1,161,2566,2405
15592,1,1,267,1228,961
15593,0,0,7,0,-7
15594,1,0,123,0,-123
15595,1,1,583,2154,1571
15596,1,1,1611,1371,-240
15597,1,0,79,0,-79
15598,1,0,63,0,-63
15599,1,0,7,0,-7
15600,0,0,101,0,-101
15601,1,0,161,0,-161
15602,1,0,34,0,-34
15603,1,1,349,1222,873
15604,1,1,508,1522,1014
15605,1,0,52,0,-52
15606,1,1,804,1445,641
15607,1,1,588,2887,2299
15608,0,0,81,0,-81
15609,0,0,15,0,-15
15610,1,0,3,0,-3
15611,0,0,39,0,-39
15612,1,1,510,1851,1341
15613,0,0,38,0,-38
15614,0,0,53,0,-53
15615,1,0,87,0,-87
15616,1,1,336,2123,1787
15617,0,0,62,0,-62
15618,0,0,38,0,-38
15619,1,1,1273,1543,270
15620,1,1,661,1727,1066
15621,0,0,246,0,-246
15622,1,0,13,0,-13
15623,1,1,762,1513,751
15624,1,1,240,1266,1026
15625,1,1,29,1301,1272
15626,1,1,1441,1881,440
15627,0,0,61,0,-61
15628,1,1,437,1264,827
15629,0,0,4,0,-4
15630,1,0,46,0,-46
15631,0,0,19,0,-19
15632,1,1,113,3681,3568
15633,0,0,10,0,-10
15634,1,0,33,0,-33
15635,1,0,26,0,-26
15636,1,1,1916,1666,-250
15637,0,0,31,0,-31
15638,0,0,18,0,-18
15639,0,0,10,0,-10
15640,1,1,319,1467,1148
15641,0,0,12,0,-12
15642,1,0,1,0,-1
15643,0,0,41,0,-41
15644,0,0,33,0,-33
15645,0,0,12,0,-12
15646,1,0,7,0,-7
15647,0,0,129,0,-129
15648,1,0,161,0,-161
15649,1,1,25,1672,1647
15650,0,0,56,0,-56
15651,1,1,809,1674,865
15652,0,0,23,0,-23
15653,0,0,100,0,-100
15654,0,0,45,0,-45
15655,0,0,85,0,-85
15656,0,0,41,0,-41
15657,1,1,144,1227,1083
15658,0,0,30,0,-30
15659,1,1,237,1739,1502
15660,0,0,167,0,-167
15661,1,0,76,0,-76
15662,1,0,69,0,-69
15663,0,0,5,0,-5
15664,0,0,61,0,-61
15665,1,1,704,2571,1867
15666,0,0,18,0,-18
15667,1,1,154,1301,1147
15668,1,0,26,0,-26
15669,1,1,951,1811,860
15670,1,0,11,0,-11
15671,1,0,68,0,-68
15672,0,0,58,0,-58
15673,0,0,89,0,-89
15674,1,0,24,0,-24
15675,0,0,13,0,-13
15676,1,1,16,1321,1305
15677,0,0,50,0,-50
15678,1,1,599,1263,664
15679,1,1,943,1204,261
15680,1,1,1052,1573,521
15681,1,1,18,1237,1219
15682,1,1,900,1249,349
15683,1,0,81,0,-81
15684,0,0,1,0,-1
15685,0,0,33,0,-33
15686,0,0,62,0,-62
15687,0,0,12,0,-12
15688,0,0,176,0,-176
15689,1,1,93,1293,1200
15690,0,0,42,0,-42
15691,0,0,185,0,-185
15692,1,0,25,0,-25
15693,1,0,58,0,-58
15694,0,0,3,0,-3
15695,1,1,220,3229,3009
15696,1,1,187,1364,1177
15697,0,0,18,0,-18
15698,1,1,191,1348,1157
15699,0,0,59,0,-59
15700,0,0,4,0,-4
15701,1,1,471,1347,876
15702,1,1,263,1300,1037
15703,1,1,267,1356,1089
15704,0,0,109,0,-109
15705,1,0,3,0,-3
15706,1,0,33,0,-33
15707,1,1,434,4690,4256
15708,1,0,7,0,-7
15709,1,0,71,0,-71
15710,0,0,36,0,-36
15711,1,0,17,0,-17
15712,1,1,108,1346,1238
15713,1,0,12,0,-12
15714,1,0,27,0,-27
15715,1,1,400,1318,918
15716,1,0,128,0,-128
15717,0,0,36,0,-36
15718,0,0,25,0,-25
15719,1,1,19,1257,1238
15720,1,0,3,0,-3
15721,1,0,65,0,-65
15722,1,1,957,1507,550
15723,1,0,42,0,-42
15724,1,0,51,0,-51
15725,1,0,48,0,-48
15726,1,1,814,2295,1481
15727,1,1,1552,1423,-129
15728,1,1,556,2024,1468
15729,1,0,9,0,-9
15730,1,0,45,0,-45
15731,1,0,44,0,-44
15732,1,0,6,0,-6
15733,1,1,326,1360,1034
15734,1,1,1291,2103,812
15735,1,1,1206,1404,198
15736,0,0,80,0,-80
15737,1,1,71,1347,1276
15738,1,1,633,1293,660
15739,1,0,100,0,-100
15740,0,0,90,0,-90
15741,0,0,11,0,-11
15742,0,0,2,0,-2
15743,1,0,9,0,-9
15744,0,0,2,0,-2
15745,1,1,152,1927,1775
15746,1,1,191,1305,1114
15747,0,0,71,0,-71
15748,0,0,1,0,-1
15749,1,0,18,0,-18
15750,0,0,4,0,-4
15751,0,0,15,0,-15
15752,1,1,1094,1644,550
15753,0,0,22,0,-22
15754,1,1,123,1670,1547
15755,0,0,70,0,-70
15756,1,0,37,0,-37
15757,1,1,561,1631,1070
15758,0,0,5,0,-5
15759,1,0,22,0,-22
15760,1,0,7,0,-7
15761,1,1,286,1889,1603
15762,1,0,18,0,-18
15763,0,0,9,0,-9
15764,0,0,170,0,-170
15765,1,1,440,1280,840
15766,1,0,57,0,-57
15767,1,1,1093,1283,190
15768,0,0,20,0,-20
15769,1,1,150,3785,3635
15770,1,0,0,0,0
15771,1,0,23,0,-23
15772,1,0,4,0,-4
15773,1,0,6,0,-6
15774,1,1,366,1639,1273
15775,0,0,55,0,-55
15776,1,0,1,0,-1
15777,1,1,374,1381,1007
15778,1,1,757,1697,940
15779,1,1,212,1323,1111
15780,0,0,127,0,-127
15781,0,0,59,0,-59
15782,0,0,21,0,-21
15783,1,0,21,0,-21
15784,1,1,583,1322,739
15785,1,1,1032,1758,726
15786,1,1,679,1601,922
15787,1,1,2029,1513,-516
15788,0,0,30,0,-30
15789,1,1,1023,1200,177
15790,1,1,182,1204,1022
15791,1,1,104,1535,1431
15792,0,0,41,0,-41
15793,1,1,551,2179,1628
15794,1,0,6,0,-6
15795,1,1,55,1307,1252
15796,1,1,1089,1421,332
15797,1,1,137,1489,1352
15798,1,0,56,0,-56
15799,0,0,114,0,-114
15800,1,0,12,0,-12
15801,1,1,181,1600,1419
15802,0,0,87,0,-87
15803,0,0,6,0,-6
15804,1,0,38,0,-38
15805,0,0,100,0,-100
15806,1,0,106,0,-106
15807,0,0,90,0,-90
15808,1,0,28,0,-28
15809,0,0,63,0,-63
15810,1,1,32,1327,1295
15811,0,0,6,0,-6
15812,0,0,109,0,-109
15813,1,1,702,1756,1054
15814,1,0,14,0,-14
15815,0,0,54,0,-54
15816,1,1,244,1531,1287
15817,1,0,36,0,-36
15818,1,1,84,1239,1155
15819,1,1,22,1296,1274
15820,1,0,2,0,-2
15821,1,0,32,0,-32
15822,1,1,2530,1438,-1092
15823,0,0,2,0,-2
15824,1,1,559,1668,1109
15825,0,0,35,0,-35
15826,1,0,45,0,-45
15827,1,1,46,1356,1310
15828,1,1,283,1428,1145
15829,1,0,111,0,-111
15830,1,1,805,1575,770
15831,1,1,119,1939,1820
15832,0,0,0,0,0
15833,1,1,159,1436,1277
15834,1,0,25,0,-25
15835,1,0,11,0,-11
15836,1,0,241,0,-241
15837,0,0,179,0,-179
15838,1,1,475,1412,937
15839,1,0,3,0,-3
15840,0,0,62,0,-62
15841,1,0,4,0,-4
15842,0,0,33,0,-33
15843,1,0,45,0,-45
15844,1,1,165,3274,3109
15845,1,0,13,0,-13
15846,1,0,4,0,-4
15847,1,1,129,1333,1204
15848,1,0,54,0,-54
15849,1,1,1949,1593,-356
15850,1,0,8,0,-8
15851,1,0,191,0,-191
15852,1,1,729,1742,1013
15853,1,0,26,0,-26
15854,1,1,113,1285,1172
15855,1,1,104,1334,1230
15856,1,0,120,0,-120
15857,0,0,45,0,-45
15858,0,0,49,0,-49
15859,1,1,410,1315,905
15860,1,0,4,0,-4
15861,1,0,34,0,-34
15862,1,1,195,1343,1148
15863,0,0,50,0,-50
15864,1,1,207,2004,1797
15865,1,0,33,0,-33
15866,0,0,75,0,-75
15867,0,0,37,0,-37
15868,1,0,62,0,-62
15869,0,0,17,0,-17
15870,1,0,31,0,-31
15871,1,1,77,1208,1131
15872,1,1,189,1422,1233
15873,0,0,157,0,-157
15874,1,1,213,1272,1059
15875,0,0,60,0,-60
15876,0,0,68,0,-68
15877,0,0,44,0,-44
15878,1,0,92,0,-92
15879,1,0,91,0,-91
15880,1,1,60,2720,2660
15881,0,0,29,0,-29
15882,1,1,97,1237,1140
15883,1,1,592,1325,733
15884,0,0,130,0,-130
15885,0,0,25,0,-25
15886,0,0,26,0,-26
15887,1,0,122,0,-122
15888,1,0,45,0,-45
15889,0,0,22,0,-22
15890,1,0,130,0,-130
15891,1,1,1487,1266,-221
15892,1,1,189,1609,1420
15893,1,1,489,1561,1072
15894,1,0,154,0,-154
15895,1,1,1344,2019,675
15896,1,1,849,1764,915
15897,1,0,23,0,-23
15898,1,0,70,0,-70
15899,1,0,11,0,-11
15900,1,1,221,1682,1461
15901,1,1,1765,1477,-288
15902,0,0,94,0,-94
15903,1,1,1239,1543,304
15904,1,0,79,0,-79
15905,1,1,502,1487,985
15906,1,1,147,1566,1419
15907,0,0,21,0,-21
15908,1,1,756,1244,488
15909,0,0,78,0,-78
15910,1,0,108,0,-108
15911,0,0,13,0,-13
15912,0,0,4,0,-4
15913,1,0,95,0,-95
15914,0,0,1,0,-1
15915,0,0,45,0,-45
15916,1,0,1,0,-1
15917,0,0,50,0,-50
15918,0,0,19,0,-19
15919,1,1,700,1368,668
15920,1,0,42,0,-42
15921,0,0,82,0,-82
15922,1,1,1223,1772,549
15923,1,1,688,3395,2707
15924,1,0,63,0,-63
15925,0,0,52,0,-52
15926,0,0,21,0,-21
15927,1,1,519,1236,717
15928,1,1,201,1869,1668
15929,0,0,17,0,-17
15930,1,1,515,1387,872
15931,1,0,51,0,-51
15932,0,0,25,0,-25
15933,1,1,147,1342,1195
15934,1,0,152,0,-152
15935,1,1,315,1561,1246
15936,1,1,491,1253,762
15937,1,0,70,0,-70
15938,0,0,122,0,-122
15939,1,0,10,0,-10
15940,0,0,38,0,-38
15941,1,1,278,1499,1221
15942,0,0,1,0,-1
15943,1,0,34,0,-34
15944,1,0,48,0,-48
15945,0,0,34,0,-34
15946,1,0,124,0,-124
15947,1,1,393,2183,1790
15948,0,0,81,0,-81
15949,1,0,64,0,-64
15950,1,0,40,0,-40
15951,1,1,882,1231,349
15952,0,0,186,0,-186
15953,0,0,19,0,-19
15954,1,1,424,1275,851
15955,1,0,29,0,-29
15956,1,1,163,1228,1065
15957,1,0,5,0,-5
15958,1,1,564,1260,696
15959,0,0,20,0,-20
15960,0,0,69,0,-69
15961,1,0,75,0,-75
15962,1,1,258,1253,995
15963,1,1,782,1413,631
15964,1,1,412,2023,1611
15965,0,0,98,0,-98
15966,1,1,409,1327,918
15967,0,0,35,0,-35
15968,0,0,14,0,-14
15969,0,0,27,0,-27
15970,0,0,29,0,-29
15971,1,0,67,0,-67
15972,1,1,95,1798,1703
15973,0,0,46,0,-46
15974,1,0,34,0,-34
15975,1,1,1153,1365,212
15976,0,0,1,0,-1
15977,1,1,670,1303,633
15978,0,0,3,0,-3
15979,1,0,0,0,0
15980,1,1,98,1279,1181
15981,1,0,25,0,-25
15982,1,0,63,0,-63
15983,0,0,23,0,-23
15984,0,0,24,0,-24
15985,1,1,177,1234,1057
15986,0,0,2,0,-2
15987,0,0,48,0,-48
15988,1,0,61,0,-61
15989,0,0,62,0,-62
15990,1,1,162,1223,1061
15991,0,0,16,0,-16
15992,0,0,20,0,-20
15993,1,0,67,0,-67
15994,1,0,34,0,-34
15995,1,0,5,0,-5
15996,1,0,16,0,-16
15997,1,1,1827,1442,-385
15998,1,1,356,1218,862
15999,1,1,41,2329,2288
16000,0,0,44,0,-44
16001,0,0,89,0,-89
16002,1,0,95,0,-95
16003,0,0,43,0,-43
16004,1,1,564,1237,673
16005,0,0,10,0,-10
16006,1,0,2,0,-2
16007,0,0,27,0,-27
16008,0,0,84,0,-84
16009,1,0,102,0,-102
16010,1,0,85,0,-85
16011,1,0,24,0,-24
16012,1,0,73,0,-73
16013,0,0,45,0,-45
16014,0,0,29,0,-29
16015,1,0,30,0,-30
16016,0,0,7,0,-7
16017,1,1,681,1777,1096
16018,1,0,34,0,-34
16019,0,0,18,0,-18
16020,0,0,5,0,-5
16021,0,0,39,0,-39
16022,1,1,197,1424,1227
16023,0,0,48,0,-48
16024,0,0,31,0,-31
16025,1,1,61,1281,1220
16026,0,0,5,0,-5
16027,1,1,185,1291,1106
16028,1,0,3,0,-3
16029,0,0,5,0,-5
16030,1,0,35,0,-35
16031,0,0,16,0,-16
16032,0,0,44,0,-44
16033,1,0,2,0,-2
16034,0,0,53,0,-53
16035,0,0,3,0,-3
16036,1,0,131,0,-131
16037,0,0,65,0,-65
16038,1,1,234,1465,1231
16039,1,0,38,0,-38
16040,0,0,29,0,-29
16041,0,0,0,0,0
16042,1,0,2,0,-2
16043,0,0,1,0,-1
16044,1,1,443,1237,794
16045,1,0,54,0,-54
16046,1,0,33,0,-33
16047,0,0,6,0,-6
16048,1,1,848,1592,744
16049,0,0,117,0,-117
16050,0,0,42,0,-42
16051,0,0,43,0,-43
16052,1,1,406,1322,916
16053,0,0,163,0,-163
16054,1,1,978,1322,344
16055,1,1,572,1214,642
16056,1,0,2,0,-2
16057,0,0,37,0,-37
16058,1,0,43,0,-43
16059,1,1,974,2518,1544
16060,1,1,709,1440,731
16061,1,1,2026,1414,-612
16062,1,0,28,0,-28
16063,0,0,2,0,-2
16064,1,1,222,2190,1968
16065,0,0,52,0,-52
16066,1,0,10,0,-10
16067,0,0,72,0,-72
16068,0,0,150,0,-150
16069,0,0,48,0,-48
16070,0,0,17,0,-17
16071,0,0,80,0,-80
16072,1,0,106,0,-106
16073,1,0,2,0,-2
16074,0,0,4,0,-4
16075,1,0,39,0,-39
16076,1,0,15,0,-15
16077,1,1,751,1403,652
16078,1,1,52,1359,1307
16079,1,0,4,0,-4
16080,1,1,2230,1364,-866
16081,0,0,66,0,-66
16082,0,0,10,0,-10
16083,0,0,43,0,-43
16084,0,0,80,0,-80
16085,0,0,13,0,-13
16086,1,1,1224,1257,33
16087,0,0,15,0,-15
16088,0,0,72,0,-72
16089,0,0,80,0,-80
16090,1,1,515,1370,855
16091,0,0,35,0,-35
16092,1,0,52,0,-52
16093,0,0,11,0,-11
16094,1,0,10,0,-10
16095,1,0,18,0,-18
16096,1,0,9,0,-9
16097,0,0,125,0,-125
16098,0,0,8,0,-8
16099,0,0,19,0,-19
16100,1,0,20,0,-20
16101,0,0,4,0,-4
16102,1,0,20,0,-20
16103,0,0,24,0,-24
16104,0,0,0,0,0
16105,1,0,113,0,-113
16106,1,1,346,1321,975
16107,1,0,17,0,-17
16108,1,0,146,0,-146
16109,1,1,88,1825,1737
16110,0,0,72,0,-72
16111,0,0,24,0,-24
16112,1,0,46,0,-46
16113,1,1,581,1750,1169
16114,0,0,11,0,-11
16115,1,1,332,1293,961
16116,1,1,1340,1335,-5
16117,0,0,32,0,-32
16118,1,1,285,1536,1251
16119,1,0,33,0,-33
16120,0,0,108,0,-108
16121,1,1,50,1379,1329
16122,1,1,1506,1673,167
16123,1,1,69,4491,4422
16124,0,0,91,0,-91
16125,0,0,119,0,-119
16126,0,0,14,0,-14
16127,1,1,115,2674,2559
16128,1,1,1945,1420,-525
16129,0,0,33,0,-33
16130,0,0,20,0,-20
16131,0,0,13,0,-13
16132,1,0,123,0,-123
16133,0,0,13,0,-13
16134,1,1,277,1550,1273
16135,1,1,374,3127,2753
16136,0,0,141,0,-141
16137,0,0,1,0,-1
16138,1,1,1005,1227,222
16139,1,0,71,0,-71
16140,1,1,46,1427,1381
16141,0,0,3,0,-3
16142,1,0,77,0,-77
16143,1,1,1099,1355,256
16144,0,0,61,0,-61
16145,0,0,37,0,-37
16146,0,0,46,0,-46
16147,1,0,21,0,-21
16148,1,1,228,1246,1018
16149,0,0,1,0,-1
16150,1,1,299,3096,2797
16151,1,1,206,1287,1081
16152,0,0,207,0,-207
16153,1,1,335,1583,1248
16154,1,0,104,0,-104
16155,0,0,10,0,-10
16156,0,0,8,0,-8
16157,1,0,36,0,-36
16158,1,1,262,1463,1201
16159,0,0,7,0,-7
16160,1,1,550,2543,1993
16161,1,0,25,0,-25
16162,1,1,14,1225,1211
16163,1,1,331,2028,1697
16164,1,1,585,1286,701
16165,1,0,21,0,-21
16166,1,0,42,0,-42
16167,1,0,48,0,-48
16168,1,0,15,0,-15
16169,0,0,23,0,-23
16170,0,0,64,0,-64
16171,1,1,317,2016,1699
16172,0,0,101,0,-101
16173,1,0,87,0,-87
16174,0,0,51,0,-51
16175,0,0,7,0,-7
16176,0,0,36,0,-36
16177,1,1,287,1571,1284
16178,1,0,23,0,-23
16179,0,0,92,0,-92
16180,1,0,199,0,-199
16181,1,0,27,0,-27
16182,1,0,92,0,-92
16183,1,0,7,0,-7
16184,0,0,17,0,-17
16185,1,0,29,0,-29
16186,0,0,61,0,-61
16187,1,1,612,1302,690
16188,0,0,15,0,-15
16189,0,0,23,0,-23
16190,1,1,392,1441,1049
16191,0,0,17,0,-17
16192,1,0,122,0,-122
16193,1,0,41,0,-41
16194,1,1,388,1308,920
16195,1,0,186,0,-186
16196,0,0,20,0,-20
16197,0,0,53,0,-53
16198,1,1,82,1594,1512
16199,0,0,71,0,-71
16200,0,0,6,0,-6
16201,1,1,43,1589,1546
16202,1,0,66,0,-66
16203,0,0,22,0,-22
16204,0,0,31,0,-31
16205,1,1,1276,1355,79
16206,0,0,73,0,-73
16207,0,0,12,0,-12
16208,0,0,12,0,-12
16209,0,0,93,0,-93
16210,0,0,38,0,-38
16211,1,1,227,1212,985
16212,1,1,885,2475,1590
16213,0,0,14,0,-14
16214,1,0,52,0,-52
16215,1,1,896,1932,1036
16216,0,0,44,0,-44
16217,1,0,49,0,-49
16218,1,1,939,4127,3188
16219,0,0,14,0,-14
16220,0,0,80,0,-80
16221,1,1,74,1314,1240
16222,1,0,42,0,-42
16223,0,0,31,0,-31
16224,1,0,15,0,-15
16225,0,0,25,0,-25
16226,0,0,21,0,-21
16227,0,0,20,0,-20
16228,0,0,11,0,-11
16229,0,0,30,0,-30
16230,1,0,107,0,-107
16231,1,1,3038,1685,-1353
16232,1,0,18,0,-18
16233,0,0,138,0,-138
16234,0,0,62,0,-62
16235,1,0,27,0,-27
16236,1,0,5,0,-5
16237,1,0,46,0,-46
16238,0,0,19,0,-19
16239,1,0,28,0,-28
16240,0,0,6,0,-6
16241,0,0,130,0,-130
16242,0,0,7,0,-7
16243,1,0,5,0,-5
16244,0,0,16,0,-16
16245,1,0,139,0,-139
16246,0,0,47,0,-47
16247,1,1,2129,1603,-526
16248,1,0,1,0,-1
16249,0,0,45,0,-45
16250,0,0,35,0,-35
16251,1,1,469,2187,1718
16252,1,0,10,0,-10
16253,0,0,34,0,-34
16254,1,1,952,1593,641
16255,0,0,68,0,-68
16256,0,0,12,0,-12
16257,0,0,1,0,-1
16258,0,0,28,0,-28
16259,1,1,90,1385,1295
16260,1,1,291,1552,1261
16261,1,1,492,1279,787
16262,1,0,135,0,-135
16263,0,0,20,0,-20
16264,1,1,1070,1303,233
16265,1,1,239,1494,1255
16266,1,1,288,1400,1112
16267,0,0,211,0,-211
16268,1,1,52,1338,1286
16269,0,0,75,0,-75
16270,0,0,16,0,-16
16271,0,0,69,0,-69
16272,0,0,78,0,-78
16273,1,0,39,0,-39
16274,1,0,9,0,-9
16275,1,0,76,0,-76
16276,1,1,829,3454,2625
16277,0,0,8,0,-8
16278,0,0,120,0,-120
16279,0,0,26,0,-26
16280,0,0,12,0,-12
16281,1,0,7,0,-7
16282,1,1,134,1419,1285
16283,0,0,113,0,-113
16284,1,0,23,0,-23
16285,0,0,179,0,-179
16286,0,0,81,0,-81
16287,1,0,24,0,-24
16288,1,0,69,0,-69
16289,1,1,1353,1280,-73
16290,1,1,595,1226,631
16291,0,0,2,0,-2
16292,1,1,104,1322,1218
16293,1,0,50,0,-50
16294,1,1,2496,2298,-198
16295,0,0,49,0,-49
16296,1,1,357,1461,1104
16297,1,0,19,0,-19
16298,1,1,667,2340,1673
16299,1,0,98,0,-98
16300,0,0,29,0,-29
16301,0,0,76,0,-76
16302,1,0,30,0,-30
16303,0,0,62,0,-62
16304,0,0,54,0,-54
16305,0,0,133,0,-133
16306,0,0,100,0,-100
16307,0,0,26,0,-26
16308,1,0,22,0,-22
16309,0,0,5,0,-5
16310,0,0,23,0,-23
16311,1,0,70,0,-70
16312,0,0,13,0,-13
16313,0,0,13,0,-13
16314,1,0,93,0,-93
16315,0,0,55,0,-55
16316,0,0,12,0,-12
16317,1,1,723,1663,940
16318,0,0,21,0,-21
16319,1,0,13,0,-13
16320,0,0,91,0,-91
16321,0,0,14,0,-14
16322,1,0,27,0,-27
16323,0,0,35,0,-35
16324,0,0,6,0,-6
16325,0,0,1,0,-1
16326,1,1,299,1536,1237
16327,0,0,62,0,-62
16328,0,0,33,0,-33
16329,1,0,19,0,-19
16330,1,1,149,1371,1222
16331,0,0,77,0,-77
16332,0,0,53,0,-53
16333,0,0,21,0,-21
16334,1,1,853,1289,436
16335,0,0,70,0,-70
16336,1,1,65,1256,1191
16337,1,1,165,4524,4359
16338,1,1,773,1351,578
16339,0,0,95,0,-95
16340,1,0,90,0,-90
16341,0,0,103,0,-103
16342,1,0,39,0,-39
16343,0,0,158,0,-158
16344,1,1,466,1448,982
16345,0,0,0,0,0
16346,0,0,81,0,-81
16347,0,0,1,0,-1
16348,1,0,4,0,-4
16349,0,0,8,0,-8
16350,1,1,60,1629,1569
16351,1,0,79,0,-79
16352,1,0,8,0,-8
16353,1,1,134,1491,1357
16354,1,1,345,1389,1044
16355,1,1,843,1231,388
16356,0,0,49,0,-49
16357,0,0,61,0,-61
16358,1,1,1186,1557,371
16359,1,1,683,1349,666
16360,0,0,146,0,-146
16361,0,0,109,0,-109
16362,1,0,49,0,-49
16363,0,0,136,0,-136
16364,1,1,293,1248,955
16365,0,0,18,0,-18
16366,1,0,88,0,-88
16367,0,0,63,0,-63
16368,1,1,242,1225,983
16369,1,1,172,2796,2624
16370,1,0,17,0,-17
16371,1,0,36,0,-36
16372,0,0,24,0,-24
16373,0,0,7,0,-7
16374,0,0,2,0,-2
16375,1,1,1372,1660,288
16376,1,0,15,0,-15
16377,0,0,16,0,-16
16378,1,1,185,1346,1161
16379,1,0,20,0,-20
16380,0,0,8,0,-8
16381,1,1,1148,3421,2273
16382,1,1,1002,1465,463
16383,0,0,92,0,-92
16384,0,0,77,0,-77
16385,1,1,498,1514,1016
16386,1,1,91,1995,1904
16387,1,1,82,1350,1268
16388,0,0,115,0,-115
16389,1,1,1089,1417,328
16390,1,0,11,0,-11
16391,1,1,385,1392,1007
16392,1,1,715,1261,546
16393,0,0,11,0,-11
16394,1,0,18,0,-18
16395,1,0,25,0,-25
16396,1,1,999,1656,657
16397,1,0,124,0,-124
16398,0,0,75,0,-75
16399,1,1,249,1202,953
16400,0,0,159,0,-159
16401,0,0,17,0,-17
16402,1,1,144,1688,1544
16403,1,1,364,1399,1035
16404,0,0,12,0,-12
16405,0,0,45,0,-45
16406,1,0,106,0,-106
16407,1,0,10,0,-10
16408,1,1,275,2599,2324
16409,1,1,366,1288,922
16410,1,1,298,2531,2233
16411,1,0,63,0,-63
16412,1,1,129,1264,1135
16413,1,1,672,1257,585
16414,0,0,58,0,-58
16415,1,0,8,0,-8
16416,1,1,439,1298,859
16417,1,1,116,1314,1198
16418,0,0,72,0,-72
16419,1,0,35,0,-35
16420,1,1,90,1598,1508
16421,1,1,316,1864,1548
16422,0,0,37,0,-37
16423,0,0,149,0,-149
16424,1,0,45,0,-45
16425,0,0,84,0,-84
16426,1,0,17,0,-17
16427,0,0,35,0,-35
16428,0,0,25,0,-25
16429,1,1,606,1234,628
16430,1,1,381,2868,2487
16431,0,0,0,0,0
16432,1,0,7,0,-7
16433,1,0,44,0,-44
16434,1,1,1356,1335,-21
16435,1,0,11,0,-11
16436,1,1,627,1494,867
16437,0,0,46,0,-46
16438,0,0,49,0,-49
16439,0,0,63,0,-63
16440,1,0,6,0,-6
16441,1,0,66,0,-66
16442,0,0,32,0,-32
16443,1,0,23,0,-23
16444,0,0,12,0,-12
16445,0,0,221,0,-221
16446,1,1,466,1335,869
16447,1,0,90,0,-90
16448,1,0,15,0,-15
16449,1,0,53,0,-53
16450,1,0,28,0,-28
16451,0,0,59,0,-59
16452,1,0,157,0,-157
16453,1,0,65,0,-65
16454,1,0,13,0,-13
16455,1,1,784,1244,460
16456,0,0,10,0,-10
16457,0,0,53,0,-53
16458,0,0,66,0,-66
16459,1,1,141,1680,1539
16460,1,1,2440,1641,-799
16461,0,0,23,0,-23
16462,1,0,18,0,-18
16463,1,0,12,0,-12
16464,1,0,6,0,-6
16465,0,0,7,0,-7
16466,1,1,507,1696,1189
16467,1,1,598,1203,605
16468,1,0,76,0,-76
16469,1,0,43,0,-43
16470,1,1,288,1503,1215
16471,0,0,64,0,-64
16472,0,0,69,0,-69
16473,1,1,489,1314,825
16474,1,1,1913,1806,-107
16475,1,0,9,0,-9
16476,1,0,28,0,-28
16477,0,0,84,0,-84
16478,1,0,21,0,-21
16479,1,1,318,1354,1036
16480,1,1,639,1281,642
16481,1,1,218,1657,1439
16482,1,0,3,0,-3
16483,1,0,40,0,-40
16484,1,1,1267,1311,44
16485,0,0,28,0,-28
16486,0,0,41,0,-41
16487,0,0,34,0,-34
16488,1,0,48,0,-48
16489,0,0,1,0,-1
16490,1,0,39,0,-39
16491,1,0,236,0,-236
16492,1,0,119,0,-119
16493,0,0,49,0,-49
16494,1,0,77,0,-77
16495,1,0,8,0,-8
16496,0,0,68,0,-68
16497,1,0,7,0,-7
16498,0,0,84,0,-84
16499,1,0,81,0,-81
16500,1,1,1423,1330,-93
16501,1,0,27,0,-27
16502,1,0,1,0,-1
16503,1,1,1329,1308,-21
16504,0,0,10,0,-10
16505,1,0,80,0,-80
16506,1,1,1625,1436,-189
16507,1,0,23,0,-23
16508,0,0,17,0,-17
16509,0,0,17,0,-17
16510,0,0,10,0,-10
16511,1,1,1047,1638,591
16512,1,1,33,1622,1589
16513,0,0,116,0,-116
16514,1,1,1022,1602,580
16515,0,0,5,0,-5
16516,1,0,44,0,-44
16517,0,0,23,0,-23
16518,0,0,44,0,-44
16519,0,0,2,0,-2
16520,1,0,11,0,-11
16521,1,0,38,0,-38
16522,1,1,2088,1576,-512
16523,1,1,202,1378,1176
16524,1,1,730,1308,578
16525,1,0,21,0,-21
16526,1,1,388,1224,836
16527,1,1,578,1347,769
16528,0,0,180,0,-180
16529,0,0,32,0,-32
16530,0,0,26,0,-26
16531,1,1,1609,1283,-326
16532,1,1,857,1459,602
16533,0,0,10,0,-10
16534,0,0,1,0,-1
16535,1,1,1203,1548,345
16536,1,0,65,0,-65
16537,1,0,47,0,-47
16538,1,0,15,0,-15
16539,0,0,44,0,-44
16540,0,0,12,0,-12
16541,1,1,210,2776,2566
16542,0,0,132,0,-132
16543,0,0,62,0,-62
16544,1,1,251,1687,1436
16545,1,0,20,0,-20
16546,0,0,62,0,-62
16547,0,0,34,0,-34
16548,1,1,651,1871,1220
16549,1,0,7,0,-7
16550,1,0,54,0,-54
16551,1,0,29,0,-29
16552,1,0,75,0,-75
16553,1,0,39,0,-39
16554,1,0,11,0,-11
16555,1,0,78,0,-78
16556,1,1,1039,1651,612
16557,0,0,18,0,-18
16558,0,0,117,0,-117
16559,1,1,204,1351,1147
16560,0,0,96,0,-96
16561,1,1,443,1253,810
16562,0,0,43,0,-43
16563,0,0,34,0,-34
16564,1,1,185,1450,1265
16565,1,1,271,3328,3057
16566,0,0,5,0,-5
16567,1,0,13,0,-13
16568,0,0,4,0,-4
16569,1,1,622,1260,638
16570,1,1,79,1291,1212
16571,1,1,842,1508,666
16572,1,1,376,2750,2374
16573,0,0,34,0,-34
16574,1,1,290,1266,976
16575,1,0,68,0,-68
16576,1,0,48,0,-48
16577,1,1,491,1308,817
16578,1,0,43,0,-43
16579,1,0,47,0,-47
16580,1,0,9,0,-9
16581,0,0,3,0,-3
16582,1,0,48,0,-48
16583,0,0,4,0,-4
16584,1,0,69,0,-69
16585,0,0,36,0,-36
16586,1,1,383,1966,1583
16587,1,1,373,1230,857
16588,1,1,246,1238,992
16589,0,0,69,0,-69
16590,0,0,4,0,-4
16591,0,0,31,0,-31
16592,1,0,17,0,-17
16593,1,1,153,1240,1087
16594,0,0,46,0,-46
16595,1,0,102,0,-102
16596,1,0,74,0,-74
16597,0,0,203,0,-203
16598,1,0,43,0,-43
16599,0,0,203,0,-203
16600,0,0,25,0,-25
16601,0,0,31,0,-31
16602,1,0,131,0,-131
16603,0,0,12,0,-12
16604,0,0,111,0,-111
16605,1,0,137,0,-137
16606,0,0,82,0,-82
16607,1,0,70,0,-70
16608,1,1,388,1265,877
16609,1,1,227,1220,993
16610,1,0,46,0,-46
16611,1,0,40,0,-40
16612,0,0,83,0,-83
16613,1,0,49,0,-49
16614,1,1,244,1618,1374
16615,1,1,1051,1723,672
16616,1,0,30,0,-30
16617,0,0,96,0,-96
16618,1,1,103,1322,1219
16619,0,0,73,0,-73
16620,1,1,570,1603,1033
16621,0,0,15,0,-15
16622,0,0,202,0,-202
16623,1,1,233,3256,3023
16624,0,0,12,0,-12
16625,0,0,5,0,-5
16626,1,0,124,0,-124
16627,1,1,192,1356,1164
16628,1,0,2,0,-2
16629,0,0,69,0,-69
16630,0,0,28,0,-28
16631,1,1,130,1237,1107
16632,1,1,235,1289,1054
16633,1,0,79,0,-79
16634,0,0,20,0,-20
16635,1,1,704,1955,1251
16636,1,1,454,1290,836
16637,1,0,88,0,-88
16638,0,0,116,0,-116
16639,1,1,386,1255,869
16640,0,0,3,0,-3
16641,1,1,509,1508,999
16642,1,1,500,1572,1072
16643,0,0,100,0,-100
16644,1,1,1242,1278,36
16645,1,0,8,0,-8
16646,0,0,147,0,-147
16647,0,0,46,0,-46
16648,0,0,202,0,-202
16649,1,1,423,2003,1580
16650,1,0,76,0,-76
16651,1,1,160,1352,1192
16652,0,0,32,0,-32
16653,0,0,44,0,-44
16654,1,1,391,1405,1014
16655,0,0,24,0,-24
16656,0,0,20,0,-20
16657,1,0,51,0,-51
16658,0,0,94,0,-94
16659,1,1,241,1339,1098
16660,0,0,43,0,-43
16661,0,0,9,0,-9
16662,1,1,108,1289,1181
16663,0,0,156,0,-156
16664,0,0,32,0,-32
16665,0,0,15,0,-15
16666,0,0,16,0,-16
16667,0,0,24,0,-24
16668,1,1,146,1214,1068
16669,1,1,123,1651,1528
16670,1,1,242,1201,959
16671,1,1,274,1502,1228
16672,1,1,826,1350,524
16673,1,0,78,0,-78
16674,1,0,5,0,-5
16675,1,1,1194,1454,260
16676,1,1,356,1554,1198
16677,1,0,155,0,-155
16678,0,0,140,0,-140
16679,0,0,0,0,0
16680,0,0,23,0,-23
16681,1,1,281,1461,1180
16682,0,0,57,0,-57
16683,0,0,58,0,-58
16684,0,0,79,0,-79
16685,0,0,41,0,-41
16686,0,0,34,0,-34
16687,1,1,192,1449,1257
16688,0,0,52,0,-52
16689,0,0,13,0,-13
16690,0,0,70,0,-70
16691,1,1,135,1337,1202
16692,1,1,699,1472,773
16693,0,0,16,0,-16
16694,0,0,18,0,-18
16695,0,0,7,0,-7
16696,0,0,52,0,-52
16697,0,0,5,0,-5
16698,1,0,108,0,-108
16699,1,1,256,2360,2104
16700,0,0,112,0,-112
16701,1,1,155,1548,1393
16702,1,1,81,2576,2495
16703,1,1,184,1992,1808
16704,1,1,135,1878,1743
16705,1,0,18,0,-18
16706,1,1,111,2202,2091
16707,1,1,98,1221,1123
16708,1,1,591,1303,712
16709,1,0,2,0,-2
16710,1,1,245,1298,1053
16711,1,1,196,1238,1042
16712,0,0,4,0,-4
16713,0,0,51,0,-51
16714,0,0,56,0,-56
16715,1,0,19,0,-19
16716,1,1,358,1817,1459
16717,1,1,1677,1396,-281
16718,1,0,26,0,-26
16719,1,1,901,1264,363
16720,0,0,29,0,-29
16721,1,0,13,0,-13
16722,0,0,80,0,-80
16723,0,0,40,0,-40
16724,1,0,20,0,-20
16725,0,0,26,0,-26
16726,1,1,1656,1622,-34
16727,1,1,1404,1380,-24
16728,1,1,54,1243,1189
16729,1,1,178,1446,1268
16730,0,0,111,0,-111
16731,0,0,109,0,-109
16732,1,1,510,1316,806
16733,1,1,1974,1688,-286
16734,1,0,96,0,-96
16735,1,0,13,0,-13
16736,0,0,140,0,-140
16737,0,0,209,0,-209
16738,0,0,178,0,-178
16739,1,1,35,1555,1520
16740,0,0,15,0,-15
16741,1,1,1466,1248,-218
16742,0,0,57,0,-57
16743,1,1,171,1318,1147
16744,0,0,28,0,-28
16745,1,0,4,0,-4
16746,0,0,34,0,-34
16747,1,0,79,0,-79
16748,1,1,773,1484,711
16749,0,0,73,0,-73
16750,1,1,899,2247,1348
16751,0,0,122,0,-122
16752,0,0,191,0,-191
16753,1,0,83,0,-83
16754,1,0,20,0,-20
16755,1,1,613,1599,986
16756,1,1,484,1679,1195
16757,1,1,154,1267,1113
16758,1,1,416,1260,844
16759,1,0,0,0,0
16760,0,0,37,0,-37
16761,1,1,394,1662,1268
16762,1,1,131,1348,1217
16763,1,1,66,2109,2043
16764,0,0,22,0,-22
16765,0,0,12,0,-12
16766,0,0,28,0,-28
16767,0,0,73,0,-73
16768,0,0,44,0,-44
16769,0,0,82,0,-82
16770,1,0,12,0,-12
16771,1,0,4,0,-4
16772,1,1,179,1665,1486
16773,1,1,590,1315,725
16774,1,1,488,2123,1635
16775,1,1,478,5998,5520
16776,0,0,14,0,-14
16777,0,0,15,0,-15
16778,0,0,29,0,-29
16779,0,0,25,0,-25
16780,1,1,829,1455,626
16781,1,0,75,0,-75
16782,0,0,38,0,-38
16783,1,1,330,1214,884
16784,1,1,1155,1216,61
16785,1,0,47,0,-47
16786,0,0,73,0,-73
16787,1,1,693,1461,768
16788,0,0,13,0,-13
16789,0,0,93,0,-93
16790,0,0,16,0,-16
16791,0,0,70,0,-70
16792,1,0,6,0,-6
16793,1,1,865,1917,1052
16794,1,1,811,1283,472
16795,1,0,23,0,-23
16796,0,0,137,0,-137
16797,1,1,677,1390,713
16798,1,0,70,0,-70
16799,0,0,124,0,-124
16800,1,1,510,1491,981
16801,0,0,103,0,-103
16802,1,0,19,0,-19
16803,0,0,5,0,-5
16804,1,1,118,1383,1265
16805,1,0,152,0,-152
16806,1,0,98,0,-98
16807,0,0,112,0,-112
16808,1,1,231,1569,1338
16809,0,0,1,0,-1
16810,0,0,72,0,-72
16811,1,1,1198,1508,310
16812,1,1,850,1751,901
16813,1,1,308,1500,1192
16814,0,0,15,0,-15
16815,0,0,115,0,-115
16816,1,0,53,0,-53
16817,0,0,94,0,-94
16818,0,0,44,0,-44
16819,0,0,20,0,-20
16820,1,0,64,0,-64
16821,0,0,15,0,-15
16822,0,0,23,0,-23
16823,1,1,860,1620,760
16824,0,0,77,0,-77
16825,1,1,645,1223,578
16826,0,0,177,0,-177
16827,0,0,24,0,-24
16828,1,0,4,0,-4
16829,1,1,133,1948,1815
16830,1,0,62,0,-62
16831,1,1,419,1448,1029
16832,1,1,742,1947,1205
16833,0,0,26,0,-26
16834,1,0,1,0,-1
16835,1,1,315,1392,1077
16836,0,0,49,0,-49
16837,0,0,34,0,-34
16838,1,1,597,2500,1903
16839,0,0,10,0,-10
16840,1,0,134,0,-134
16841,1,1,285,1292,1007
16842,1,0,43,0,-43
16843,1,0,92,0,-92
16844,0,0,3,0,-3
16845,1,0,33,0,-33
16846,0,0,72,0,-72
16847,0,0,16,0,-16
16848,1,0,61,0,-61
16849,1,1,240,1474,1234
16850,1,1,873,1664,791
16851,1,1,216,3470,3254
16852,1,1,33,1245,1212
16853,1,1,1113,1209,96
16854,1,1,390,1235,845
16855,0,0,51,0,-51
16856,1,1,208,1204,996
16857,0,0,5,0,-5
16858,1,1,177,1601,1424
16859,1,1,278,1317,1039
16860,0,0,4,0,-4
16861,1,0,5,0,-5
16862,1,0,53,0,-53
16863,0,0,136,0,-136
16864,1,1,1555,1340,-215
16865,1,0,18,0,-18
16866,1,1,872,1461,589
16867,1,0,1,0,-1
16868,0,0,67,0,-67
16869,1,0,0,0,0
16870,0,0,54,0,-54
16871,0,0,56,0,-56
16872,1,1,829,1512,683
16873,1,1,64,1656,1592
16874,1,0,46,0,-46
16875,0,0,18,0,-18
16876,1,1,146,1830,1684
16877,0,0,8,0,-8
16878,1,0,37,0,-37
16879,0,0,112,0,-112
16880,1,1,332,1914,1582
16881,1,0,22,0,-22
16882,1,1,705,1219,514
16883,1,1,90,1445,1355
16884,1,1,181,2189,2008
16885,0,0,68,0,-68
16886,1,0,6,0,-6
16887,1,0,86,0,-86
16888,0,0,16,0,-16
16889,1,0,16,0,-16
16890,1,0,28,0,-28
16891,1,1,59,3723,3664
16892,0,0,69,0,-69
16893,0,0,166,0,-166
16894,1,0,127,0,-127
16895,0,0,113,0,-113
16896,0,0,51,0,-51
16897,1,0,18,0,-18
16898,1,1,834,1551,717
16899,1,0,14,0,-14
16900,1,1,328,7351,7023
16901,1,1,513,1860,1347
16902,0,0,73,0,-73
16903,0,0,18,0,-18
16904,1,0,50,0,-50
16905,1,0,44,0,-44
16906,1,0,37,0,-37
16907,0,0,22,0,-22
16908,1,1,840,1969,1129
16909,1,0,77,0,-77
16910,0,0,1,0,-1
16911,1,1,180,1268,1088
16912,1,1,1183,1339,156
16913,1,0,19,0,-19
16914,1,1,2589,1501,-1088
16915,1,1,243,1882,1639
16916,0,0,70,0,-70
16917,1,1,294,1243,949
16918,1,1,459,1397,938
16919,1,1,451,1258,807
16920,0,0,29,0,-29
16921,1,0,29,0,-29
16922,1,1,209,1898,1689
16923,1,1,126,1374,1248
16924,1,1,829,1304,475
16925,1,0,25,0,-25
16926,0,0,168,0,-168
16927,0,0,12,0,-12
16928,1,1,118,1513,1395
16929,0,0,53,0,-53
16930,1,1,948,1337,389
16931,1,1,609,1533,924
16932,1,1,656,1298,642
16933,0,0,79,0,-79
16934,1,0,18,0,-18
16935,1,0,23,0,-23
16936,1,0,57,0,-57
16937,1,0,27,0,-27
16938,1,1,374,1799,1425
16939,1,1,53,1781,1728
16940,0,0,14,0,-14
16941,1,0,0,0,0
16942,1,0,38,0,-38
16943,0,0,24,0,-24
16944,0,0,85,0,-85
16945,1,1,409,1721,1312
16946,1,1,1495,1310,-185
16947,1,0,10,0,-10
16948,1,0,36,0,-36
16949,1,0,46,0,-46
16950,0,0,42,0,-42
16951,1,1,1792,1623,-169
16952,1,1,287,1489,1202
16953,1,0,76,0,-76
16954,0,0,23,0,-23
16955,0,0,25,0,-25
16956,0,0,201,0,-201
16957,0,0,48,0,-48
16958,0,0,38,0,-38
16959,1,1,699,1344,645
16960,1,0,155,0,-155
16961,0,0,16,0,-16
16962,1,0,9,0,-9
16963,1,1,2240,3193,953
16964,0,0,52,0,-52
16965,1,0,12,0,-12
16966,0,0,48,0,-48
16967,1,0,57,0,-57
16968,0,0,90,0,-90
16969,1,1,706,1287,581
16970,1,0,15,0,-15
16971,1,0,14,0,-14
16972,1,0,14,0,-14
16973,1,0,21,0,-21
16974,1,1,233,1687,1454
16975,1,0,184,0,-184
16976,0,0,99,0,-99
16977,1,1,524,1232,708
16978,0,0,49,0,-49
16979,1,0,158,0,-158
16980,0,0,74,0,-74
16981,1,0,14,0,-14
16982,1,1,232,1390,1158
16983,1,0,56,0,-56
16984,0,0,36,0,-36
16985,0,0,19,0,-19
16986,1,0,3,0,-3
16987,0,0,40,0,-40
16988,0,0,69,0,-69
16989,1,0,2,0,-2
16990,0,0,10,0,-10
16991,1,0,9,0,-9
16992,1,1,322,1212,890
16993,1,0,5,0,-5
16994,1,0,64,0,-64
16995,1,1,633,1491,858
16996,1,1,701,1427,726
16997,1,0,4,0,-4
16998,1,1,1097,1930,833
16999,1,1,539,1582,1043
17000,1,1,392,1598,1206
17001,1,0,28,0,-28
17002,1,1,35,1919,1884
17003,1,1,111,2326,2215
17004,0,0,58,0,-58
17005,1,0,36,0,-36
17006,0,0,27,0,-27
17007,1,1,685,1246,561
17008,1,0,16,0,-16
17009,1,0,52,0,-52
17010,0,0,6,0,-6
17011,0,0,8,0,-8
17012,1,1,381,1280,899
17013,1,0,26,0,-26
17014,1,1,808,1238,430
17015,0,0,89,0,-89
17016,0,0,2,0,-2
17017,0,0,117,0,-117
17018,1,1,602,1343,741
17019,1,0,4,0,-4
17020,0,0,33,0,-33
17021,0,0,52,0,-52
17022,1,0,59,0,-59
17023,0,0,4,0,-4
17024,0,0,131,0,-131
17025,0,0,151,0,-151
17026,1,1,1720,1929,209
17027,0,0,13,0,-13
17028,1,0,92,0,-92
17029,1,1,151,1438,1287
17030,1,1,331,1215,884
17031,0,0,24,0,-24
17032,1,0,45,0,-45
17033,0,0,33,0,-33
17034,1,0,62,0,-62
17035,0,0,21,0,-21
17036,1,0,44,0,-44
17037,1,0,37,0,-37
17038,0,0,12,0,-12
17039,0,0,14,0,-14
17040,1,1,275,1370,1095
17041,1,0,23,0,-23
17042,1,1,121,1715,1594
17043,1,1,344,1324,980
17044,0,0,15,0,-15
17045,0,0,43,0,-43
17046,1,1,786,1239,453
17047,0,0,37,0,-37
17048,1,0,92,0,-92
17049,0,0,7,0,-7
17050,0,0,90,0,-90
17051,1,0,7,0,-7
17052,1,0,72,0,-72
17053,0,0,8,0,-8
17054,0,0,62,0,-62
17055,1,1,772,1291,519
17056,0,0,8,0,-8
17057,0,0,51,0,-51
17058,1,0,186,0,-186
17059,0,0,6,0,-6
17060,0,0,28,0,-28
17061,1,1,400,1651,1251
17062,1,0,1,0,-1
17063,1,1,1420,2232,812
17064,1,0,48,0,-48
17065,0,0,100,0,-100
17066,0,0,16,0,-16
17067,1,0,111,0,-111
17068,1,1,488,1497,1009
17069,1,0,98,0,-98
17070,0,0,36,0,-36
17071,1,1,1401,2063,662
17072,1,1,424,1298,874
17073,1,1,359,1481,1122
17074,0,0,31,0,-31
17075,0,0,39,0,-39
17076,1,0,44,0,-44
17077,0,0,10,0,-10
17078,0,0,44,0,-44
17079,1,1,172,1321,1149
17080,0,0,4,0,-4
17081,0,0,32,0,-32
17082,1,0,18,0,-18
17083,0,0,11,0,-11
17084,1,1,2091,1269,-822
17085,0,0,102,0,-102
17086,1,0,46,0,-46
17087,1,0,0,0,0
17088,1,0,88,0,-88
17089,0,0,10,0,-10
17090,1,1,629,1832,1203
17091,1,0,30,0,-30
17092,1,0,136,0,-136
17093,1,0,9,0,-9
17094,1,0,1,0,-1
17095,0,0,61,0,-61
17096,1,1,72,2261,2189
17097,1,0,33,0,-33
17098,1,1,240,1626,1386
17099,1,1,163,1270,1107
17100,1,1,353,1390,1037
17101,0,0,35,0,-35
17102,1,1,221,1232,1011
17103,0,0,49,0,-49
17104,1,0,46,0,-46
17105,0,0,134,0,-134
17106,1,1,323,1255,932
17107,0,0,52,0,-52
17108,1,1,69,1305,1236
17109,0,0,2,0,-2
17110,1,0,22,0,-22
17111,1,0,25,0,-25
17112,1,0,7,0,-7
17113,1,0,14,0,-14
17114,0,0,77,0,-77
17115,0,0,72,0,-72
17116,1,0,51,0,-51
17117,1,1,234,1310,1076
17118,1,0,1,0,-1
17119,0,0,200,0,-200
17120,0,0,1,0,-1
17121,0,0,0,0,0
17122,1,0,66,0,-66
17123,1,1,99,1320,1221
17124,1,1,19,1294,1275
17125,1,0,66,0,-66
17126,0,0,89,0,-89
17127,1,1,143,1436,1293
17128,1,1,245,2851,2606
17129,1,0,5,0,-5
17130,0,0,89,0,-89
17131,1,1,303,1450,1147
17132,0,0,6,0,-6
17133,0,0,18,0,-18
17134,1,1,269,1368,1099
17135,0,0,9,0,-9
17136,1,1,2165,1592,-573
17137,0,0,34,0,-34
17138,1,0,164,0,-164
17139,0,0,85,0,-85
17140,0,0,31,0,-31
17141,1,0,20,0,-20
17142,1,1,700,1391,691
17143,1,1,496,1224,728
17144,1,0,102,0,-102
17145,1,0,7,0,-7
17146,1,1,329,1989,1660
17147,1,1,205,1271,1066
17148,1,0,63,0,-63
17149,1,0,66,0,-66
17150,1,0,152,0,-152
17151,1,1,489,1493,1004
17152,1,0,88,0,-88
17153,1,1,605,1402,797
17154,0,0,9,0,-9
17155,1,1,151,1288,1137
17156,0,0,62,0,-62
17157,1,0,0,0,0
17158,0,0,24,0,-24
17159,1,0,11,0,-11
17160,0,0,19,0,-19
17161,0,0,24,0,-24
17162,1,0,108,0,-108
17163,0,0,31,0,-31
17164,1,1,183,1401,1218
17165,1,0,42,0,-42
17166,0,0,65,0,-65
17167,1,1,81,1291,1210
17168,1,1,703,1806,1103
17169,1,1,1407,1265,-142
17170,0,0,13,0,-13
17171,0,0,45,0,-45
17172,1,1,172,1829,1657
17173,0,0,250,0,-250
17174,1,1,266,1295,1029
17175,1,1,410,1220,810
17176,1,0,85,0,-85
17177,1,0,38,0,-38
17178,0,0,39,0,-39
17179,1,1,1431,1567,136
17180,0,0,212,0,-212
17181,0,0,8,0,-8
17182,0,0,110,0,-110
17183,1,0,57,0,-57
17184,1,0,42,0,-42
17185,1,0,57,0,-57
17186,1,1,1052,1608,556
17187,0,0,23,0,-23
17188,1,1,168,1284,1116
17189,0,0,93,0,-93
17190,1,1,158,1237,1079
17191,1,1,126,1434,1308
17192,1,1,32,1245,1213
17193,0,0,32,0,-32
17194,1,1,1124,1332,208
17195,1,0,59,0,-59
17196,1,1,311,1349,1038
17197,0,0,186,0,-186
17198,1,0,78,0,-78
17199,0,0,25,0,-25
17200,1,1,152,1612,1460
17201,0,0,42,0,-42
17202,1,1,927,1958,1031
17203,1,1,271,1213,942
17204,0,0,3,0,-3
17205,0,0,10,0,-10
17206,1,0,96,0,-96
17207,1,0,284,0,-284
17208,1,0,14,0,-14
17209,1,1,323,6740,6417
17210,1,1,254,1298,1044
17211,0,0,3,0,-3
17212,1,0,7,0,-7
17213,1,1,202,1633,1431
17214,0,0,6,0,-6
17215,1,1,264,1481,1217
17216,0,0,25,0,-25
17217,1,0,6,0,-6
17218,1,0,22,0,-22
17219,1,1,686,1482,796
17220,1,0,153,0,-153
17221,1,1,141,1424,1283
17222,0,0,52,0,-52
17223,0,0,1,0,-1
17224,1,0,55,0,-55
17225,1,0,20,0,-20
17226,1,0,27,0,-27
17227,0,0,22,0,-22
17228,1,1,1016,3245,2229
17229,1,0,8,0,-8
17230,1,0,33,0,-33
17231,1,0,27,0,-27
17232,1,0,19,0,-19
17233,1,1,186,1252,1066
17234,1,0,91,0,-91
17235,0,0,3,0,-3
17236,0,0,132,0,-132
17237,1,0,92,0,-92
17238,1,1,267,1705,1438
17239,1,1,133,1350,1217
17240,0,0,14,0,-14
17241,0,0,30,0,-30
17242,1,0,18,0,-18
17243,0,0,30,0,-30
17244,1,1,831,2094,1263
17245,1,0,79,0,-79
17246,0,0,68,0,-68
17247,1,0,29,0,-29
17248,0,0,69,0,-69
17249,1,0,4,0,-4
17250,1,1,191,1664,1473
17251,1,0,11,0,-11
17252,1,1,603,2150,1547
17253,0,0,7,0,-7
17254,1,1,2098,1992,-106
17255,0,0,17,0,-17
17256,1,0,46,0,-46
17257,1,0,38,0,-38
17258,1,0,67,0,-67
17259,1,1,114,1852,1738
17260,0,0,14,0,-14
17261,1,0,12,0,-12
17262,0,0,15,0,-15
17263,1,1,91,1743,1652
17264,0,0,13,0,-13
17265,1,0,44,0,-44
17266,1,1,18,1735,1717
17267,0,0,59,0,-59
17268,1,1,718,1292,574
17269,1,0,29,0,-29
17270,1,0,1,0,-1
17271,1,0,11,0,-11
17272,0,0,20,0,-20
17273,1,0,16,0,-16
17274,1,1,348,1215,867
17275,1,1,130,1437,1307
17276,1,0,42,0,-42
17277,1,1,301,1938,1637
17278,0,0,12,0,-12
17279,0,0,12,0,-12
17280,1,1,725,2603,1878
17281,1,1,139,1206,1067
17282,1,1,122,2757,2635
17283,0,0,109,0,-109
17284,1,1,363,1685,1322
17285,1,1,282,2188,1906
17286,0,0,40,0,-40
17287,1,1,193,1223,1030
17288,1,0,15,0,-15
17289,0,0,62,0,-62
17290,1,0,160,0,-160
17291,0,0,52,0,-52
17292,1,1,1169,1337,168
17293,0,0,16,0,-16
17294,1,1,691,1874,1183
17295,0,0,67,0,-67
17296,0,0,8,0,-8
17297,0,0,72,0,-72
17298,1,1,302,1430,1128
17299,1,1,340,2518,2178
17300,1,0,0,0,0
17301,1,0,44,0,-44
17302,1,1,1411,1285,-126
17303,1,0,0,0,0
17304,1,1,758,1316,558
17305,1,1,349,1951,1602
17306,1,0,36,0,-36
17307,1,1,280,1335,1055
17308,0,0,21,0,-21
17309,1,1,117,1767,1650
17310,1,1,265,1995,1730
17311,1,1,81,1672,1591
17312,0,0,46,0,-46
17313,1,1,316,1371,1055
17314,0,0,236,0,-236
17315,0,0,1,0,-1
17316,1,0,61,0,-61
17317,1,1,626,1300,674
17318,1,0,75,0,-75
17319,0,0,118,0,-118
17320,1,0,1,0,-1
17321,1,0,6,0,-6
17322,1,0,65,0,-65
17323,1,0,77,0,-77
17324,0,0,4,0,-4
17325,1,0,31,0,-31
17326,1,0,3,0,-3
17327,1,1,609,2758,2149
17328,0,0,98,0,-98
17329,1,0,92,0,-92
17330,1,1,706,1204,498
17331,1,0,18,0,-18
17332,1,0,5,0,-5
17333,1,0,69,0,-69
17334,1,1,215,1882,1667
17335,0,0,171,0,-171
17336,1,1,115,2765,2650
17337,1,0,44,0,-44
17338,0,0,37,0,-37
17339,0,0,113,0,-113
17340,1,1,2167,1554,-613
17341,0,0,152,0,-152
17342,1,0,50,0,-50
17343,1,1,387,1247,860
17344,0,0,17,0,-17
17345,1,1,651,1993,1342
17346,1,1,756,1205,449
17347,0,0,25,0,-25
17348,1,0,35,0,-35
17349,0,0,15,0,-15
17350,0,0,156,0,-156
17351,0,0,19,0,-19
17352,1,1,745,1755,1010
17353,1,0,66,0,-66
17354,1,1,237,2777,2540
17355,0,0,29,0,-29
17356,1,1,48,1263,1215
17357,1,0,1,0,-1
17358,1,0,33,0,-33
17359,1,0,10,0,-10
17360,1,1,276,1452,1176
17361,0,0,23,0,-23
17362,0,0,139,0,-139
17363,0,0,81,0,-81
17364,0,0,45,0,-45
17365,0,0,11,0,-11
17366,1,1,737,1428,691
17367,0,0,55,0,-55
17368,1,1,153,2249,2096
17369,1,0,67,0,-67
17370,0,0,5,0,-5
17371,1,0,66,0,-66
17372,1,1,553,1305,752
17373,1,0,36,0,-36
17374,1,1,819,1685,866
17375,0,0,359,0,-359
17376,0,0,20,0,-20
17377,0,0,26,0,-26
17378,0,0,195,0,-195
17379,0,0,43,0,-43
17380,1,1,1112,2563,1451
17381,0,0,94,0,-94
17382,1,0,4,0,-4
17383,0,0,16,0,-16
17384,1,1,1146,1231,85
17385,1,0,27,0,-27
17386,0,0,15,0,-15
17387,0,0,41,0,-41
17388,1,1,220,1207,987
17389,1,1,1378,1545,167
17390,0,0,157,0,-157
17391,1,0,27,0,-27
17392,1,0,108,0,-108
17393,0,0,35,0,-35
17394,1,1,543,1454,911
17395,1,1,17,1206,1189
17396,0,0,198,0,-198
17397,0,0,112,0,-112
17398,1,0,14,0,-14
17399,0,0,4,0,-4
17400,1,1,267,1566,1299
17401,1,1,446,1421,975
17402,1,1,101,1683,1582
17403,0,0,16,0,-16
17404,0,0,23,0,-23
17405,1,0,25,0,-25
17406,1,1,216,1250,1034
17407,1,0,4,0,-4
17408,1,0,64,0,-64
17409,1,1,292,1200,908
17410,1,0,23,0,-23
17411,1,1,236,1366,1130
17412,0,0,85,0,-85
17413,1,1,423,1802,1379
17414,1,0,108,0,-108
17415,1,0,37,0,-37
17416,1,1,472,1798,1326
17417,1,1,359,1554,1195
17418,1,0,5,0,-5
17419,0,0,104,0,-104
17420,1,0,8,0,-8
17421,0,0,14,0,-14
17422,0,0,81,0,-81
17423,1,1,114,3076,2962
17424,1,0,91,0,-91
17425,1,1,413,1675,1262
17426,0,0,48,0,-48
17427,0,0,44,0,-44
17428,1,1,349,1225,876
17429,0,0,28,0,-28
17430,1,0,23,0,-23
17431,1,1,161,1658,1497
17432,1,1,845,1464,619
17433,0,0,11,0,-11
17434,1,1,353,1226,873
17435,0,0,18,0,-18
17436,0,0,4,0,-4
17437,0,0,12,0,-12
17438,0,0,41,0,-41
17439,1,1,95,1407,1312
17440,1,1,209,2645,2436
17441,1,1,262,1742,1480
17442,0,0,20,0,-20
17443,0,0,34,0,-34
17444,1,0,4,0,-4
17445,1,1,149,1454,1305
17446,1,0,13,0,-13
17447,1,1,46,1523,1477
17448,1,1,67,1379,1312
17449,1,0,11,0,-11
17450,0,0,94,0,-94
17451,0,0,9,0,-9
17452,0,0,54,0,-54
17453,0,0,12,0,-12
17454,1,1,345,1450,1105
17455,1,0,60,0,-60
17456,1,1,59,1414,1355
17457,1,1,132,2915,2783
17458,0,0,13,0,-13
17459,0,0,46,0,-46
17460,1,1,97,1962,1865
17461,1,1,545,1225,680
17462,1,0,10,0,-10
17463,1,0,39,0,-39
17464,0,0,23,0,-23
17465,1,1,153,1279,1126
17466,0,0,2,0,-2
17467,0,0,27,0,-27
17468,0,0,240,0,-240
17469,1,0,30,0,-30
17470,0,0,57,0,-57
17471,0,0,1,0,-1
17472,0,0,152,0,-152
17473,1,0,5,0,-5
17474,1,1,405,1314,909
17475,1,1,1910,1248,-662
17476,0,0,21,0,-21
17477,1,0,64,0,-64
17478,0,0,41,0,-41
17479,1,1,206,1383,1177
17480,1,1,229,1401,1172
17481,1,1,583,1352,769
17482,1,0,115,0,-115
17483,1,0,90,0,-90
17484,1,0,22,0,-22
17485,1,1,608,1286,678
17486,0,0,29,0,-29
17487,1,1,1446,1242,-204
17488,0,0,19,0,-19
17489,1,0,2,0,-2
17490,0,0,7,0,-7
17491,1,1,1421,1307,-114
17492,1,0,2,0,-2
17493,1,0,16,0,-16
17494,1,1,494,2117,1623
17495,1,0,1,0,-1
17496,1,1,226,1394,1168
17497,1,1,280,2025,1745
17498,0,0,20,0,-20
17499,1,0,25,0,-25
17500,1,0,63,0,-63
17501,1,1,377,2554,2177
17502,0,0,26,0,-26
17503,0,0,2,0,-2
17504,0,0,62,0,-62
17505,1,0,14,0,-14
17506,1,0,44,0,-44
17507,1,1,689,1584,895
17508,1,1,456,1284,828
17509,0,0,229,0,-229
17510,0,0,6,0,-6
17511,1,0,17,0,-17
17512,0,0,77,0,-77
17513,1,0,10,0,-10
17514,1,1,160,1420,1260
17515,1,0,84,0,-84
17516,1,1,179,1822,1643
17517,0,0,47,0,-47
17518,1,1,746,1345,599
17519,1,0,71,0,-71
17520,1,1,98,1242,1144
17521,0,0,7,0,-7
17522,0,0,72,0,-72
17523,0,0,59,0,-59
17524,1,0,39,0,-39
17525,1,0,61,0,-61
17526,1,1,447,1468,1021
17527,0,0,78,0,-78
17528,1,1,259,1325,1066
17529,0,0,18,0,-18
17530,0,0,14,0,-14
17531,1,0,52,0,-52
17532,1,1,1594,1304,-290
17533,0,0,40,0,-40
17534,1,0,11,0,-11
17535,1,1,295,1203,908
17536,0,0,59,0,-59
17537,0,0,8,0,-8
17538,0,0,67,0,-67
17539,0,0,114,0,-114
17540,0,0,23,0,-23
17541,1,1,345,1263,918
17542,1,0,13,0,-13
17543,1,0,59,0,-59
17544,1,0,98,0,-98
17545,0,0,39,0,-39
17546,1,1,15,1231,1216
17547,1,0,58,0,-58
17548,1,1,344,1266,922
17549,1,1,154,1633,1479
17550,0,0,39,0,-39
17551,1,0,2,0,-2
17552,1,1,155,2747,2592
17553,1,1,429,1262,833
17554,1,0,64,0,-64
17555,1,1,1304,1641,337
17556,0,0,67,0,-67
17557,1,0,19,0,-19
17558,1,1,389,1347,958
17559,0,0,68,0,-68
17560,1,0,85,0,-85
17561,1,0,24,0,-24
17562,1,1,68,1552,1484
17563,1,0,59,0,-59
17564,1,0,8,0,-8
17565,1,0,47,0,-47
17566,0,0,66,0,-66
17567,0,0,19,0,-19
17568,1,1,232,1434,1202
17569,1,1,541,1590,1049
17570,1,1,4224,1338,-2886
17571,1,0,11,0,-11
17572,1,1,275,1235,960
17573,1,0,17,0,-17
17574,1,1,132,1247,1115
17575,1,0,51,0,-51
17576,0,0,43,0,-43
17577,0,0,39,0,-39
17578,0,0,20,0,-20
17579,1,1,78,1237,1159
17580,1,0,14,0,-14
17581,0,0,31,0,-31
17582,1,0,181,0,-181
17583,1,1,885,1242,357
17584,1,1,614,1662,1048
17585,1,0,12,0,-12
17586,1,0,1,0,-1
17587,1,0,32,0,-32
17588,0,0,4,0,-4
17589,1,0,53,0,-53
17590,1,1,1369,2353,984
17591,0,0,37,0,-37
17592,1,0,51,0,-51
17593,0,0,109,0,-109
17594,1,1,488,1480,992
17595,1,1,519,1359,840
17596,1,1,2664,1362,-1302
17597,1,0,101,0,-101
17598,0,0,35,0,-35
17599,1,0,9,0,-9
17600,1,0,40,0,-40
17601,0,0,34,0,-34
17602,0,0,95,0,-95
17603,1,1,148,1275,1127
17604,1,0,16,0,-16
17605,1,0,75,0,-75
17606,0,0,28,0,-28
17607,1,1,126,1340,1214
17608,0,0,9,0,-9
17609,1,0,13,0,-13
17610,0,0,6,0,-6
17611,1,0,15,0,-15
17612,0,0,24,0,-24
17613,0,0,297,0,-297
17614,1,1,2089,1323,-766
17615,0,0,72,0,-72
17616,1,1,152,1855,1703
17617,1,0,74,0,-74
17618,1,1,250,1462,1212
17619,0,0,33,0,-33
17620,1,1,137,1479,1342
17621,1,1,1556,1422,-134
17622,1,0,99,0,-99
17623,0,0,0,0,0
17624,1,1,659,1539,880
17625,1,1,61,1273,1212
17626,0,0,24,0,-24
17627,0,0,93,0,-93
17628,0,0,154,0,-154
17629,1,0,3,0,-3
17630,1,1,262,1299,1037
17631,0,0,56,0,-56
17632,0,0,98,0,-98
17633,0,0,82,0,-82
17634,0,0,1,0,-1
17635,0,0,73,0,-73
17636,1,0,255,0,-255
17637,1,0,11,0,-11
17638,1,1,782,1465,683
17639,1,0,97,0,-97
17640,0,0,4,0,-4
17641,0,0,146,0,-146
17642,0,0,49,0,-49
17643,0,0,43,0,-43
17644,0,0,50,0,-50
17645,0,0,0,0,0
17646,0,0,18,0,-18
17647,0,0,104,0,-104
17648,1,0,23,0,-23
17649,0,0,1,0,-1
17650,1,1,1750,1393,-357
17651,0,0,96,0,-96
17652,1,0,65,0,-65
17653,1,0,62,0,-62
17654,1,0,95,0,-95
17655,1,0,2,0,-2
17656,1,1,723,1319,596
17657,1,0,90,0,-90
17658,0,0,46,0,-46
17659,0,0,4,0,-4
17660,1,0,40,0,-40
17661,0,0,70,0,-70
17662,1,0,29,0,-29
17663,1,1,1067,1334,267
17664,1,1,297,1490,1193
17665,1,1,565,1221,656
17666,0,0,2,0,-2
17667,1,0,56,0,-56
17668,0,0,2,0,-2
17669,0,0,21,0,-21
17670,1,1,96,1949,1853
17671,1,1,448,1508,1060
17672,1,0,9,0,-9
17673,0,0,92,0,-92
17674,1,0,1,0,-1
17675,0,0,36,0,-36
17676,0,0,56,0,-56
17677,1,0,1,0,-1
17678,1,1,325,2022,1697
17679,0,0,15,0,-15
17680,0,0,42,0,-42
17681,1,1,618,1329,711
17682,1,0,20,0,-20
17683,1,0,4,0,-4
17684,1,1,549,1934,1385
17685,0,0,0,0,0
17686,0,0,20,0,-20
17687,1,1,782,1471,689
17688,0,0,4,0,-4
17689,1,0,102,0,-102
17690,1,0,334,0,-334
17691,1,0,58,0,-58
17692,1,0,135,0,-135
17693,0,0,19,0,-19
17694,1,1,1034,1754,720
17695,0,0,68,0,-68
17696,1,1,418,1209,791
17697,0,0,33,0,-33
17698,0,0,19,0,-19
17699,1,0,6,0,-6
17700,0,0,22,0,-22
17701,1,1,111,1450,1339
17702,1,0,33,0,-33
17703,1,1,377,1509,1132
17704,1,1,2062,2842,780
17705,1,1,220,1644,1424
17706,1,1,285,1405,1120
17707,0,0,2,0,-2
17708,0,0,6,0,-6
17709,0,0,11,0,-11
17710,0,0,5,0,-5
17711,0,0,100,0,-100
17712,0,0,0,0,0
17713,0,0,37,0,-37
17714,1,0,72,0,-72
17715,0,0,87,0,-87
17716,0,0,90,0,-90
17717,1,1,1486,1904,418
17718,1,1,1261,1237,-24
17719,1,0,91,0,-91
17720,1,0,25,0,-25
17721,0,0,56,0,-56
17722,1,0,44,0,-44
17723,0,0,269,0,-269
17724,1,0,8,0,-8
17725,0,0,71,0,-71
17726,0,0,45,0,-45
17727,0,0,58,0,-58
17728,0,0,39,0,-39
17729,0,0,61,0,-61
17730,0,0,23,0,-23
17731,1,1,88,2289,2201
17732,1,0,12,0,-12
17733,1,1,384,1593,1209
17734,1,0,37,0,-37
17735,0,0,3,0,-3
17736,1,0,18,0,-18
17737,1,1,1929,1347,-582
17738,1,1,119,1215,1096
17739,1,1,230,2154,1924
17740,1,1,961,1524,563
17741,1,1,143,1247,1104
17742,1,1,1059,1376,317
17743,1,0,77,0,-77
17744,1,1,226,1239,1013
17745,0,0,97,0,-97
17746,1,0,21,0,-21
17747,0,0,97,0,-97
17748,1,0,5,0,-5
17749,1,0,0,0,0
17750,1,1,508,1212,704
17751,1,1,200,1996,1796
17752,0,0,28,0,-28
17753,0,0,16,0,-16
17754,1,0,14,0,-14
17755,0,0,8,0,-8
17756,1,0,29,0,-29
17757,1,0,14,0,-14
17758,1,1,2132,1609,-523
17759,1,1,683,1339,656
17760,1,1,77,1930,1853
17761,1,0,187,0,-187
17762,1,1,2068,1530,-538
17763,1,0,45,0,-45
17764,1,1,426,1260,834
17765,1,0,45,0,-45
17766,1,0,108,0,-108
17767,1,1,394,2075,1681
17768,0,0,53,0,-53
17769,1,1,150,1389,1239
17770,1,1,595,2080,1485
17771,1,0,66,0,-66
17772,1,0,21,0,-21
17773,0,0,62,0,-62
17774,1,1,272,1716,1444
17775,0,0,57,0,-57
17776,1,1,411,1209,798
17777,1,0,71,0,-71
17778,0,0,49,0,-49
17779,1,1,429,1826,1397
17780,1,1,613,2369,1756
17781,0,0,134,0,-134
17782,0,0,7,0,-7
17783,1,1,997,1337,340
17784,1,0,6,0,-6
17785,1,0,65,0,-65
17786,1,0,4,0,-4
17787,1,1,968,1470,502
17788,1,1,223,1729,1506
17789,1,1,1112,2046,934
17790,0,0,13,0,-13
17791,0,0,12,0,-12
17792,1,0,26,0,-26
17793,1,0,101,0,-101
17794,1,0,28,0,-28
17795,1,1,635,1798,1163
17796,1,0,3,0,-3
17797,1,1,278,1667,1389
17798,1,0,77,0,-77
17799,0,0,13,0,-13
17800,1,1,281,1244,963
17801,0,0,158,0,-158
17802,1,1,1594,1274,-320
17803,1,1,559,1553,994
17804,0,0,35,0,-35
17805,0,0,74,0,-74
17806,1,0,31,0,-31
17807,1,1,1015,1501,486
17808,1,1,2905,3613,708
17809,1,1,511,1422,911
17810,1,0,30,0,-30
17811,1,1,355,1999,1644
17812,1,1,546,1284,738
17813,0,0,80,0,-80
17814,0,0,8,0,-8
17815,0,0,8,0,-8
17816,1,1,831,1448,617
17817,0,0,38,0,-38
17818,1,0,33,0,-33
17819,1,0,150,0,-150
17820,1,1,166,1213,1047
17821,0,0,35,0,-35
17822,0,0,101,0,-101
17823,1,0,22,0,-22
17824,1,0,28,0,-28
17825,1,0,6,0,-6
17826,0,0,13,0,-13
17827,0,0,191,0,-191
17828,1,0,40,0,-40
17829,1,1,273,1414,1141
17830,1,0,0,0,0
17831,0,0,66,0,-66
17832,1,0,26,0,-26
17833,1,0,98,0,-98
17834,1,1,598,1247,649
17835,0,0,140,0,-140
17836,1,0,80,0,-80
17837,1,0,49,0,-49
17838,1,0,113,0,-113
17839,0,0,89,0,-89
17840,1,1,523,2570,2047
17841,1,1,635,1474,839
17842,1,1,163,1298,1135
17843,1,0,7,0,-7
17844,0,0,41,0,-41
17845,1,1,1532,1360,-172
17846,1,0,11,0,-11
17847,1,0,59,0,-59
17848,0,0,31,0,-31
17849,0,0,37,0,-37
17850,0,0,4,0,-4
17851,0,0,102,0,-102
17852,1,1,884,1237,353
17853,1,0,29,0,-29
17854,1,0,43,0,-43
17855,1,1,382,1477,1095
17856,0,0,56,0,-56
17857,1,1,98,2812,2714
17858,1,0,31,0,-31
17859,0,0,37,0,-37
17860,0,0,77,0,-77
17861,1,1,447,1277,830
17862,0,0,147,0,-147
17863,1,0,59,0,-59
17864,1,0,58,0,-58
17865,1,0,168,0,-168
17866,0,0,3,0,-3
17867,0,0,16,0,-16
17868,0,0,7,0,-7
17869,1,0,43,0,-43
17870,0,0,71,0,-71
17871,0,0,79,0,-79
17872,0,0,84,0,-84
17873,1,0,24,0,-24
17874,1,1,210,2461,2251
17875,0,0,22,0,-22
17876,0,0,32,0,-32
17877,1,0,57,0,-57
17878,0,0,52,0,-52
17879,0,0,48,0,-48
17880,1,1,93,1963,1870
17881,1,1,1195,2061,866
17882,1,1,404,1279,875
17883,1,0,15,0,-15
17884,0,0,16,0,-16
17885,0,0,104,0,-104
17886,1,0,2,0,-2
17887,1,0,58,0,-58
17888,0,0,1,0,-1
17889,1,0,14,0,-14
17890,0,0,9,0,-9
17891,0,0,111,0,-111
17892,1,1,159,3516,3357
17893,1,0,4,0,-4
17894,1,0,38,0,-38
17895,1,1,276,2760,2484
17896,1,0,98,0,-98
17897,1,1,853,1308,455
17898,0,0,94,0,-94
17899,1,0,34,0,-34
17900,0,0,41,0,-41
17901,0,0,23,0,-23
17902,1,1,962,2827,1865
17903,1,1,710,1573,863
17904,1,1,834,1542,708
17905,0,0,136,0,-136
17906,1,0,18,0,-18
17907,0,0,27,0,-27
17908,1,1,40,2832,2792
17909,0,0,160,0,-160
17910,1,1,845,1645,800
17911,0,0,45,0,-45
17912,0,0,111,0,-111
17913,1,1,95,1238,1143
17914,0,0,61,0,-61
17915,0,0,31,0,-31
17916,1,0,40,0,-40
17917,0,0,78,0,-78
17918,0,0,79,0,-79
17919,0,0,121,0,-121
17920,1,1,716,1216,500
17921,1,1,361,1257,896
17922,0,0,72,0,-72
17923,1,0,4,0,-4
17924,0,0,63,0,-63
17925,0,0,84,0,-84
17926,1,0,16,0,-16
17927,1,1,42,1407,1365
17928,1,0,19,0,-19
17929,1,0,85,0,-85
17930,0,0,50,0,-50
17931,1,1,1471,1706,235
17932,0,0,19,0,-19
17933,0,0,0,0,0
17934,1,1,59,1354,1295
17935,1,1,955,1245,290
17936,1,1,1380,1279,-101
17937,1,0,36,0,-36
17938,0,0,28,0,-28
17939,0,0,64,0,-64
17940,1,1,190,1765,1575
17941,1,0,198,0,-198
17942,1,1,130,1270,1140
17943,0,0,34,0,-34
17944,1,1,1073,1543,470
17945,1,0,71,0,-71
17946,0,0,35,0,-35
17947,1,1,287,1212,925
17948,0,0,145,0,-145
17949,0,0,85,0,-85
17950,1,0,0,0,0
17951,1,0,71,0,-71
17952,1,1,474,1283,809
17953,1,0,33,0,-33
17954,0,0,32,0,-32
17955,1,1,909,1517,608
17956,1,0,3,0,-3
17957,1,0,0,0,0
17958,0,0,3,0,-3
17959,1,1,96,1239,1143
17960,1,1,379,1555,1176
17961,0,0,94,0,-94
17962,0,0,67,0,-67
17963,1,1,448,1405,957
17964,1,0,80,0,-80
17965,1,1,202,1468,1266
17966,0,0,44,0,-44
17967,1,0,14,0,-14
17968,1,1,524,1212,688
17969,0,0,148,0,-148
17970,1,0,7,0,-7
17971,1,1,107,1390,1283
17972,1,1,87,1239,1152
17973,1,1,512,1209,697
17974,1,0,13,0,-13
17975,1,0,6,0,-6
17976,0,0,35,0,-35
17977,1,0,21,0,-21
17978,0,0,84,0,-84
17979,0,0,8,0,-8
17980,1,1,741,1320,579
17981,1,0,71,0,-71
17982,0,0,51,0,-51
17983,1,1,1898,1477,-421
17984,0,0,34,0,-34
17985,0,0,19,0,-19
17986,1,0,79,0,-79
17987,1,0,1,0,-1
17988,1,0,46,0,-46
17989,0,0,39,0,-39
17990,1,1,67,1444,1377
17991,1,0,128,0,-128
17992,1,1,554,1305,751
17993,0,0,35,0,-35
17994,0,0,3,0,-3
17995,0,0,26,0,-26
17996,0,0,8,0,-8
17997,1,0,140,0,-140
17998,1,0,1,0,-1
17999,1,0,106,0,-106
18000,1,0,167,0,-167
18001,1,0,4,0,-4
18002,0,0,10,0,-10
18003,1,0,69,0,-69
18004,0,0,141,0,-141
18005,1,1,1510,1545,35
18006,0,0,6,0,-6
18007,0,0,163,0,-163
18008,1,0,43,0,-43
18009,1,0,111,0,-111
18010,1,1,125,1217,1092
18011,0,0,105,0,-105
18012,0,0,17,0,-17
18013,1,0,18,0,-18
18014,1,1,384,1740,1356
18015,1,1,962,1322,360
18016,1,0,36,0,-36
18017,1,1,47,1344,1297
18018,1,1,919,1306,387
18019,0,0,51,0,-51
18020,0,0,68,0,-68
18021,0,0,1,0,-1
18022,1,1,676,1224,548
18023,1,0,17,0,-17
18024,0,0,36,0,-36
18025,0,0,41,0,-41
18026,1,1,88,1506,1418
18027,1,1,144,1239,1095
18028,1,1,140,1215,1075
18029,1,0,103,0,-103
18030,1,0,84,0,-84
18031,0,0,23,0,-23
18032,0,0,17,0,-17
18033,0,0,26,0,-26
18034,1,1,47,1628,1581
18035,0,0,1,0,-1
18036,0,0,158,0,-158
18037,1,1,415,1222,807
18038,1,0,42,0,-42
18039,1,0,45,0,-45
18040,1,0,112,0,-112
18041,0,0,117,0,-117
18042,0,0,110,0,-110
18043,0,0,0,0,0
18044,0,0,10,0,-10
18045,1,1,155,1360,1205
18046,1,1,447,1766,1319
18047,1,1,559,1292,733
18048,1,0,6,0,-6
18049,1,1,70,1200,1130
18050,1,0,11,0,-11
18051,0,0,81,0,-81
18052,1,1,601,1997,1396
18053,1,0,2,0,-2
18054,0,0,147,0,-147
18055,0,0,54,0,-54
18056,1,0,136,0,-136
18057,0,0,37,0,-37
18058,0,0,22,0,-22
18059,0,0,49,0,-49
18060,0,0,143,0,-143
18061,1,1,1171,1466,295
18062,1,0,123,0,-123
18063,0,0,128,0,-128
18064,1,1,602,1990,1388
18065,0,0,70,0,-70
18066,1,0,123,0,-123
18067,1,1,604,1314,710
18068,0,0,5,0,-5
18069,0,0,6,0,-6
18070,1,1,444,1970,1526
18071,1,0,24,0,-24
18072,0,0,21,0,-21
18073,1,0,26,0,-26
18074,0,0,83,0,-83
18075,1,0,63,0,-63
18076,1,0,8,0,-8
18077,0,0,54,0,-54
18078,1,0,4,0,-4
18079,1,0,80,0,-80
18080,1,0,34,0,-34
18081,0,0,68,0,-68
18082,0,0,81,0,-81
18083,1,1,272,1220,948
18084,1,1,1117,1455,338
18085,0,0,30,0,-30
18086,1,0,0,0,0
18087,1,1,941,1226,285
18088,0,0,8,0,-8
18089,0,0,3,0,-3
18090,0,0,14,0,-14
18091,0,0,144,0,-144
18092,0,0,19,0,-19
18093,1,0,43,0,-43
18094,1,0,10,0,-10
18095,0,0,53,0,-53
18096,1,0,28,0,-28
18097,1,1,111,1323,1212
18098,1,0,50,0,-50
18099,0,0,34,0,-34
18100,1,0,60,0,-60
18101,1,0,13,0,-13
18102,0,0,112,0,-112
18103,1,1,1753,1279,-474
18104,0,0,16,0,-16
18105,1,1,523,1209,686
18106,1,1,176,1807,1631
18107,0,0,60,0,-60
18108,0,0,39,0,-39
18109,1,1,181,1385,1204
18110,0,0,9,0,-9
18111,0,0,92,0,-92
18112,0,0,4,0,-4
18113,0,0,0,0,0
18114,1,0,1,0,-1
18115,1,0,57,0,-57
18116,1,0,13,0,-13
18117,0,0,84,0,-84
18118,0,0,24,0,-24
18119,0,0,15,0,-15
18120,0,0,41,0,-41
18121,1,1,470,1367,897
18122,1,0,21,0,-21
18123,0,0,56,0,-56
18124,1,1,221,1209,988
18125,0,0,133,0,-133
18126,1,1,233,1213,980
18127,0,0,22,0,-22
18128,1,0,39,0,-39
18129,1,1,76,1392,1316
18130,1,0,44,0,-44
18131,0,0,36,0,-36
18132,1,1,298,2073,1775
18133,1,1,1492,1216,-276
18134,1,1,293,1695,1402
18135,0,0,45,0,-45
18136,1,1,70,1242,1172
18137,1,1,29,1353,1324
18138,1,1,936,1245,309
18139,0,0,26,0,-26
18140,0,0,4,0,-4
18141,1,1,307,1241,934
18142,1,0,39,0,-39
18143,1,0,72,0,-72
18144,1,1,118,1380,1262
18145,1,1,363,1504,1141
18146,1,0,105,0,-105
18147,0,0,109,0,-109
18148,0,0,41,0,-41
18149,0,0,33,0,-33
18150,1,0,12,0,-12
18151,0,0,107,0,-107
18152,0,0,17,0,-17
18153,1,1,94,1739,1645
18154,0,0,130,0,-130
18155,0,0,6,0,-6
18156,1,1,87,1384,1297
18157,1,0,62,0,-62
18158,1,1,284,1376,1092
18159,1,1,435,1341,906
18160,1,0,32,0,-32
18161,1,1,1323,1384,61
18162,0,0,173,0,-173
18163,1,0,3,0,-3
18164,1,0,12,0,-12
18165,1,0,19,0,-19
18166,1,1,451,2151,1700
18167,0,0,80,0,-80
18168,0,0,23,0,-23
18169,1,1,50,5146,5096
18170,0,0,15,0,-15
18171,1,1,50,1329,1279
18172,1,0,18,0,-18
18173,1,1,24,1382,1358
18174,1,1,214,1286,1072
18175,1,0,88,0,-88
18176,1,0,81,0,-81
18177,1,1,361,1397,1036
18178,1,0,3,0,-3
18179,1,1,339,1321,982
18180,0,0,162,0,-162
18181,1,0,1,0,-1
18182,1,0,34,0,-34
18183,1,1,131,1355,1224
18184,1,1,436,2270,1834
18185,1,0,45,0,-45
18186,0,0,7,0,-7
18187,1,0,42,0,-42
18188,0,0,14,0,-14
18189,0,0,154,0,-154
18190,1,1,137,1381,1244
18191,0,0,28,0,-28
18192,1,0,39,0,-39
18193,1,1,62,1279,1217
18194,0,0,42,0,-42
18195,0,0,35,0,-35
18196,1,0,69,0,-69
18197,1,0,10,0,-10
18198,0,0,131,0,-131
18199,1,0,68,0,-68
18200,1,1,1267,1936,669
18201,0,0,6,0,-6
18202,0,0,28,0,-28
18203,1,0,92,0,-92
18204,1,1,496,1306,810
18205,1,1,376,1255,879
18206,1,1,814,1367,553
18207,1,0,33,0,-33
18208,1,1,1318,2216,898
18209,0,0,106,0,-106
18210,0,0,31,0,-31
18211,0,0,39,0,-39
18212,1,0,7,0,-7
18213,1,0,16,0,-16
18214,1,1,917,1671,754
18215,1,0,9,0,-9
18216,1,1,3424,1733,-1691
18217,0,0,53,0,-53
18218,0,0,52,0,-52
18219,1,1,887,1346,459
18220,0,0,106,0,-106
18221,1,0,14,0,-14
18222,0,0,25,0,-25
18223,0,0,37,0,-37
18224,1,0,2,0,-2
18225,1,0,52,0,-52
18226,0,0,59,0,-59
18227,0,0,42,0,-42
18228,1,1,192,1321,1129
18229,1,0,91,0,-91
18230,1,1,571,1202,631
18231,1,1,464,1346,882
18232,0,0,40,0,-40
18233,1,1,178,1311,1133
18234,1,0,27,0,-27
18235,1,0,5,0,-5
18236,0,0,46,0,-46
18237,0,0,161,0,-161
18238,0,0,67,0,-67
18239,1,1,139,2332,2193
18240,0,0,31,0,-31
18241,0,0,111,0,-111
18242,1,0,29,0,-29
18243,0,0,38,0,-38
18244,1,1,225,1377,1152
18245,0,0,21,0,-21
18246,0,0,7,0,-7
18247,1,1,1137,1210,73
18248,0,0,51,0,-51
18249,1,0,66,0,-66
18250,0,0,11,0,-11
18251,1,0,10,0,-10
18252,1,0,99,0,-99
18253,1,1,489,2104,1615
18254,0,0,16,0,-16
18255,1,1,279,1242,963
18256,0,0,12,0,-12
18257,0,0,16,0,-16
18258,1,0,26,0,-26
18259,1,0,54,0,-54
18260,1,1,194,2457,2263
18261,1,0,20,0,-20
18262,0,0,104,0,-104
18263,1,0,127,0,-127
18264,0,0,126,0,-126
18265,1,0,15,0,-15
18266,0,0,2,0,-2
18267,0,0,0,0,0
18268,1,0,59,0,-59
18269,1,1,151,1704,1553
18270,1,0,72,0,-72
18271,0,0,1,0,-1
18272,0,0,28,0,-28
18273,1,0,95,0,-95
18274,1,1,376,1313,937
18275,1,0,12,0,-12
18276,1,0,9,0,-9
18277,1,0,83,0,-83
18278,1,1,367,2188,1821
18279,0,0,11,0,-11
18280,0,0,4,0,-4
18281,1,0,147,0,-147
18282,1,1,1144,1416,272
18283,1,0,199,0,-199
18284,1,0,188,0,-188
18285,0,0,12,0,-12
18286,0,0,16,0,-16
18287,0,0,32,0,-32
18288,1,0,7,0,-7
18289,1,1,129,2476,2347
18290,1,1,565,1252,687
18291,1,0,83,0,-83
18292,0,0,58,0,-58
18293,1,0,47,0,-47
18294,0,0,27,0,-27
18295,1,0,2,0,-2
18296,1,0,9,0,-9
18297,0,0,86,0,-86
18298,1,1,840,1214,374
18299,1,1,961,1677,716
18300,1,1,632,1209,577
18301,1,0,28,0,-28
18302,0,0,113,0,-113
18303,1,1,396,1339,943
18304,0,0,7,0,-7
18305,1,1,218,3191,2973
18306,1,1,80,1228,1148
18307,0,0,14,0,-14
18308,1,1,17,2042,2025
18309,1,0,39,0,-39
18310,1,0,0,0,0
18311,1,1,343,1808,1465
18312,1,1,164,1874,1710
18313,1,1,642,1214,572
18314,1,0,80,0,-80
18315,1,0,37,0,-37
18316,0,0,2,0,-2
18317,1,0,75,0,-75
18318,1,0,136,0,-136
18319,1,0,34,0,-34
18320,0,0,1,0,-1
18321,1,0,4,0,-4
18322,0,0,18,0,-18
18323,0,0,54,0,-54
18324,1,1,1724,2017,293
18325,1,1,39,1694,1655
18326,0,0,12,0,-12
18327,1,1,222,1216,994
18328,0,0,42,0,-42
18329,1,1,230,1249,1019
18330,1,0,24,0,-24
18331,1,1,736,1217,481
18332,0,0,17,0,-17
18333,1,1,803,1263,460
18334,0,0,4,0,-4
18335,0,0,3,0,-3
18336,1,0,108,0,-108
18337,1,1,352,1302,950
18338,0,0,21,0,-21
18339,0,0,12,0,-12
18340,1,0,62,0,-62
18341,0,0,6,0,-6
18342,1,1,547,1572,1025
18343,0,0,7,0,-7
18344,0,0,8,0,-8
18345,1,0,96,0,-96
18346,1,1,633,2461,1828
18347,1,0,26,0,-26
18348,1,0,64,0,-64
18349,1,1,602,1206,604
18350,0,0,32,0,-32
18351,0,0,10,0,-10
18352,1,0,76,0,-76
18353,0,0,113,0,-113
18354,1,0,8,0,-8
18355,0,0,14,0,-14
18356,1,1,678,1271,593
18357,0,0,42,0,-42
18358,0,0,43,0,-43
18359,1,0,9,0,-9
18360,0,0,21,0,-21
18361,1,0,87,0,-87
18362,0,0,33,0,-33
18363,0,0,18,0,-18
18364,1,0,10,0,-10
18365,0,0,302,0,-302
18366,0,0,351,0,-351
18367,0,0,36,0,-36
18368,0,0,38,0,-38
18369,0,0,100,0,-100
18370,1,1,260,1462,1202
18371,1,1,179,1306,1127
18372,1,1,859,1376,517
18373,1,0,26,0,-26
18374,0,0,30,0,-30
18375,1,0,75,0,-75
18376,1,0,43,0,-43
18377,1,1,1293,1319,26
18378,1,0,135,0,-135
18379,1,0,6,0,-6
18380,1,0,105,0,-105
18381,0,0,201,0,-201
18382,0,0,123,0,-123
18383,1,0,6,0,-6
18384,1,1,344,1374,1030
18385,1,0,91,0,-91
18386,1,0,134,0,-134
18387,1,1,529,1312,783
18388,1,0,23,0,-23
18389,1,1,647,1785,1138
18390,1,0,3,0,-3
18391,1,1,50,1246,1196
18392,1,1,7,1994,1987
18393,1,0,7,0,-7
18394,1,1,313,1968,1655
18395,1,1,582,1349,767
18396,1,1,328,1662,1334
18397,1,1,772,1222,450
18398,1,0,2,0,-2
18399,1,0,54,0,-54
18400,1,0,51,0,-51
18401,1,0,19,0,-19
18402,1,0,45,0,-45
18403,1,0,137,0,-137
18404,0,0,11,0,-11
18405,1,1,276,1362,1086
18406,0,0,37,0,-37
18407,1,0,44,0,-44
18408,0,0,7,0,-7
18409,0,0,106,0,-106
18410,1,1,425,1213,788
18411,1,0,71,0,-71
18412,1,1,583,1437,854
18413,1,1,1221,1723,502
18414,0,0,50,0,-50
18415,0,0,1,0,-1
18416,1,1,188,3200,3012
18417,1,1,351,3376,3025
18418,0,0,73,0,-73
18419,1,0,7,0,-7
18420,1,1,1309,1470,161
18421,0,0,25,0,-25
18422,1,1,415,1502,1087
18423,1,0,193,0,-193
18424,1,1,815,1344,529
18425,1,1,1145,1248,103
18426,0,0,32,0,-32
18427,1,0,57,0,-57
18428,1,1,583,1203,620
18429,0,0,49,0,-49
18430,1,1,494,1564,1070
18431,0,0,4,0,-4
18432,0,0,1,0,-1
18433,1,0,170,0,-170
18434,0,0,68,0,-68
18435,0,0,10,0,-10
18436,1,0,107,0,-107
18437,1,0,172,0,-172
18438,1,1,699,1886,1187
18439,1,0,78,0,-78
18440,1,1,553,2326,1773
18441,1,1,1113,1258,145
18442,0,0,43,0,-43
18443,0,0,107,0,-107
18444,1,0,1,0,-1
18445,0,0,69,0,-69
18446,1,0,29,0,-29
18447,0,0,28,0,-28
18448,0,0,34,0,-34
18449,1,0,101,0,-101
18450,1,1,567,1563,996
18451,0,0,81,0,-81
18452,1,0,30,0,-30
18453,1,1,1102,1619,517
18454,0,0,6,0,-6
18455,0,0,21,0,-21
18456,1,1,280,1251,971
18457,1,0,125,0,-125
18458,1,1,998,1262,264
18459,1,0,22,0,-22
18460,0,0,49,0,-49
18461,1,0,29,0,-29
18462,0,0,21,0,-21
18463,1,0,23,0,-23
18464,1,1,376,1398,1022
18465,0,0,96,0,-96
18466,1,0,48,0,-48
18467,1,1,144,1246,1102
18468,1,1,549,1211,662
18469,1,0,20,0,-20
18470,1,0,9,0,-9
18471,1,1,57,2611,2554
18472,0,0,0,0,0
18473,0,0,39,0,-39
18474,1,0,142,0,-142
18475,1,1,679,1218,539
18476,0,0,213,0,-213
18477,1,0,69,0,-69
18478,1,1,1177,1364,187
18479,0,0,30,0,-30
18480,1,0,1,0,-1
18481,1,0,1,0,-1
18482,1,0,36,0,-36
18483,1,1,332,1264,932
18484,1,1,32,1913,1881
18485,1,1,86,1546,1460
18486,1,1,115,1240,1125
18487,1,1,208,1232,1024
18488,0,0,76,0,-76
18489,1,0,55,0,-55
18490,1,1,2268,1713,-555
18491,0,0,18,0,-18
18492,0,0,120,0,-120
18493,1,0,26,0,-26
18494,0,0,12,0,-12
18495,1,1,391,1619,1228
18496,0,0,57,0,-57
18497,0,0,27,0,-27
18498,1,0,62,0,-62
18499,1,0,126,0,-126
18500,1,0,25,0,-25
18501,0,0,79,0,-79
18502,1,0,18,0,-18
18503,0,0,7,0,-7
18504,1,1,696,1682,986
18505,1,1,249,1421,1172
18506,0,0,69,0,-69
18507,1,0,69,0,-69
18508,1,1,660,1280,620
18509,0,0,10,0,-10
18510,1,0,149,0,-149
18511,1,1,553,1331,778
18512,0,0,74,0,-74
18513,1,1,166,1286,1120
18514,1,1,1662,1476,-186
18515,1,1,1605,1366,-239
18516,0,0,19,0,-19
18517,1,0,106,0,-106
18518,0,0,75,0,-75
18519,1,0,37,0,-37
18520,0,0,79,0,-79
18521,1,0,1,0,-1
18522,1,0,11,0,-11
18523,0,0,64,0,-64
18524,1,1,165,1798,1633
18525,1,1,943,1350,407
18526,0,0,143,0,-143
18527,1,0,4,0,-4
18528,0,0,36,0,-36
18529,1,1,380,2210,1830
18530,1,0,1,0,-1
18531,1,0,227,0,-227
18532,1,1,385,1307,922
18533,0,0,10,0,-10
18534,1,1,408,1408,1000
18535,1,1,736,4077,3341
18536,0,0,122,0,-122
18537,1,1,76,1216,1140
18538,1,1,920,1269,349
18539,1,0,7,0,-7
18540,1,0,142,0,-142
18541,1,1,482,1321,839
18542,1,0,5,0,-5
18543,1,0,107,0,-107
18544,0,0,72,0,-72
18545,0,0,2,0,-2
18546,1,1,214,1377,1163
18547,0,0,45,0,-45
18548,1,1,1300,1554,254
18549,1,0,10,0,-10
18550,1,1,2570,1275,-1295
18551,1,1,380,1961,1581
18552,1,0,112,0,-112
18553,1,1,106,1394,1288
18554,1,1,140,1211,1071
18555,1,1,1115,1297,182
18556,1,0,316,0,-316
18557,1,1,85,1316,1231
18558,1,0,7,0,-7
18559,1,0,2,0,-2
18560,1,1,348,1349,1001
18561,0,0,1,0,-1
18562,0,0,24,0,-24
18563,1,1,321,1253,932
18564,0,0,40,0,-40
18565,1,1,59,1268,1209
18566,1,1,1153,1288,135
18567,0,0,111,0,-111
18568,0,0,26,0,-26
18569,0,0,7,0,-7
18570,0,0,6,0,-6
18571,1,1,293,1360,1067
18572,1,1,388,1588,1200
18573,1,1,609,1213,604
18574,1,1,605,1689,1084
18575,0,0,5,0,-5
18576,1,0,4,0,-4
18577,1,1,642,1263,621
18578,0,0,37,0,-37
18579,1,0,14,0,-14
18580,1,0,68,0,-68
18581,0,0,13,0,-13
18582,1,1,595,1281,686
18583,0,0,17,0,-17
18584,1,0,7,0,-7
18585,0,0,37,0,-37
18586,1,1,1352,1509,157
18587,1,0,33,0,-33
18588,1,0,21,0,-21
18589,0,0,227,0,-227
18590,0,0,23,0,-23
18591,1,0,34,0,-34
18592,0,0,52,0,-52
18593,1,0,2,0,-2
18594,1,0,34,0,-34
18595,1,1,202,1336,1134
18596,1,0,53,0,-53
18597,0,0,75,0,-75
18598,1,1,465,1458,993
18599,1,1,148,1470,1322
18600,1,0,56,0,-56
18601,0,0,69,0,-69
18602,1,1,108,1399,1291
18603,1,0,29,0,-29
18604,1,0,1,0,-1
18605,0,0,18,0,-18
18606,0,0,95,0,-95
18607,1,0,10,0,-10
18608,0,0,16,0,-16
18609,0,0,32,0,-32
18610,1,1,1226,1721,495
18611,1,1,163,1212,1049
18612,0,0,41,0,-41
18613,1,0,86,0,-86
18614,0,0,99,0,-99
18615,0,0,127,0,-127
18616,0,0,16,0,-16
18617,1,1,503,1245,742
18618,1,1,713,2762,2049
18619,0,0,6,0,-6
18620,1,0,43,0,-43
18621,1,0,18,0,-18
18622,0,0,6,0,-6
18623,0,0,5,0,-5
18624,1,0,9,0,-9
18625,0,0,32,0,-32
18626,1,0,150,0,-150
18627,1,0,24,0,-24
18628,1,0,34,0,-34
18629,0,0,17,0,-17
18630,1,0,275,0,-275
18631,0,0,40,0,-40
18632,0,0,11,0,-11
18633,1,0,28,0,-28
18634,1,0,41,0,-41
18635,0,0,21,0,-21
18636,1,1,87,1455,1368
18637,1,0,30,0,-30
18638,0,0,27,0,-27
18639,0,0,4,0,-4
18640,0,0,9,0,-9
18641,1,1,297,1333,1036
18642,1,0,7,0,-7
18643,1,1,464,1398,934
18644,0,0,166,0,-166
18645,0,0,6,0,-6
18646,0,0,65,0,-65
18647,0,0,23,0,-23
18648,0,0,68,0,-68
18649,1,1,2156,1595,-561
18650,0,0,95,0,-95
18651,0,0,33,0,-33
18652,1,0,3,0,-3
18653,0,0,27,0,-27
18654,0,0,21,0,-21
18655,1,0,8,0,-8
18656,1,0,104,0,-104
18657,0,0,178,0,-178
18658,0,0,154,0,-154
18659,1,0,220,0,-220
18660,1,1,649,1498,849
18661,1,1,1560,1235,-325
18662,1,0,66,0,-66
18663,1,0,115,0,-115
18664,0,0,41,0,-41
18665,0,0,218,0,-218
18666,1,0,15,0,-15
18667,0,0,20,0,-20
18668,1,1,375,2568,2193
18669,1,1,681,1474,793
18670,1,0,6,0,-6
18671,1,0,18,0,-18
18672,1,0,26,0,-26
18673,0,0,63,0,-63
18674,1,1,251,1251,1000
18675,1,1,417,1265,848
18676,0,0,20,0,-20
18677,0,0,63,0,-63
18678,1,1,891,2649,1758
18679,1,0,18,0,-18
18680,0,0,14,0,-14
18681,1,0,22,0,-22
18682,0,0,0,0,0
18683,0,0,88,0,-88
18684,0,0,138,0,-138
18685,0,0,132,0,-132
18686,1,1,10,2268,2258
18687,1,1,265,1314,1049
18688,1,1,285,2738,2453
18689,1,1,946,1353,407
18690,1,1,173,2055,1882
18691,0,0,89,0,-89
18692,1,1,702,1390,688
18693,1,1,2495,2121,-374
18694,1,1,112,1426,1314
18695,1,0,41,0,-41
18696,1,0,0,0,0
18697,0,0,37,0,-37
18698,0,0,31,0,-31
18699,0,0,15,0,-15
18700,1,1,444,1281,837
18701,1,0,104,0,-104
18702,0,0,85,0,-85
18703,1,1,416,1856,1440
18704,0,0,37,0,-37
18705,1,0,177,0,-177
18706,0,0,121,0,-121
18707,1,0,247,0,-247
18708,0,0,54,0,-54
18709,1,1,368,2306,1938
18710,0,0,25,0,-25
18711,0,0,38,0,-38
18712,0,0,24,0,-24
18713,0,0,23,0,-23
18714,0,0,61,0,-61
18715,1,0,2,0,-2
18716,1,0,1,0,-1
18717,1,0,54,0,-54
18718,1,0,20,0,-20
18719,0,0,19,0,-19
18720,0,0,2,0,-2
18721,0,0,17,0,-17
18722,0,0,205,0,-205
18723,1,0,55,0,-55
18724,1,1,676,2062,1386
18725,0,0,107,0,-107
18726,1,1,48,1401,1353
18727,0,0,48,0,-48
18728,0,0,80,0,-80
18729,1,0,31,0,-31
18730,0,0,23,0,-23
18731,1,1,1140,1516,376
18732,0,0,28,0,-28
18733,0,0,0,0,0
18734,0,0,69,0,-69
18735,1,1,270,1602,1332
18736,1,0,53,0,-53
18737,0,0,46,0,-46
18738,1,1,938,1431,493
18739,1,1,41,1214,1173
18740,1,1,661,1625,964
18741,1,1,351,1308,957
18742,1,0,33,0,-33
18743,1,1,230,1976,1746
18744,1,1,688,1763,1075
18745,1,1,30,3188,3158
18746,0,0,4,0,-4
18747,1,0,39,0,-39
18748,0,0,40,0,-40
18749,0,0,127,0,-127
18750,1,1,665,1546,881
18751,0,0,41,0,-41
18752,0,0,64,0,-64
18753,1,1,747,1227,480
18754,0,0,90,0,-90
18755,0,0,0,0,0
18756,1,0,148,0,-148
18757,0,0,52,0,-52
18758,0,0,68,0,-68
18759,1,0,45,0,-45
18760,1,0,117,0,-117
18761,1,1,763,1382,619
18762,0,0,75,0,-75
18763,0,0,63,0,-63
18764,0,0,3,0,-3
18765,1,1,499,1291,792
18766,0,0,0,0,0
18767,1,0,78,0,-78
18768,0,0,38,0,-38
18769,0,0,33,0,-33
18770,1,0,22,0,-22
18771,1,0,37,0,-37
18772,0,0,2,0,-2
18773,0,0,52,0,-52
18774,0,0,61,0,-61
18775,1,1,96,1325,1229
18776,1,0,25,0,-25
18777,0,0,2,0,-2
18778,1,1,1297,1318,21
18779,0,0,163,0,-163
18780,0,0,31,0,-31
18781,0,0,95,0,-95
18782,1,1,344,1200,856
18783,1,1,883,1850,967
18784,1,0,32,0,-32
18785,1,1,236,1298,1062
18786,0,0,10,0,-10
18787,1,0,4,0,-4
18788,1,0,7,0,-7
18789,1,0,60,0,-60
18790,1,0,19,0,-19
18791,1,1,51,1698,1647
18792,0,0,16,0,-16
18793,0,0,16,0,-16
18794,0,0,128,0,-128
18795,0,0,18,0,-18
18796,1,1,714,1389,675
18797,1,0,44,0,-44
18798,0,0,85,0,-85
18799,1,1,495,1485,990
18800,1,0,51,0,-51
18801,1,0,61,0,-61
18802,0,0,47,0,-47
18803,0,0,34,0,-34
18804,1,1,642,1291,649
18805,0,0,12,0,-12
18806,1,0,6,0,-6
18807,1,0,6,0,-6
18808,1,1,945,1333,388
18809,1,0,48,0,-48
18810,0,0,26,0,-26
18811,1,0,58,0,-58
18812,1,0,82,0,-82
18813,0,0,19,0,-19
18814,1,1,412,1202,790
18815,1,1,549,1216,667
18816,0,0,16,0,-16
18817,1,0,38,0,-38
18818,1,0,39,0,-39
18819,1,0,34,0,-34
18820,0,0,2,0,-2
18821,0,0,175,0,-175
18822,1,0,12,0,-12
18823,1,0,11,0,-11
18824,0,0,63,0,-63
18825,0,0,1,0,-1
18826,1,1,605,1441,836
18827,1,0,103,0,-103
18828,0,0,26,0,-26
18829,1,1,288,1455,1167
18830,1,0,19,0,-19
18831,0,0,76,0,-76
18832,1,1,624,2755,2131
18833,1,1,421,1941,1520
18834,1,0,1,0,-1
18835,1,0,13,0,-13
18836,0,0,47,0,-47
18837,1,1,974,1320,346
18838,1,0,7,0,-7
18839,1,0,39,0,-39
18840,1,1,230,1337,1107
18841,1,1,762,1434,672
18842,0,0,83,0,-83
18843,1,1,869,1516,647
18844,0,0,95,0,-95
18845,1,1,312,1499,1187
18846,0,0,16,0,-16
18847,1,1,245,1896,1651
18848,1,1,659,1537,878
18849,0,0,17,0,-17
18850,1,0,99,0,-99
18851,1,1,1963,1298,-665
18852,0,0,33,0,-33
18853,0,0,26,0,-26
18854,1,1,603,2079,1476
18855,1,0,23,0,-23
18856,1,0,61,0,-61
18857,1,0,25,0,-25
18858,0,0,23,0,-23
18859,0,0,21,0,-21
18860,0,0,35,0,-35
18861,0,0,16,0,-16
18862,0,0,32,0,-32
18863,0,0,59,0,-59
18864,0,0,33,0,-33
18865,1,0,39,0,-39
18866,1,0,50,0,-50
18867,1,1,549,2535,1986
18868,1,1,368,1484,1116
18869,1,1,1302,2102,800
18870,1,1,43,1534,1491
18871,1,0,313,0,-313
18872,1,0,9,0,-9
18873,1,1,172,2484,2312
18874,0,0,21,0,-21
18875,1,1,188,1294,1106
18876,0,0,13,0,-13
18877,0,0,14,0,-14
18878,0,0,56,0,-56
18879,1,0,53,0,-53
18880,0,0,2,0,-2
18881,0,0,1,0,-1
18882,0,0,8,0,-8
18883,1,0,102,0,-102
18884,0,0,50,0,-50
18885,1,1,758,1296,538
18886,1,0,40,0,-40
18887,1,0,133,0,-133
18888,0,0,44,0,-44
18889,0,0,0,0,0
18890,1,0,38,0,-38
18891,1,0,42,0,-42
18892,0,0,32,0,-32
18893,1,0,5,0,-5
18894,1,1,317,1242,925
18895,0,0,46,0,-46
18896,1,0,1,0,-1
18897,1,1,273,1337,1064
18898,0,0,14,0,-14
18899,1,0,49,0,-49
18900,0,0,71,0,-71
18901,1,1,374,1993,1619
18902,0,0,127,0,-127
18903,1,0,23,0,-23
18904,0,0,16,0,-16
18905,1,1,251,1844,1593
18906,1,0,5,0,-5
18907,1,0,30,0,-30
18908,1,1,689,1810,1121
18909,1,0,98,0,-98
18910,0,0,31,0,-31
18911,0,0,6,0,-6
18912,0,0,13,0,-13
18913,0,0,111,0,-111
18914,1,0,29,0,-29
18915,1,0,130,0,-130
18916,0,0,3,0,-3
18917,1,0,1,0,-1
18918,0,0,139,0,-139
18919,1,1,189,1250,1061
18920,1,1,207,1254,1047
18921,1,0,58,0,-58
18922,1,0,2,0,-2
18923,1,0,69,0,-69
18924,1,1,241,1922,1681
18925,0,0,30,0,-30
18926,0,0,26,0,-26
18927,0,0,65,0,-65
18928,1,0,103,0,-103
18929,1,1,427,1300,873
18930,0,0,7,0,-7
18931,1,1,2388,1538,-850
18932,0,0,41,0,-41
18933,1,1,77,1720,1643
18934,0,0,43,0,-43
18935,0,0,2,0,-2
18936,0,0,75,0,-75
18937,0,0,10,0,-10
18938,0,0,82,0,-82
18939,0,0,57,0,-57
18940,0,0,54,0,-54
18941,0,0,7,0,-7
18942,0,0,51,0,-51
18943,1,1,1026,1377,351
18944,0,0,17,0,-17
18945,1,1,826,1226,400
18946,1,1,1064,2151,1087
18947,1,1,145,1280,1135
18948,0,0,27,0,-27
18949,1,1,253,1366,1113
18950,1,0,85,0,-85
18951,0,0,16,0,-16
18952,1,0,18,0,-18
18953,1,1,2231,1850,-381
18954,1,0,79,0,-79
18955,1,1,467,1645,1178
18956,1,0,44,0,-44
18957,1,1,1557,1213,-344
18958,1,1,260,1247,987
18959,0,0,9,0,-9
18960,1,0,40,0,-40
18961,0,0,27,0,-27
18962,0,0,24,0,-24
18963,1,1,282,1978,1696
18964,1,1,241,2338,2097
18965,1,0,21,0,-21
18966,1,1,754,1462,708
18967,1,1,567,1200,633
18968,1,1,1035,1392,357
18969,0,0,41,0,-41
18970,1,0,50,0,-50
18971,1,0,57,0,-57
18972,1,1,381,1424,1043
18973,1,0,63,0,-63
18974,0,0,89,0,-89
18975,1,0,71,0,-71
18976,0,0,8,0,-8
18977,0,0,21,0,-21
18978,1,1,721,1250,529
18979,0,0,6,0,-6
18980,1,1,543,1277,734
18981,1,0,30,0,-30
18982,0,0,20,0,-20
18983,1,0,44,0,-44
18984,0,0,44,0,-44
18985,1,0,95,0,-95
18986,0,0,53,0,-53
18987,1,0,9,0,-9
18988,1,0,9,0,-9
18989,0,0,105,0,-105
18990,0,0,36,0,-36
18991,1,1,320,1350,1030
18992,1,1,81,1468,1387
18993,1,1,275,1500,1225
18994,1,0,45,0,-45
18995,0,0,1,0,-1
18996,1,1,862,1231,369
18997,1,0,43,0,-43
18998,1,1,2244,1338,-906
18999,1,1,401,2080,1679
19000,1,0,6,0,-6
19001,1,0,49,0,-49
19002,1,1,606,2022,1416
19003,1,1,290,1797,1507
19004,1,0,32,0,-32
19005,1,1,437,1234,797
19006,0,0,9,0,-9
19007,1,1,1231,3138,1907
19008,1,1,1098,1234,136
19009,1,0,158,0,-158
19010,0,0,193,0,-193
19011,1,1,575,1472,897
19012,0,0,18,0,-18
19013,1,0,159,0,-159
19014,1,1,338,1656,1318
19015,1,0,97,0,-97
19016,0,0,20,0,-20
19017,1,0,92,0,-92
19018,1,1,2718,1335,-1383
19019,1,0,151,0,-151
19020,1,0,53,0,-53
19021,1,0,7,0,-7
19022,1,1,694,1558,864
19023,0,0,72,0,-72
19024,0,0,31,0,-31
19025,1,1,1171,2062,891
19026,1,0,10,0,-10
19027,0,0,73,0,-73
19028,0,0,165,0,-165
19029,1,1,151,1803,1652
19030,0,0,47,0,-47
19031,1,1,354,1347,993
19032,0,0,17,0,-17
19033,0,0,94,0,-94
19034,0,0,8,0,-8
19035,0,0,1,0,-1
19036,1,0,12,0,-12
19037,1,1,1087,1652,565
19038,1,0,28,0,-28
19039,1,0,19,0,-19
19040,0,0,22,0,-22
19041,0,0,42,0,-42
19042,0,0,111,0,-111
19043,1,0,38,0,-38
19044,1,1,187,1416,1229
19045,0,0,55,0,-55
19046,0,0,86,0,-86
19047,1,0,39,0,-39
19048,0,0,62,0,-62
19049,1,0,55,0,-55
19050,0,0,4,0,-4
19051,1,1,112,1395,1283
19052,0,0,5,0,-5
19053,0,0,9,0,-9
19054,1,0,25,0,-25
19055,0,0,35,0,-35
19056,1,0,48,0,-48
19057,0,0,15,0,-15
19058,1,1,341,1712,1371
19059,1,1,582,1739,1157
19060,1,0,92,0,-92
19061,1,1,844,1239,395
19062,1,0,47,0,-47
19063,0,0,77,0,-77
19064,0,0,10,0,-10
19065,1,1,870,2100,1230
19066,1,1,202,2151,1949
19067,1,1,412,1610,1198
19068,0,0,149,0,-149
19069,0,0,6,0,-6
19070,1,0,9,0,-9
19071,1,0,58,0,-58
19072,0,0,97,0,-97
19073,1,1,302,1605,1303
19074,0,0,28,0,-28
19075,1,0,12,0,-12
19076,0,0,17,0,-17
19077,0,0,43,0,-43
19078,0,0,50,0,-50
19079,1,0,51,0,-51
19080,1,1,844,1739,895
19081,0,0,31,0,-31
19082,1,1,305,1284,979
19083,1,1,54,1460,1406
19084,0,0,38,0,-38
19085,1,0,110,0,-110
19086,1,1,249,1236,987
19087,0,0,205,0,-205
19088,1,0,12,0,-12
19089,0,0,43,0,-43
19090,1,0,68,0,-68
19091,0,0,97,0,-97
19092,1,0,4,0,-4
19093,1,0,87,0,-87
19094,0,0,35,0,-35
19095,0,0,12,0,-12
19096,0,0,24,0,-24
19097,1,1,205,2029,1824
19098,1,0,75,0,-75
19099,0,0,126,0,-126
19100,0,0,4,0,-4
19101,1,0,95,0,-95
19102,0,0,97,0,-97
19103,1,0,19,0,-19
19104,1,0,49,0,-49
19105,1,1,47,1412,1365
19106,0,0,46,0,-46
19107,1,1,66,1415,1349
19108,0,0,97,0,-97
19109,0,0,78,0,-78
19110,1,1,51,3085,3034
19111,1,1,1824,1465,-359
19112,1,1,312,1266,954
19113,0,0,67,0,-67
19114,1,1,223,1740,1517
19115,1,1,124,1381,1257
19116,1,1,1905,1912,7
19117,0,0,14,0,-14
19118,1,1,686,2045,1359
19119,0,0,9,0,-9
19120,1,1,237,1208,971
19121,1,1,171,1463,1292
19122,0,0,18,0,-18
19123,1,0,35,0,-35
19124,0,0,27,0,-27
19125,0,0,4,0,-4
19126,0,0,4,0,-4
19127,1,0,1,0,-1
19128,1,0,41,0,-41
19129,1,0,43,0,-43
19130,1,1,121,1372,1251
19131,1,1,156,1454,1298
19132,0,0,53,0,-53
19133,1,1,513,1980,1467
19134,1,0,69,0,-69
19135,0,0,10,0,-10
19136,0,0,67,0,-67
19137,0,0,90,0,-90
19138,0,0,110,0,-110
19139,1,1,2613,1303,-1310
19140,0,0,45,0,-45
19141,1,1,1345,1226,-119
19142,1,1,48,1220,1172
19143,0,0,17,0,-17
19144,0,0,8,0,-8
19145,1,0,120,0,-120
19146,1,0,6,0,-6
19147,0,0,25,0,-25
19148,1,1,687,1805,1118
19149,0,0,8,0,-8
19150,0,0,21,0,-21
19151,1,0,43,0,-43
19152,0,0,14,0,-14
19153,0,0,72,0,-72
19154,1,1,128,1389,1261
19155,1,1,1204,3504,2300
19156,0,0,11,0,-11
19157,0,0,66,0,-66
19158,0,0,41,0,-41
19159,0,0,46,0,-46
19160,0,0,36,0,-36
19161,1,0,46,0,-46
19162,1,0,122,0,-122
19163,1,1,1040,2200,1160
19164,0,0,54,0,-54
19165,1,0,162,0,-162
19166,1,0,65,0,-65
19167,0,0,6,0,-6
19168,0,0,64,0,-64
19169,1,0,1,0,-1
19170,0,0,2,0,-2
19171,1,0,2,0,-2
19172,1,0,0,0,0
19173,1,0,54,0,-54
19174,0,0,40,0,-40
19175,1,1,252,1485,1233
19176,0,0,82,0,-82
19177,1,0,0,0,0
19178,1,1,436,1709,1273
19179,1,1,1619,1683,64
19180,1,0,35,0,-35
19181,1,1,80,1342,1262
19182,1,1,138,1242,1104
19183,1,1,581,1262,681
19184,1,1,111,3444,3333
19185,0,0,15,0,-15
19186,1,0,13,0,-13
19187,1,1,131,1294,1163
19188,0,0,91,0,-91
19189,1,0,63,0,-63
19190,1,0,22,0,-22
19191,1,0,34,0,-34
19192,0,0,21,0,-21
19193,1,0,22,0,-22
19194,1,1,280,1447,1167
19195,1,0,55,0,-55
19196,0,0,86,0,-86
19197,1,0,27,0,-27
19198,0,0,16,0,-16
19199,0,0,92,0,-92
19200,1,1,374,1251,877
19201,0,0,36,0,-36
19202,0,0,21,0,-21
19203,1,0,24,0,-24
19204,1,0,34,0,-34
19205,0,0,30,0,-30
19206,1,0,152,0,-152
19207,0,0,110,0,-110
19208,1,1,731,2087,1356
19209,1,1,168,1443,1275
19210,1,1,256,1378,1122
19211,0,0,32,0,-32
19212,0,0,17,0,-17
19213,0,0,106,0,-106
19214,1,0,22,0,-22
19215,1,0,111,0,-111
19216,1,0,40,0,-40
19217,1,1,57,1461,1404
19218,0,0,36,0,-36
19219,1,1,1791,1221,-570
19220,1,1,799,1364,565
19221,0,0,75,0,-75
19222,0,0,108,0,-108
19223,0,0,21,0,-21
19224,1,1,732,1221,489
19225,1,1,344,1279,935
19226,1,1,902,1528,626
19227,1,1,2115,1988,-127
19228,1,1,580,1308,728
19229,0,0,15,0,-15
19230,0,0,11,0,-11
19231,0,0,77,0,-77
19232,0,0,8,0,-8
19233,1,1,598,1542,944
19234,0,0,320,0,-320
19235,1,1,355,1329,974
19236,0,0,54,0,-54
19237,1,0,119,0,-119
19238,0,0,122,0,-122
19239,0,0,11,0,-11
19240,0,0,15,0,-15
19241,1,0,113,0,-113
19242,1,1,611,1224,613
19243,0,0,152,0,-152
19244,1,0,0,0,0
19245,1,0,57,0,-57
19246,1,1,2,1258,1256
19247,0,0,12,0,-12
19248,1,1,29,1248,1219
19249,0,0,59,0,-59
19250,1,0,13,0,-13
19251,1,0,5,0,-5
19252,1,0,2,0,-2
19253,1,1,1242,1297,55
19254,0,0,93,0,-93
19255,1,1,516,1461,945
19256,1,1,1056,1207,151
19257,1,1,392,1443,1051
19258,1,1,131,1335,1204
19259,1,1,828,1697,869
19260,0,0,94,0,-94
19261,0,0,6,0,-6
19262,1,1,468,1340,872
19263,0,0,49,0,-49
19264,1,1,797,1287,490
19265,0,0,25,0,-25
19266,1,1,963,1598,635
19267,0,0,111,0,-111
19268,1,0,22,0,-22
19269,1,0,4,0,-4
19270,0,0,36,0,-36
19271,0,0,30,0,-30
19272,0,0,67,0,-67
19273,1,0,2,0,-2
19274,1,1,975,1285,310
19275,1,1,392,1288,896
19276,0,0,12,0,-12
19277,0,0,25,0,-25
19278,1,0,45,0,-45
19279,1,1,274,1657,1383
19280,1,0,65,0,-65
19281,1,1,1084,1420,336
19282,0,0,3,0,-3
19283,0,0,10,0,-10
19284,1,1,154,1408,1254
19285,1,1,325,1680,1355
19286,1,0,3,0,-3
19287,1,1,79,2181,2102
19288,0,0,116,0,-116
19289,0,0,68,0,-68
19290,1,0,30,0,-30
19291,1,1,1351,1598,247
19292,1,0,1,0,-1
19293,1,1,837,1928,1091
19294,1,0,41,0,-41
19295,0,0,15,0,-15
19296,1,0,66,0,-66
19297,1,0,77,0,-77
19298,0,0,25,0,-25
19299,1,1,1851,1475,-376
19300,1,1,104,1312,1208
19301,1,0,75,0,-75
19302,0,0,137,0,-137
19303,0,0,190,0,-190
19304,1,0,125,0,-125
19305,0,0,28,0,-28
19306,0,0,61,0,-61
19307,1,1,146,1243,1097
19308,1,0,188,0,-188
19309,0,0,98,0,-98
19310,1,0,49,0,-49
19311,0,0,25,0,-25
19312,1,0,68,0,-68
19313,1,1,125,1415,1290
19314,1,1,188,1321,1133
19315,0,0,96,0,-96
19316,1,0,18,0,-18
19317,1,1,97,1207,1110
19318,1,1,541,1388,847
19319,1,0,25,0,-25
19320,1,1,1518,1310,-208
19321,1,1,907,1233,326
19322,0,0,29,0,-29
19323,1,0,19,0,-19
19324,0,0,54,0,-54
19325,1,0,3,0,-3
19326,1,0,107,0,-107
19327,0,0,59,0,-59
19328,0,0,12,0,-12
19329,1,0,66,0,-66
19330,1,0,39,0,-39
19331,0,0,11,0,-11
19332,0,0,8,0,-8
19333,1,0,119,0,-119
19334,0,0,2,0,-2
19335,1,1,411,1449,1038
19336,1,1,183,1247,1064
19337,0,0,14,0,-14
19338,1,1,111,1626,1515
19339,1,1,100,2101,2001
19340,1,0,16,0,-16
19341,0,0,28,0,-28
19342,0,0,16,0,-16
19343,1,0,1,0,-1
19344,0,0,70,0,-70
19345,1,0,64,0,-64
19346,1,1,324,1212,888
19347,1,1,1400,1659,259
19348,0,0,2,0,-2
19349,0,0,70,0,-70
19350,0,0,55,0,-55
19351,1,0,21,0,-21
19352,0,0,22,0,-22
19353,0,0,72,0,-72
19354,1,1,170,1248,1078
19355,1,0,98,0,-98
19356,0,0,5,0,-5
19357,1,1,1173,1721,548
19358,1,0,6,0,-6
19359,1,1,309,1652,1343
19360,1,1,335,2334,1999
19361,1,1,151,1779,1628
19362,1,0,25,0,-25
19363,1,0,32,0,-32
19364,0,0,112,0,-112
19365,1,1,96,1233,1137
19366,1,0,191,0,-191
19367,0,0,34,0,-34
19368,1,0,110,0,-110
19369,1,0,3,0,-3
19370,0,0,25,0,-25
19371,1,0,21,0,-21
19372,0,0,104,0,-104
19373,1,0,128,0,-128
19374,0,0,13,0,-13
19375,1,0,5,0,-5
19376,1,0,20,0,-20
19377,1,0,30,0,-30
19378,1,0,27,0,-27
19379,1,1,159,1278,1119
19380,0,0,105,0,-105
19381,0,0,23,0,-23
19382,1,0,57,0,-57
19383,1,1,768,1887,1119
19384,1,1,66,1526,1460
19385,1,1,105,1674,1569
19386,0,0,46,0,-46
19387,1,1,48,1776,1728
19388,1,1,551,1363,812
19389,0,0,14,0,-14
19390,0,0,63,0,-63
19391,1,1,213,1745,1532
19392,1,0,0,0,0
19393,0,0,81,0,-81
19394,1,0,29,0,-29
19395,1,1,879,1212,333
19396,0,0,163,0,-163
19397,0,0,76,0,-76
19398,1,1,627,1375,748
19399,0,0,1,0,-1
19400,1,0,39,0,-39
19401,0,0,3,0,-3
19402,0,0,12,0,-12
19403,1,1,1138,1386,248
19404,0,0,121,0,-121
19405,1,0,54,0,-54
19406,0,0,71,0,-71
19407,1,1,266,1685,1419
19408,1,0,9,0,-9
19409,1,1,395,1579,1184
19410,1,1,2147,1634,-513
19411,0,0,139,0,-139
19412,1,1,488,3751,3263
19413,1,1,1359,1263,-96
19414,1,1,863,1476,613
19415,0,0,31,0,-31
19416,1,1,269,1429,1160
19417,1,1,2170,1419,-751
19418,1,0,28,0,-28
19419,1,1,339,1518,1179
19420,0,0,50,0,-50
19421,1,1,139,1332,1193
19422,0,0,94,0,-94
19423,0,0,199,0,-199
19424,1,1,1225,2887,1662
19425,1,0,58,0,-58
19426,1,1,379,1658,1279
19427,0,0,66,0,-66
19428,1,0,36,0,-36
19429,1,0,121,0,-121
19430,0,0,12,0,-12
19431,1,0,45,0,-45
19432,0,0,13,0,-13
19433,1,1,636,1596,960
19434,1,0,28,0,-28
19435,1,0,27,0,-27
19436,1,1,295,1254,959
19437,0,0,6,0,-6
19438,1,1,211,1256,1045
19439,0,0,22,0,-22
19440,1,1,14,2443,2429
19441,0,0,58,0,-58
19442,0,0,21,0,-21
19443,1,1,686,1253,567
19444,0,0,22,0,-22
19445,0,0,82,0,-82
19446,1,1,22,2496,2474
19447,0,0,14,0,-14
19448,0,0,85,0,-85
19449,1,0,307,0,-307
19450,1,1,1836,1436,-400
19451,1,0,124,0,-124
19452,1,1,564,1213,649
19453,0,0,8,0,-8
19454,1,1,390,1246,856
19455,1,0,24,0,-24
19456,0,0,17,0,-17
19457,0,0,55,0,-55
19458,0,0,26,0,-26
19459,0,0,19,0,-19
19460,0,0,9,0,-9
19461,1,1,126,1300,1174
19462,0,0,47,0,-47
19463,1,1,407,1442,1035
19464,0,0,83,0,-83
19465,1,1,532,1460,928
19466,1,0,3,0,-3
19467,1,1,244,2029,1785
19468,0,0,131,0,-131
19469,1,1,202,1350,1148
19470,1,0,77,0,-77
19471,0,0,51,0,-51
19472,0,0,71,0,-71
19473,1,1,46,1924,1878
19474,1,1,166,1360,1194
19475,1,1,138,1226,1088
19476,1,1,860,1432,572
19477,0,0,3,0,-3
19478,1,0,141,0,-141
19479,0,0,66,0,-66
19480,0,0,145,0,-145
19481,0,0,50,0,-50
19482,0,0,35,0,-35
19483,1,0,2,0,-2
19484,0,0,15,0,-15
19485,1,0,25,0,-25
19486,0,0,29,0,-29
19487,1,1,207,1652,1445
19488,0,0,4,0,-4
19489,1,1,987,1228,241
19490,0,0,150,0,-150
19491,1,1,981,1224,243
19492,0,0,11,0,-11
19493,0,0,5,0,-5
19494,1,0,13,0,-13
19495,1,1,834,1282,448
19496,1,1,626,1450,824
19497,1,0,3,0,-3
19498,0,0,50,0,-50
19499,0,0,4,0,-4
19500,0,0,39,0,-39
19501,1,0,32,0,-32
19502,1,0,20,0,-20
19503,0,0,40,0,-40
19504,0,0,50,0,-50
19505,1,1,1076,1766,690
19506,0,0,37,0,-37
19507,1,1,347,1454,1107
19508,1,0,155,0,-155
19509,1,0,56,0,-56
19510,1,0,95,0,-95
19511,1,1,171,1483,1312
19512,1,0,14,0,-14
19513,0,0,63,0,-63
19514,1,0,7,0,-7
19515,0,0,13,0,-13
19516,0,0,3,0,-3
19517,0,0,41,0,-41
19518,1,1,511,2782,2271
19519,0,0,21,0,-21
19520,0,0,1,0,-1
19521,0,0,24,0,-24
19522,0,0,65,0,-65
19523,1,0,1,0,-1
19524,0,0,3,0,-3
19525,1,1,1164,1447,283
19526,1,1,1031,1579,548
19527,1,1,948,1373,425
19528,0,0,16,0,-16
19529,1,1,1010,1499,489
19530,1,0,13,0,-13
19531,1,1,373,1271,898
19532,0,0,18,0,-18
19533,0,0,31,0,-31
19534,0,0,12,0,-12
19535,1,0,29,0,-29
19536,1,0,10,0,-10
19537,1,1,76,1633,1557
19538,0,0,94,0,-94
19539,0,0,36,0,-36
19540,0,0,2,0,-2
19541,1,1,806,1303,497
19542,1,1,279,1607,1328
19543,0,0,40,0,-40
19544,0,0,20,0,-20
19545,0,0,6,0,-6
19546,1,0,21,0,-21
19547,1,0,37,0,-37
19548,0,0,216,0,-216
19549,0,0,72,0,-72
19550,1,0,27,0,-27
19551,1,1,249,1537,1288
19552,0,0,14,0,-14
19553,1,1,124,1757,1633
19554,1,1,899,1354,455
19555,1,1,369,1234,865
19556,0,0,3,0,-3
19557,0,0,84,0,-84
19558,0,0,67,0,-67
19559,1,0,56,0,-56
19560,0,0,43,0,-43
19561,1,0,105,0,-105
19562,0,0,2,0,-2
19563,1,0,11,0,-11
19564,1,1,88,1648,1560
19565,0,0,23,0,-23
19566,1,0,9,0,-9
19567,0,0,146,0,-146
19568,1,1,305,2212,1907
19569,0,0,87,0,-87
19570,0,0,21,0,-21
19571,1,0,22,0,-22
19572,0,0,162,0,-162
19573,1,0,49,0,-49
19574,1,0,92,0,-92
19575,1,0,40,0,-40
19576,0,0,21,0,-21
19577,1,1,356,3880,3524
19578,1,1,673,1244,571
19579,1,1,3507,1668,-1839
19580,1,1,1208,1263,55
19581,0,0,16,0,-16
19582,1,0,3,0,-3
19583,1,0,16,0,-16
19584,0,0,17,0,-17
19585,0,0,29,0,-29
19586,1,1,343,1781,1438
19587,0,0,49,0,-49
19588,0,0,18,0,-18
19589,0,0,3,0,-3
19590,1,0,17,0,-17
19591,0,0,36,0,-36
19592,0,0,6,0,-6
19593,0,0,7,0,-7
19594,1,0,170,0,-170
19595,1,1,531,1777,1246
19596,1,1,597,1274,677
19597,1,0,63,0,-63
19598,1,1,670,1268,598
19599,0,0,17,0,-17
19600,0,0,28,0,-28
19601,0,0,46,0,-46
19602,1,1,518,3305,2787
19603,1,1,109,1380,1271
19604,1,1,838,1210,372
19605,0,0,93,0,-93
19606,1,1,453,1280,827
19607,1,1,1074,1398,324
19608,0,0,16,0,-16
19609,0,0,68,0,-68
19610,0,0,53,0,-53
19611,1,1,942,1639,697
19612,0,0,29,0,-29
19613,0,0,3,0,-3
19614,0,0,63,0,-63
19615,1,1,1320,1497,177
19616,1,1,579,3196,2617
19617,0,0,0,0,0
19618,1,0,7,0,-7
19619,0,0,14,0,-14
19620,0,0,28,0,-28
19621,0,0,95,0,-95
19622,0,0,52,0,-52
19623,1,1,615,1256,641
19624,1,1,59,1212,1153
19625,1,0,346,0,-346
19626,1,1,1063,1375,312
19627,0,0,17,0,-17
19628,0,0,2,0,-2
19629,0,0,1,0,-1
19630,1,0,4,0,-4
19631,0,0,13,0,-13
19632,1,1,177,3397,3220
19633,1,1,442,1284,842
19634,1,0,3,0,-3
19635,0,0,39,0,-39
19636,0,0,19,0,-19
19637,1,1,280,1360,1080
19638,1,1,137,1412,1275
19639,0,0,26,0,-26
19640,1,0,3,0,-3
19641,0,0,13,0,-13
19642,1,1,1128,1238,110
19643,1,1,408,1205,797
19644,0,0,25,0,-25
19645,0,0,44,0,-44
19646,1,1,417,1733,1316
19647,0,0,22,0,-22
19648,0,0,19,0,-19
19649,1,0,9,0,-9
19650,0,0,1,0,-1
19651,1,1,1105,1260,155
19652,1,1,394,4936,4542
19653,0,0,54,0,-54
19654,1,0,226,0,-226
19655,1,0,4,0,-4
19656,1,0,74,0,-74
19657,0,0,9,0,-9
19658,0,0,65,0,-65
19659,1,0,19,0,-19
19660,1,1,141,2674,2533
19661,1,0,25,0,-25
19662,0,0,10,0,-10
19663,1,0,50,0,-50
19664,0,0,23,0,-23
19665,1,0,57,0,-57
19666,1,0,6,0,-6
19667,1,1,254,1211,957
19668,1,0,37,0,-37
19669,1,0,30,0,-30
19670,0,0,23,0,-23
19671,0,0,55,0,-55
19672,1,1,94,1322,1228
19673,1,1,130,1414,1284
19674,0,0,9,0,-9
19675,0,0,54,0,-54
19676,1,1,289,1354,1065
19677,1,1,74,1410,1336
19678,1,1,524,1251,727
19679,1,0,10,0,-10
19680,1,0,25,0,-25
19681,0,0,32,0,-32
19682,0,0,252,0,-252
19683,1,0,29,0,-29
19684,0,0,3,0,-3
19685,1,1,471,1849,1378
19686,0,0,53,0,-53
19687,0,0,19,0,-19
19688,1,0,25,0,-25
19689,1,1,690,1395,705
19690,1,1,279,1579,1300
19691,1,0,138,0,-138
19692,0,0,24,0,-24
19693,0,0,6,0,-6
19694,0,0,36,0,-36
19695,0,0,20,0,-20
19696,1,1,417,1558,1141
19697,1,0,19,0,-19
19698,1,1,85,1233,1148
19699,1,1,175,1332,1157
19700,0,0,37,0,-37
19701,1,0,16,0,-16
19702,1,1,39,1261,1222
19703,0,0,13,0,-13
19704,0,0,21,0,-21
19705,1,1,504,1426,922
19706,1,1,310,1338,1028
19707,1,0,49,0,-49
19708,1,1,189,1868,1679
19709,0,0,1,0,-1
19710,0,0,51,0,-51
19711,1,0,59,0,-59
19712,1,0,13,0,-13
19713,0,0,16,0,-16
19714,1,1,361,2023,1662
19715,0,0,5,0,-5
19716,1,0,28,0,-28
19717,1,1,296,1603,1307
19718,1,0,69,0,-69
19719,1,0,44,0,-44
19720,1,0,58,0,-58
19721,0,0,60,0,-60
19722,1,1,303,1214,911
19723,1,1,347,1238,891
19724,0,0,5,0,-5
19725,1,1,34,1777,1743
19726,1,0,41,0,-41
19727,0,0,3,0,-3
19728,0,0,37,0,-37
19729,1,1,419,1434,1015
19730,0,0,18,0,-18
19731,1,1,346,1234,888
19732,0,0,54,0,-54
19733,1,0,86,0,-86
19734,1,1,1225,2072,847
19735,1,0,106,0,-106
19736,1,0,17,0,-17
19737,0,0,56,0,-56
19738,0,0,7,0,-7
19739,1,0,37,0,-37
19740,0,0,97,0,-97
19741,1,0,28,0,-28
19742,1,0,20,0,-20
19743,1,0,76,0,-76
19744,0,0,10,0,-10
19745,1,0,71,0,-71
19746,1,1,439,1541,1102
19747,0,0,14,0,-14
19748,0,0,22,0,-22
19749,1,1,258,1677,1419
19750,0,0,5,0,-5
19751,0,0,49,0,-49
19752,1,0,11,0,-11
19753,1,0,115,0,-115
19754,0,0,20,0,-20
19755,0,0,3,0,-3
19756,1,0,26,0,-26
19757,1,1,382,1600,1218
19758,1,1,1137,2390,1253
19759,0,0,64,0,-64
19760,1,1,476,1239,763
19761,0,0,17,0,-17
19762,1,0,41,0,-41
19763,0,0,59,0,-59
19764,1,0,113,0,-113
19765,0,0,17,0,-17
19766,0,0,3,0,-3
19767,1,1,690,1520,830
19768,0,0,143,0,-143
19769,1,0,68,0,-68
19770,1,0,34,0,-34
19771,1,0,11,0,-11
19772,1,1,388,1255,867
19773,1,1,1202,1338,136
19774,0,0,48,0,-48
19775,0,0,18,0,-18
19776,1,0,38,0,-38
19777,0,0,72,0,-72
19778,1,1,143,1341,1198
19779,1,1,48,1422,1374
19780,1,1,678,2022,1344
19781,1,1,802,1258,456
19782,1,1,918,1229,311
19783,1,0,89,0,-89
19784,0,0,10,0,-10
19785,1,1,197,1879,1682
19786,0,0,163,0,-163
19787,1,0,91,0,-91
19788,1,1,1066,1345,279
19789,0,0,59,0,-59
19790,1,1,1951,1227,-724
19791,1,0,21,0,-21
19792,0,0,53,0,-53
19793,1,0,63,0,-63
19794,1,0,3,0,-3
19795,0,0,7,0,-7
19796,0,0,54,0,-54
19797,0,0,5,0,-5
19798,1,1,709,1256,547
19799,1,1,71,1205,1134
19800,0,0,0,0,0
19801,0,0,58,0,-58
19802,1,0,70,0,-70
19803,0,0,7,0,-7
19804,0,0,17,0,-17
19805,0,0,109,0,-109
19806,1,0,42,0,-42
19807,1,1,1398,1257,-141
19808,1,0,46,0,-46
19809,1,1,1215,2248,1033
19810,1,0,12,0,-12
19811,1,1,133,1234,1101
19812,1,1,480,1252,772
19813,0,0,51,0,-51
19814,1,0,0,0,0
19815,1,1,307,1422,1115
19816,0,0,70,0,-70
19817,0,0,3,0,-3
19818,0,0,24,0,-24
19819,1,0,49,0,-49
19820,0,0,245,0,-245
19821,0,0,3,0,-3
19822,1,0,63,0,-63
19823,0,0,57,0,-57
19824,1,1,1132,1222,90
19825,0,0,89,0,-89
19826,0,0,11,0,-11
19827,0,0,4,0,-4
19828,0,0,15,0,-15
19829,1,0,111,0,-111
19830,1,0,121,0,-121
19831,0,0,1,0,-1
19832,0,0,9,0,-9
19833,1,0,65,0,-65
19834,1,0,51,0,-51
19835,1,0,124,0,-124
19836,1,1,4098,1455,-2643
19837,1,0,94,0,-94
19838,1,0,21,0,-21
19839,0,0,22,0,-22
19840,1,0,107,0,-107
19841,1,0,208,0,-208
19842,0,0,53,0,-53
19843,1,1,424,1566,1142
19844,0,0,28,0,-28
19845,1,1,1300,2611,1311
19846,0,0,3,0,-3
19847,1,0,10,0,-10
19848,1,0,12,0,-12
19849,1,0,57,0,-57
19850,0,0,13,0,-13
19851,1,1,105,1237,1132
19852,1,0,2,0,-2
19853,1,0,34,0,-34
19854,0,0,127,0,-127
19855,1,1,559,1584,1025
19856,1,0,0,0,0
19857,0,0,35,0,-35
19858,0,0,43,0,-43
19859,1,1,524,1413,889
19860,0,0,48,0,-48
19861,0,0,7,0,-7
19862,1,1,396,1566,1170
19863,0,0,121,0,-121
19864,1,1,224,2040,1816
19865,0,0,29,0,-29
19866,1,1,1652,1942,290
19867,1,0,181,0,-181
19868,1,0,3,0,-3
19869,1,0,77,0,-77
19870,1,0,42,0,-42
19871,0,0,1,0,-1
19872,1,0,20,0,-20
19873,1,0,49,0,-49
19874,1,1,198,1216,1018
19875,1,0,1,0,-1
19876,1,0,14,0,-14
19877,1,1,93,1215,1122
19878,1,1,425,1316,891
19879,1,1,407,1502,1095
19880,1,1,2318,1515,-803
19881,0,0,4,0,-4
19882,1,1,306,1274,968
19883,0,0,12,0,-12
19884,0,0,74,0,-74
19885,1,1,465,1737,1272
19886,1,1,199,1753,1554
19887,1,0,134,0,-134
19888,1,0,11,0,-11
19889,0,0,21,0,-21
19890,1,1,121,1331,1210
19891,0,0,38,0,-38
19892,0,0,10,0,-10
19893,1,1,251,1455,1204
19894,1,1,193,1454,1261
19895,1,1,1717,1501,-216
19896,1,0,208,0,-208
19897,0,0,14,0,-14
19898,0,0,36,0,-36
19899,1,1,2290,1488,-802
19900,0,0,27,0,-27
19901,1,0,33,0,-33
19902,1,0,10,0,-10
19903,1,0,42,0,-42
19904,1,1,627,2343,1716
19905,0,0,61,0,-61
19906,1,1,191,1438,1247
19907,0,0,61,0,-61
19908,0,0,1,0,-1
19909,1,0,84,0,-84
19910,1,0,73,0,-73
19911,0,0,29,0,-29
19912,1,0,35,0,-35
19913,0,0,17,0,-17
19914,1,1,938,2667,1729
19915,0,0,21,0,-21
19916,1,1,171,1293,1122
19917,1,0,9,0,-9
19918,0,0,116,0,-116
19919,0,0,3,0,-3
19920,0,0,57,0,-57
19921,0,0,16,0,-16
19922,0,0,80,0,-80
19923,1,0,15,0,-15
19924,1,1,911,1450,539
19925,0,0,16,0,-16
19926,1,0,32,0,-32
19927,0,0,27,0,-27
19928,1,0,1,0,-1
19929,0,0,12,0,-12
19930,0,0,34,0,-34
19931,0,0,88,0,-88
19932,0,0,157,0,-157
19933,1,1,479,1408,929
19934,0,0,2,0,-2
19935,0,0,16,0,-16
19936,1,0,11,0,-11
19937,1,1,249,1893,1644
19938,1,1,374,1824,1450
19939,1,0,39,0,-39
19940,1,1,182,1944,1762
19941,1,1,531,1669,1138
19942,0,0,20,0,-20
19943,1,1,320,1388,1068
19944,1,0,45,0,-45
19945,0,0,5,0,-5
19946,0,0,30,0,-30
19947,0,0,15,0,-15
19948,0,0,66,0,-66
19949,1,0,25,0,-25
19950,1,0,1,0,-1
19951,0,0,40,0,-40
19952,0,0,59,0,-59
19953,1,1,712,1241,529
19954,1,0,137,0,-137
19955,0,0,64,0,-64
19956,1,1,432,1761,1329
19957,1,1,346,1290,944
19958,0,0,3,0,-3
19959,1,1,701,1287,586
19960,1,0,5,0,-5
19961,1,0,23,0,-23
19962,0,0,17,0,-17
19963,1,0,13,0,-13
19964,1,1,1186,1216,30
19965,0,0,22,0,-22
19966,1,0,17,0,-17
19967,0,0,33,0,-33
19968,1,1,618,2436,1818
19969,0,0,134,0,-134
19970,1,1,702,1618,916
19971,1,1,215,1355,1140
19972,1,1,117,1421,1304
19973,1,0,89,0,-89
19974,1,0,6,0,-6
19975,1,0,45,0,-45
19976,0,0,106,0,-106
19977,0,0,13,0,-13
19978,1,1,254,1960,1706
19979,0,0,8,0,-8
19980,1,1,980,1360,380
19981,1,1,563,1293,730
19982,1,0,12,0,-12
19983,1,0,7,0,-7
19984,1,1,569,1324,755
19985,0,0,32,0,-32
19986,1,1,333,1465,1132
19987,1,1,707,1255,548
19988,0,0,16,0,-16
19989,0,0,80,0,-80
19990,1,0,44,0,-44
19991,0,0,102,0,-102
19992,1,1,125,1663,1538
19993,0,0,1,0,-1
19994,0,0,48,0,-48
19995,0,0,106,0,-106
19996,0,0,40,0,-40
19997,1,0,38,0,-38
19998,1,1,531,1233,702
19999,0,0,15,0,-15
20000,1,0,239,0,-239
20001,1,0,88,0,-88
20002,1,1,834,1304,470
20003,1,1,1389,1687,298
20004,0,0,29,0,-29
20005,1,1,1403,1647,244
20006,1,0,55,0,-55
20007,1,0,123,0,-123
20008,1,0,26,0,-26
20009,1,1,560,1952,1392
20010,1,0,22,0,-22
20011,0,0,10,0,-10
20012,1,0,24,0,-24
20013,1,0,28,0,-28
20014,1,0,0,0,0
20015,0,0,59,0,-59
20016,0,0,78,0,-78
20017,1,1,14,1706,1692
20018,1,0,90,0,-90
20019,0,0,66,0,-66
20020,0,0,17,0,-17
20021,1,0,11,0,-11
20022,0,0,115,0,-115
20023,0,0,106,0,-106
20024,0,0,39,0,-39
20025,1,0,13,0,-13
20026,1,1,457,1464,1007
20027,0,0,42,0,-42
20028,1,0,43,0,-43
20029,0,0,18,0,-18
20030,0,0,49,0,-49
20031,1,1,2212,1232,-980
20032,0,0,149,0,-149
20033,0,0,71,0,-71
20034,0,0,35,0,-35
20035,1,0,54,0,-54
20036,0,0,64,0,-64
20037,1,1,113,1609,1496
20038,1,0,33,0,-33
20039,1,0,90,0,-90
20040,1,1,126,1423,1297
20041,1,1,257,1547,1290
20042,1,1,1390,1376,-14
20043,1,0,65,0,-65
20044,1,1,1442,1473,31
20045,1,1,874,1303,429
20046,1,0,12,0,-12
20047,1,0,109,0,-109
20048,1,0,44,0,-44
20049,1,0,38,0,-38
20050,1,0,33,0,-33
20051,1,1,418,1586,1168
20052,1,0,20,0,-20
20053,0,0,14,0,-14
20054,0,0,45,0,-45
20055,1,1,249,1449,1200
20056,0,0,55,0,-55
20057,1,1,199,1225,1026
20058,0,0,2,0,-2
20059,0,0,2,0,-2
20060,0,0,28,0,-28
20061,1,1,660,1480,820
20062,0,0,62,0,-62
20063,0,0,32,0,-32
20064,1,1,2327,1361,-966
20065,0,0,3,0,-3
20066,1,1,678,1209,531
20067,0,0,8,0,-8
20068,1,0,93,0,-93
20069,1,1,404,1516,1112
20070,0,0,13,0,-13
20071,0,0,4,0,-4
20072,1,1,2411,1316,-1095
20073,0,0,29,0,-29
20074,1,1,586,1886,1300
20075,0,0,80,0,-80
20076,0,0,69,0,-69
20077,0,0,30,0,-30
20078,1,1,139,1440,1301
20079,1,1,428,1643,1215
20080,1,1,346,1879,1533
20081,0,0,0,0,0
20082,0,0,278,0,-278
20083,1,0,6,0,-6
20084,1,1,257,1709,1452
20085,1,1,240,1999,1759
20086,1,1,119,1322,1203
20087,0,0,53,0,-53
20088,1,0,25,0,-25
20089,0,0,141,0,-141
20090,1,0,3,0,-3
20091,1,1,1753,1404,-349
20092,0,0,8,0,-8
20093,0,0,13,0,-13
20094,1,0,83,0,-83
20095,1,0,31,0,-31
20096,0,0,24,0,-24
20097,1,0,11,0,-11
20098,1,1,670,2156,1486
20099,1,0,16,0,-16
20100,1,0,19,0,-19
20101,1,0,37,0,-37
20102,1,0,49,0,-49
20103,1,1,95,1429,1334
20104,0,0,12,0,-12
20105,1,0,22,0,-22
20106,1,0,26,0,-26
20107,0,0,27,0,-27
20108,0,0,120,0,-120
20109,1,1,1611,1269,-342
20110,1,1,492,1592,1100
20111,1,1,481,2191,1710
20112,0,0,122,0,-122
20113,1,1,248,1229,981
20114,1,0,23,0,-23
20115,0,0,5,0,-5
20116,0,0,56,0,-56
20117,0,0,9,0,-9
20118,1,1,1179,1659,480
20119,1,0,26,0,-26
20120,1,1,428,1230,802
20121,1,1,666,1359,693
20122,0,0,30,0,-30
20123,0,0,93,0,-93
20124,0,0,4,0,-4
20125,0,0,14,0,-14
20126,1,0,4,0,-4
20127,1,0,68,0,-68
20128,1,0,39,0,-39
20129,1,0,39,0,-39
20130,0,0,2,0,-2
20131,1,1,156,2260,2104
20132,1,0,4,0,-4
20133,1,1,492,1207,715
20134,0,0,31,0,-31
20135,1,0,42,0,-42
20136,1,0,184,0,-184
20137,1,0,40,0,-40
20138,1,1,2331,1340,-991
20139,1,0,36,0,-36
20140,1,0,23,0,-23
20141,0,0,42,0,-42
20142,1,1,429,1346,917
20143,1,1,193,1202,1009
20144,0,0,30,0,-30
20145,0,0,3,0,-3
20146,1,0,70,0,-70
20147,1,0,25,0,-25
20148,0,0,18,0,-18
20149,0,0,6,0,-6
20150,0,0,97,0,-97
20151,1,0,49,0,-49
20152,1,1,107,1255,1148
20153,0,0,38,0,-38
20154,1,0,1,0,-1
20155,1,1,524,1592,1068
20156,0,0,52,0,-52
20157,1,1,1368,1498,130
20158,1,1,738,1829,1091
20159,0,0,29,0,-29
20160,1,1,174,1387,1213
20161,1,0,20,0,-20
20162,1,1,549,1264,715
20163,0,0,56,0,-56
20164,1,0,6,0,-6
20165,1,0,12,0,-12
20166,1,0,5,0,-5
20167,0,0,2,0,-2
20168,1,1,844,1469,625
20169,0,0,51,0,-51
20170,0,0,114,0,-114
20171,1,1,1282,1435,153
20172,0,0,28,0,-28
20173,1,0,45,0,-45
20174,0,0,170,0,-170
20175,1,1,1789,1250,-539
20176,0,0,92,0,-92
20177,1,0,33,0,-33
20178,1,1,230,1977,1747
20179,1,1,1678,1240,-438
20180,1,1,93,2358,2265
20181,0,0,78,0,-78
20182,1,0,14,0,-14
20183,0,0,0,0,0
20184,1,0,181,0,-181
20185,0,0,25,0,-25
20186,1,0,16,0,-16
20187,1,1,981,1363,382
20188,0,0,23,0,-23
20189,0,0,3,0,-3
20190,0,0,219,0,-219
20191,1,0,20,0,-20
20192,1,1,904,1245,341
20193,1,1,82,1330,1248
20194,1,0,22,0,-22
20195,1,0,11,0,-11
20196,0,0,169,0,-169
20197,0,0,21,0,-21
20198,1,0,118,0,-118
20199,1,1,422,1234,812
20200,1,1,363,1618,1255
20201,0,0,29,0,-29
20202,1,1,175,1353,1178
20203,0,0,21,0,-21
20204,1,0,56,0,-56
20205,1,1,184,1485,1301
20206,0,0,61,0,-61
20207,0,0,35,0,-35
20208,0,0,7,0,-7
20209,0,0,13,0,-13
20210,0,0,7,0,-7
20211,0,0,14,0,-14
20212,1,1,184,1539,1355
20213,1,1,820,1762,942
20214,1,0,73,0,-73
20215,0,0,88,0,-88
20216,0,0,136,0,-136
20217,1,0,40,0,-40
20218,1,1,1064,1765,701
20219,0,0,83,0,-83
20220,0,0,9,0,-9
20221,0,0,115,0,-115
20222,0,0,52,0,-52
20223,0,0,60,0,-60
20224,0,0,52,0,-52
20225,0,0,55,0,-55
20226,1,1,852,1459,607
20227,1,1,534,1462,928
20228,1,0,1,0,-1
20229,1,1,2993,1227,-1766
20230,0,0,20,0,-20
20231,0,0,3,0,-3
20232,1,1,261,1454,1193
20233,1,1,224,1249,1025
20234,0,0,21,0,-21
20235,0,0,213,0,-213
20236,1,1,441,2265,1824
20237,0,0,42,0,-42
20238,0,0,188,0,-188
20239,1,0,20,0,-20
20240,1,0,19,0,-19
20241,0,0,23,0,-23
20242,0,0,24,0,-24
20243,0,0,40,0,-40
20244,1,0,25,0,-25
20245,0,0,17,0,-17
20246,1,0,43,0,-43
20247,0,0,11,0,-11
20248,1,1,332,1482,1150
20249,1,1,1124,1969,845
20250,1,1,1625,1545,-80
20251,0,0,124,0,-124
20252,0,0,41,0,-41
20253,0,0,36,0,-36
20254,0,0,36,0,-36
20255,1,1,444,1255,811
20256,1,1,484,1623,1139
20257,1,0,16,0,-16
20258,0,0,64,0,-64
20259,1,1,569,1532,963
20260,0,0,178,0,-178
20261,1,1,1660,1350,-310
20262,0,0,30,0,-30
20263,0,0,179,0,-179
20264,0,0,2,0,-2
20265,0,0,160,0,-160
20266,0,0,31,0,-31
20267,1,0,42,0,-42
20268,1,0,12,0,-12
20269,0,0,32,0,-32
20270,0,0,19,0,-19
20271,1,1,309,1613,1304
20272,1,0,2,0,-2
20273,1,1,297,1247,950
20274,1,1,1073,1394,321
20275,1,1,472,1202,730
20276,0,0,73,0,-73
20277,0,0,48,0,-48
20278,1,1,1230,1625,395
20279,0,0,31,0,-31
20280,0,0,40,0,-40
20281,1,1,86,1242,1156
20282,1,1,77,1214,1137
20283,0,0,70,0,-70
20284,1,1,1049,1476,427
20285,1,1,504,1543,1039
20286,1,0,25,0,-25
20287,1,1,351,1238,887
20288,0,0,201,0,-201
20289,0,0,51,0,-51
20290,1,1,682,1232,550
20291,1,1,132,1270,1138
20292,1,1,292,1352,1060
20293,1,0,348,0,-348
20294,1,1,253,1550,1297
20295,0,0,10,0,-10
20296,0,0,7,0,-7
20297,0,0,39,0,-39
20298,1,1,1791,1205,-586
20299,0,0,11,0,-11
20300,1,0,31,0,-31
20301,0,0,2,0,-2
20302,0,0,60,0,-60
20303,0,0,111,0,-111
20304,1,1,701,2672,1971
20305,0,0,3,0,-3
20306,0,0,39,0,-39
20307,0,0,45,0,-45
20308,0,0,19,0,-19
20309,0,0,11,0,-11
20310,0,0,25,0,-25
20311,0,0,60,0,-60
20312,0,0,19,0,-19
20313,0,0,1,0,-1
20314,1,0,0,0,0
20315,1,0,39,0,-39
20316,0,0,41,0,-41
20317,0,0,73,0,-73
20318,1,1,721,1348,627
20319,1,0,14,0,-14
20320,1,1,600,2083,1483
20321,1,1,666,1648,982
20322,1,1,751,1393,642
20323,1,1,591,1638,1047
20324,1,1,1048,2372,1324
20325,0,0,25,0,-25
20326,0,0,31,0,-31
20327,1,1,4,1262,1258
20328,1,1,420,1276,856
20329,0,0,4,0,-4
20330,1,0,15,0,-15
20331,1,0,46,0,-46
20332,0,0,2,0,-2
20333,1,0,22,0,-22
20334,1,0,118,0,-118
20335,1,1,285,1858,1573
20336,1,0,109,0,-109
20337,1,1,451,1280,829
20338,1,1,58,1573,1515
20339,1,1,1052,1232,180
20340,0,0,29,0,-29
20341,0,0,6,0,-6
20342,1,0,15,0,-15
20343,1,1,509,1359,850
20344,1,1,223,1231,1008
20345,0,0,61,0,-61
20346,1,0,69,0,-69
20347,0,0,24,0,-24
20348,1,1,510,1546,1036
20349,1,1,271,1216,945
20350,0,0,69,0,-69
20351,1,1,140,1583,1443
20352,1,0,115,0,-115
20353,1,0,202,0,-202
20354,1,1,458,1351,893
20355,0,0,88,0,-88
20356,1,0,205,0,-205
20357,1,0,134,0,-134
20358,0,0,85,0,-85
20359,1,1,69,1314,1245
20360,1,1,1500,1275,-225
20361,0,0,22,0,-22
20362,0,0,149,0,-149
20363,1,0,10,0,-10
20364,1,0,37,0,-37
20365,0,0,24,0,-24
20366,1,1,611,1397,786
20367,1,0,0,0,0
20368,0,0,45,0,-45
20369,1,1,257,1663,1406
20370,1,1,1350,2878,1528
20371,1,0,109,0,-109
20372,1,0,34,0,-34
20373,0,0,111,0,-111
20374,1,0,13,0,-13
20375,1,0,73,0,-73
20376,0,0,62,0,-62
20377,1,0,21,0,-21
20378,0,0,20,0,-20
20379,1,1,670,1231,561
20380,0,0,29,0,-29
20381,0,0,1,0,-1
20382,1,1,1343,1792,449
20383,0,0,44,0,-44
20384,1,0,69,0,-69
20385,1,0,1,0,-1
20386,1,1,214,1411,1197
20387,1,0,70,0,-70
20388,0,0,114,0,-114
20389,1,1,488,1303,815
20390,0,0,24,0,-24
20391,0,0,78,0,-78
20392,1,1,514,1266,752
20393,1,1,93,1243,1150
20394,0,0,5,0,-5
20395,1,0,4,0,-4
20396,0,0,8,0,-8
20397,1,1,59,1488,1429
20398,1,1,1284,1282,-2
20399,1,0,10,0,-10
20400,0,0,35,0,-35
20401,0,0,0,0,0
20402,1,1,219,1203,984
20403,1,1,470,1256,786
20404,0,0,0,0,0
20405,1,1,428,1851,1423
20406,0,0,12,0,-12
20407,1,0,13,0,-13
20408,1,0,107,0,-107
20409,1,0,27,0,-27
20410,0,0,7,0,-7
20411,1,0,21,0,-21
20412,0,0,33,0,-33
20413,0,0,9,0,-9
20414,0,0,193,0,-193
20415,0,0,140,0,-140
20416,1,1,528,1215,687
20417,1,1,475,2789,2314
20418,1,1,839,1338,499
20419,1,0,39,0,-39
20420,1,1,515,1210,695
20421,0,0,141,0,-141
20422,1,1,761,1246,485
20423,1,0,91,0,-91
20424,0,0,9,0,-9
20425,1,1,1337,1590,253
20426,0,0,0,0,0
20427,1,1,558,1276,718
20428,1,0,40,0,-40
20429,1,1,979,1268,289
20430,1,1,436,1216,780
20431,1,0,12,0,-12
20432,1,0,104,0,-104
20433,0,0,0,0,0
20434,0,0,89,0,-89
20435,1,0,12,0,-12
20436,1,1,293,1266,973
20437,0,0,43,0,-43
20438,1,0,14,0,-14
20439,0,0,55,0,-55
20440,1,0,154,0,-154
20441,1,1,1241,1305,64
20442,1,1,505,1212,707
20443,0,0,109,0,-109
20444,1,1,90,1443,1353
20445,1,0,21,0,-21
20446,1,0,24,0,-24
20447,1,0,2,0,-2
20448,1,0,48,0,-48
20449,0,0,17,0,-17
20450,0,0,20,0,-20
20451,1,1,238,1557,1319
20452,1,1,49,1269,1220
20453,0,0,63,0,-63
20454,0,0,85,0,-85
20455,0,0,2,0,-2
20456,0,0,2,0,-2
20457,1,0,14,0,-14
20458,0,0,10,0,-10
20459,1,1,93,1237,1144
20460,0,0,36,0,-36
20461,1,1,424,1240,816
20462,0,0,22,0,-22
20463,0,0,1,0,-1
20464,0,0,44,0,-44
20465,1,1,270,1838,1568
20466,1,0,23,0,-23
20467,1,1,675,1218,543
20468,0,0,39,0,-39
20469,1,1,1009,1250,241
20470,0,0,27,0,-27
20471,0,0,31,0,-31
20472,1,1,935,2098,1163
20473,1,0,36,0,-36
20474,1,0,7,0,-7
20475,1,0,53,0,-53
20476,0,0,27,0,-27
20477,1,1,242,3118,2876
20478,1,1,195,1290,1095
20479,1,0,45,0,-45
20480,1,0,145,0,-145
20481,1,1,657,2068,1411
20482,1,1,213,1203,990
20483,1,1,820,1466,646
20484,1,0,25,0,-25
20485,1,1,539,1525,986
20486,0,0,202,0,-202
20487,1,0,40,0,-40
20488,1,0,26,0,-26
20489,0,0,81,0,-81
20490,1,0,59,0,-59
20491,0,0,138,0,-138
20492,1,0,8,0,-8
20493,0,0,16,0,-16
20494,0,0,114,0,-114
20495,0,0,35,0,-35
20496,0,0,37,0,-37
20497,0,0,1,0,-1
20498,0,0,3,0,-3
20499,1,1,740,1222,482
20500,0,0,162,0,-162
20501,0,0,18,0,-18
20502,1,1,962,1298,336
20503,1,0,26,0,-26
20504,1,1,390,1229,839
20505,1,0,26,0,-26
20506,1,1,521,2257,1736
20507,1,1,1569,1755,186
20508,0,0,42,0,-42
20509,0,0,27,0,-27
20510,0,0,10,0,-10
20511,1,0,6,0,-6
20512,1,0,157,0,-157
20513,1,1,97,1478,1381
20514,1,1,231,1616,1385
20515,1,0,117,0,-117
20516,1,1,1786,1352,-434
20517,1,1,108,1330,1222
20518,1,0,81,0,-81
20519,1,0,166,0,-166
20520,1,0,5,0,-5
20521,0,0,33,0,-33
20522,1,0,13,0,-13
20523,1,0,4,0,-4
20524,0,0,67,0,-67
20525,1,1,123,1530,1407
20526,1,1,104,1511,1407
20527,1,0,84,0,-84
20528,1,1,309,1277,968
20529,1,1,1515,1366,-149
20530,1,0,52,0,-52
20531,0,0,22,0,-22
20532,1,0,25,0,-25
20533,1,0,79,0,-79
20534,1,0,68,0,-68
20535,0,0,3,0,-3
20536,1,0,32,0,-32
20537,1,1,538,3359,2821
20538,0,0,15,0,-15
20539,1,1,33,2013,1980
20540,1,1,365,1347,982
20541,0,0,4,0,-4
20542,1,1,163,1553,1390
20543,0,0,8,0,-8
20544,0,0,9,0,-9
20545,1,0,13,0,-13
20546,1,0,55,0,-55
20547,1,1,964,1426,462
20548,0,0,1,0,-1
20549,0,0,20,0,-20
20550,1,0,16,0,-16
20551,0,0,52,0,-52
20552,0,0,3,0,-3
20553,1,1,907,1221,314
20554,0,0,63,0,-63
20555,0,0,14,0,-14
20556,1,1,287,1203,916
20557,0,0,4,0,-4
20558,1,1,667,5750,5083
20559,0,0,9,0,-9
20560,1,1,87,2009,1922
20561,0,0,25,0,-25
20562,1,1,380,1910,1530
20563,0,0,0,0,0
20564,0,0,9,0,-9
20565,0,0,1,0,-1
20566,1,0,68,0,-68
20567,1,0,19,0,-19
20568,1,1,256,1310,1054
20569,1,1,466,1204,738
20570,1,0,7,0,-7
20571,0,0,35,0,-35
20572,1,1,2260,1579,-681
20573,1,1,84,1624,1540
20574,1,1,138,1449,1311
20575,1,1,91,1647,1556
20576,0,0,54,0,-54
20577,0,0,33,0,-33
20578,1,1,643,1211,568
20579,1,0,36,0,-36
20580,1,1,216,1538,1322
20581,0,0,143,0,-143
20582,0,0,27,0,-27
20583,1,0,143,0,-143
20584,1,0,92,0,-92
20585,0,0,50,0,-50
20586,0,0,17,0,-17
20587,1,0,96,0,-96
20588,1,1,76,1403,1327
20589,0,0,23,0,-23
20590,0,0,24,0,-24
20591,1,1,693,1558,865
20592,1,0,30,0,-30
20593,0,0,36,0,-36
20594,1,1,279,1745,1466
20595,1,1,1351,1399,48
20596,0,0,23,0,-23
20597,1,1,1039,1782,743
20598,1,0,23,0,-23
20599,1,1,932,1927,995
20600,0,0,53,0,-53
20601,1,1,469,1691,1222
20602,0,0,402,0,-402
20603,1,1,1056,1520,464
20604,1,1,320,1233,913
20605,1,0,101,0,-101
20606,0,0,7,0,-7
20607,1,0,62,0,-62
20608,1,1,1099,1497,398
20609,0,0,19,0,-19
20610,0,0,34,0,-34
20611,1,0,39,0,-39
20612,1,0,93,0,-93
20613,0,0,28,0,-28
20614,0,0,10,0,-10
20615,0,0,48,0,-48
20616,1,1,75,1543,1468
20617,1,1,303,1331,1028
20618,1,0,27,0,-27
20619,1,1,259,1260,1001
20620,1,0,53,0,-53
20621,0,0,14,0,-14
20622,0,0,13,0,-13
20623,1,0,11,0,-11
20624,1,0,8,0,-8
20625,1,0,1,0,-1
20626,1,1,271,1210,939
20627,0,0,29,0,-29
20628,1,1,179,1971,1792
20629,1,1,55,1474,1419
20630,1,0,69,0,-69
20631,1,1,1225,1247,22
20632,1,1,297,1392,1095
20633,1,1,243,1417,1174
20634,1,1,501,1315,814
20635,0,0,23,0,-23
20636,1,1,113,1282,1169
20637,1,1,610,1660,1050
20638,0,0,59,0,-59
20639,1,0,30,0,-30
20640,1,0,16,0,-16
20641,1,1,198,1490,1292
20642,1,1,154,2084,1930
20643,1,1,160,1507,1347
20644,1,0,5,0,-5
20645,1,1,645,1273,628
20646,1,1,69,2045,1976
20647,1,0,47,0,-47
20648,1,0,2,0,-2
20649,1,0,24,0,-24
20650,1,0,20,0,-20
20651,1,0,122,0,-122
20652,1,1,603,1358,755
20653,1,0,74,0,-74
20654,0,0,6,0,-6
20655,1,1,664,1700,1036
20656,0,0,10,0,-10
20657,1,1,394,1395,1001
20658,1,1,233,2188,1955
20659,1,0,3,0,-3
20660,1,1,244,3426,3182
20661,1,0,65,0,-65
20662,0,0,18,0,-18
20663,1,0,64,0,-64
20664,1,0,12,0,-12
20665,0,0,9,0,-9
20666,1,0,95,0,-95
20667,1,0,31,0,-31
20668,1,1,258,1732,1474
20669,1,0,8,0,-8
20670,0,0,36,0,-36
20671,1,1,185,1370,1185
20672,0,0,90,0,-90
20673,0,0,184,0,-184
20674,1,0,171,0,-171
20675,1,1,511,1682,1171
20676,1,0,123,0,-123
20677,1,1,288,1601,1313
20678,0,0,6,0,-6
20679,1,0,9,0,-9
20680,1,0,25,0,-25
20681,0,0,1,0,-1
20682,1,1,398,1245,847
20683,1,1,348,1492,1144
20684,1,0,116,0,-116
20685,0,0,70,0,-70
20686,1,1,420,1436,1016
20687,1,1,503,1438,935
20688,1,0,11,0,-11
20689,1,1,255,2136,1881
20690,1,1,1662,1486,-176
20691,1,1,45,1347,1302
20692,1,0,35,0,-35
20693,0,0,78,0,-78
20694,0,0,70,0,-70
20695,0,0,8,0,-8
20696,1,0,39,0,-39
20697,1,0,131,0,-131
20698,1,0,5,0,-5
20699,1,1,338,1774,1436
20700,1,1,406,1265,859
20701,1,1,1596,1444,-152
20702,0,0,33,0,-33
20703,1,1,57,1449,1392
20704,1,0,6,0,-6
20705,1,1,119,2180,2061
20706,1,1,176,1473,1297
20707,0,0,216,0,-216
20708,1,0,30,0,-30
20709,0,0,2,0,-2
20710,1,1,1153,1779,626
20711,1,0,25,0,-25
20712,1,1,161,3673,3512
20713,0,0,47,0,-47
20714,1,0,8,0,-8
20715,0,0,6,0,-6
20716,0,0,27,0,-27
20717,1,0,67,0,-67
20718,1,0,0,0,0
20719,1,1,221,1257,1036
20720,0,0,64,0,-64
20721,1,0,88,0,-88
20722,1,0,74,0,-74
20723,1,0,40,0,-40
20724,1,0,7,0,-7
20725,0,0,121,0,-121
20726,1,0,5,0,-5
20727,0,0,37,0,-37
20728,1,1,346,1557,1211
20729,0,0,83,0,-83
20730,0,0,153,0,-153
20731,0,0,58,0,-58
20732,1,1,418,1226,808
20733,1,0,22,0,-22
20734,1,0,2,0,-2
20735,1,1,844,1224,380
20736,1,0,20,0,-20
20737,1,0,71,0,-71
20738,0,0,1,0,-1
20739,0,0,22,0,-22
20740,0,0,23,0,-23
20741,1,1,371,1625,1254
20742,1,0,64,0,-64
20743,1,0,11,0,-11
20744,1,1,552,1998,1446
20745,1,0,99,0,-99
20746,1,0,24,0,-24
20747,1,1,127,1523,1396
20748,1,0,28,0,-28
20749,0,0,0,0,0
20750,0,0,127,0,-127
20751,1,0,1,0,-1
20752,0,0,123,0,-123
20753,0,0,22,0,-22
20754,1,0,65,0,-65
20755,0,0,8,0,-8
20756,0,0,23,0,-23
20757,0,0,111,0,-111
20758,1,0,0,0,0
20759,0,0,24,0,-24
20760,0,0,19,0,-19
20761,0,0,114,0,-114
20762,1,1,278,1219,941
20763,1,0,69,0,-69
20764,1,1,1065,1298,233
20765,0,0,127,0,-127
20766,0,0,2,0,-2
20767,1,0,32,0,-32
20768,1,0,99,0,-99
20769,0,0,33,0,-33
20770,0,0,1,0,-1
20771,1,0,78,0,-78
20772,1,1,172,1330,1158
20773,0,0,72,0,-72
20774,0,0,19,0,-19
20775,0,0,51,0,-51
20776,0,0,127,0,-127
20777,0,0,1,0,-1
20778,1,0,61,0,-61
20779,1,1,702,1832,1130
20780,1,1,398,1229,831
20781,0,0,40,0,-40
20782,1,1,677,1392,715
20783,1,1,1326,2297,971
20784,1,0,76,0,-76
20785,0,0,14,0,-14
20786,0,0,44,0,-44
20787,0,0,17,0,-17
20788,1,1,915,1263,348
20789,1,0,51,0,-51
20790,1,1,128,1639,1511
20791,1,1,501,1560,1059
20792,0,0,122,0,-122
20793,0,0,115,0,-115
20794,1,1,223,1480,1257
20795,1,0,118,0,-118
20796,1,0,3,0,-3
20797,0,0,207,0,-207
20798,0,0,349,0,-349
20799,1,1,289,1389,1100
20800,1,1,2606,1445,-1161
20801,1,0,13,0,-13
20802,1,1,1263,1781,518
20803,0,0,195,0,-195
20804,1,1,164,1290,1126
20805,0,0,18,0,-18
20806,1,1,122,2120,1998
20807,0,0,0,0,0
20808,1,0,70,0,-70
20809,0,0,125,0,-125
20810,1,0,72,0,-72
20811,0,0,29,0,-29
20812,1,0,85,0,-85
20813,0,0,51,0,-51
20814,0,0,86,0,-86
20815,0,0,41,0,-41
20816,1,1,264,1604,1340
20817,1,0,93,0,-93
20818,0,0,18,0,-18
20819,1,1,694,1993,1299
20820,1,1,2827,1847,-980
20821,1,0,17,0,-17
20822,0,0,74,0,-74
20823,1,1,1017,3217,2200
20824,1,1,1152,1654,502
20825,0,0,14,0,-14
20826,1,1,482,1227,745
20827,1,0,33,0,-33
20828,0,0,39,0,-39
20829,1,0,42,0,-42
20830,0,0,14,0,-14
20831,0,0,1,0,-1
20832,0,0,97,0,-97
20833,0,0,17,0,-17
20834,1,1,667,1679,1012
20835,1,1,178,1586,1408
20836,1,0,7,0,-7
20837,1,1,853,1915,1062
20838,0,0,16,0,-16
20839,0,0,8,0,-8
20840,0,0,6,0,-6
20841,0,0,23,0,-23
20842,1,0,11,0,-11
20843,1,1,78,1205,1127
20844,0,0,10,0,-10
20845,0,0,66,0,-66
20846,0,0,95,0,-95
20847,1,1,220,1573,1353
20848,1,0,81,0,-81
20849,0,0,64,0,-64
20850,1,1,910,1367,457
20851,1,0,14,0,-14
20852,1,0,59,0,-59
20853,0,0,5,0,-5
20854,1,0,17,0,-17
20855,1,1,625,1617,992
20856,0,0,79,0,-79
20857,1,0,63,0,-63
20858,1,0,41,0,-41
20859,0,0,2,0,-2
20860,1,1,351,1243,892
20861,1,1,308,1347,1039
20862,1,1,505,1612,1107
20863,1,0,59,0,-59
20864,1,0,75,0,-75
20865,1,1,299,1204,905
20866,0,0,106,0,-106
20867,1,1,97,1282,1185
20868,1,0,28,0,-28
20869,0,0,118,0,-118
20870,1,1,661,1697,1036
20871,1,0,119,0,-119
20872,1,1,13,1314,1301
20873,1,1,225,1364,1139
20874,0,0,18,0,-18
20875,1,0,35,0,-35
20876,1,0,110,0,-110
20877,1,1,720,1303,583
20878,1,1,243,1326,1083
20879,1,0,78,0,-78
20880,0,0,53,0,-53
20881,1,1,210,1256,1046
20882,0,0,57,0,-57
20883,1,0,31,0,-31
20884,1,0,92,0,-92
20885,0,0,42,0,-42
20886,1,1,108,1234,1126
20887,1,1,150,1387,1237
20888,1,0,2,0,-2
20889,0,0,96,0,-96
20890,1,1,252,1206,954
20891,0,0,9,0,-9
20892,0,0,2,0,-2
20893,0,0,39,0,-39
20894,1,0,1,0,-1
20895,1,0,2,0,-2
20896,0,0,48,0,-48
20897,0,0,117,0,-117
20898,1,0,8,0,-8
20899,1,0,17,0,-17
20900,0,0,16,0,-16
20901,1,1,65,1733,1668
20902,1,0,32,0,-32
20903,1,0,3,0,-3
20904,1,1,47,1281,1234
20905,1,0,31,0,-31
20906,1,1,590,1617,1027
20907,1,0,39,0,-39
20908,1,1,705,1413,708
20909,0,0,115,0,-115
20910,1,0,115,0,-115
20911,1,0,29,0,-29
20912,0,0,41,0,-41
20913,1,0,3,0,-3
20914,0,0,30,0,-30
20915,1,0,5,0,-5
20916,1,1,74,2093,2019
20917,1,0,17,0,-17
20918,1,0,3,0,-3
20919,1,1,1670,1539,-131
20920,0,0,143,0,-143
20921,1,0,11,0,-11
20922,1,0,173,0,-173
20923,0,0,77,0,-77
20924,0,0,128,0,-128
20925,1,1,917,1306,389
20926,1,0,116,0,-116
20927,0,0,8,0,-8
20928,0,0,75,0,-75
20929,1,1,56,1412,1356
20930,1,0,25,0,-25
20931,1,1,539,1717,1178
20932,1,1,516,1651,1135
20933,0,0,15,0,-15
20934,0,0,33,0,-33
20935,1,1,2149,1880,-269
20936,1,0,15,0,-15
20937,0,0,31,0,-31
20938,0,0,41,0,-41
20939,1,0,58,0,-58
20940,0,0,22,0,-22
20941,0,0,83,0,-83
20942,1,1,501,1420,919
20943,0,0,27,0,-27
20944,1,1,90,1246,1156
20945,1,1,602,1912,1310
20946,0,0,8,0,-8
20947,0,0,80,0,-80
20948,1,0,17,0,-17
20949,0,0,13,0,-13
20950,0,0,74,0,-74
20951,0,0,23,0,-23
20952,0,0,75,0,-75
20953,0,0,81,0,-81
20954,1,0,4,0,-4
20955,0,0,101,0,-101
20956,1,0,39,0,-39
20957,1,1,993,1612,619
20958,0,0,95,0,-95
20959,0,0,142,0,-142
20960,1,1,227,1444,1217
20961,1,0,61,0,-61
20962,1,0,39,0,-39
20963,1,1,152,1214,1062
20964,1,1,242,2142,1900
20965,0,0,18,0,-18
20966,1,1,374,2271,1897
20967,0,0,34,0,-34
20968,0,0,22,0,-22
20969,0,0,120,0,-120
20970,1,0,80,0,-80
20971,1,0,0,0,0
20972,1,1,985,1500,515
20973,1,0,48,0,-48
20974,1,0,7,0,-7
20975,1,1,795,1270,475
20976,1,1,911,1264,353
20977,1,0,25,0,-25
20978,1,1,647,1288,641
20979,1,1,2188,1210,-978
20980,1,0,40,0,-40
20981,1,1,1470,1517,47
20982,1,0,120,0,-120
20983,0,0,32,0,-32
20984,0,0,17,0,-17
20985,1,0,43,0,-43
20986,1,0,122,0,-122
20987,1,0,5,0,-5
20988,0,0,98,0,-98
20989,1,1,267,1303,1036
20990,1,0,142,0,-142
20991,0,0,6,0,-6
20992,0,0,279,0,-279
20993,0,0,26,0,-26
20994,1,1,13,1718,1705
20995,0,0,30,0,-30
20996,1,1,578,1307,729
20997,0,0,20,0,-20
20998,1,1,111,1207,1096
20999,0,0,13,0,-13
21000,1,0,1,0,-1
21001,1,0,11,0,-11
21002,0,0,14,0,-14
21003,1,0,19,0,-19
21004,1,1,1305,1640,335
21005,1,0,34,0,-34
21006,1,1,572,1283,711
21007,1,0,111,0,-111
21008,1,1,734,1870,1136
21009,0,0,173,0,-173
21010,1,1,692,1222,530
21011,1,0,34,0,-34
21012,0,0,2,0,-2
21013,1,1,277,1305,1028
21014,1,0,82,0,-82
21015,0,0,16,0,-16
21016,1,1,694,1228,534
21017,1,0,55,0,-55
21018,0,0,106,0,-106
21019,1,0,29,0,-29
21020,0,0,17,0,-17
21021,1,0,44,0,-44
21022,1,1,314,1636,1322
21023,0,0,80,0,-80
21024,1,0,9,0,-9
21025,1,0,9,0,-9
21026,1,1,1598,1417,-181
21027,0,0,77,0,-77
21028,0,0,224,0,-224
21029,0,0,18,0,-18
21030,1,1,248,1442,1194
21031,1,1,212,1637,1425
21032,0,0,6,0,-6
21033,1,0,25,0,-25
21034,0,0,59,0,-59
21035,0,0,2,0,-2
21036,1,0,120,0,-120
21037,1,1,825,2189,1364
21038,1,1,258,1295,1037
21039,1,0,14,0,-14
21040,1,1,175,2318,2143
21041,0,0,122,0,-122
21042,1,0,101,0,-101
21043,1,1,183,1337,1154
21044,1,0,174,0,-174
21045,0,0,44,0,-44
21046,1,0,31,0,-31
21047,1,0,8,0,-8
21048,1,1,69,1218,1149
21049,1,0,6,0,-6
21050,1,1,185,1800,1615
21051,1,0,28,0,-28
21052,0,0,26,0,-26
21053,1,0,171,0,-171
21054,1,1,3533,1359,-2174
21055,1,0,59,0,-59
21056,1,0,1,0,-1
21057,1,0,39,0,-39
21058,1,0,15,0,-15
21059,0,0,141,0,-141
21060,1,0,132,0,-132
21061,1,0,18,0,-18
21062,0,0,1,0,-1
21063,1,0,15,0,-15
21064,0,0,123,0,-123
21065,1,1,1125,1285,160
21066,1,1,2318,2614,296
21067,1,0,14,0,-14
21068,1,0,8,0,-8
21069,1,0,3,0,-3
21070,0,0,141,0,-141
21071,0,0,5,0,-5
21072,1,0,15,0,-15
21073,0,0,30,0,-30
21074,1,0,24,0,-24
21075,1,1,365,1264,899
21076,1,1,191,1368,1177
21077,0,0,11,0,-11
21078,0,0,5,0,-5
21079,0,0,73,0,-73
21080,0,0,68,0,-68
21081,1,1,480,1370,890
21082,0,0,8,0,-8
21083,0,0,36,0,-36
21084,0,0,40,0,-40
21085,1,1,154,1849,1695
21086,0,0,4,0,-4
21087,1,1,190,1594,1404
21088,1,1,432,1869,1437
21089,0,0,87,0,-87
21090,1,0,57,0,-57
21091,0,0,56,0,-56
21092,1,1,65,1261,1196
21093,1,0,54,0,-54
21094,0,0,61,0,-61
21095,1,0,95,0,-95
21096,1,1,117,1290,1173
21097,1,0,7,0,-7
21098,1,0,28,0,-28
21099,1,0,2,0,-2
21100,1,1,588,1454,866
21101,1,1,27,1497,1470
21102,1,1,815,1820,1005
21103,1,0,6,0,-6
21104,1,1,61,1460,1399
21105,1,0,16,0,-16
21106,1,1,196,2079,1883
21107,1,0,20,0,-20
21108,1,1,145,1437,1292
21109,0,0,21,0,-21
21110,1,1,1044,1332,288
21111,1,0,13,0,-13
21112,0,0,12,0,-12
21113,0,0,6,0,-6
21114,0,0,19,0,-19
21115,0,0,8,0,-8
21116,0,0,83,0,-83
21117,1,1,192,1317,1125
21118,1,0,186,0,-186
21119,1,1,1152,1334,182
21120,0,0,18,0,-18
21121,1,1,390,1348,958
21122,1,1,202,1278,1076
21123,1,0,24,0,-24
21124,1,1,90,1693,1603
21125,0,0,77,0,-77
21126,1,0,46,0,-46
21127,0,0,119,0,-119
21128,1,1,158,1318,1160
21129,1,0,11,0,-11
21130,0,0,66,0,-66
21131,0,0,24,0,-24
21132,0,0,34,0,-34
21133,1,0,43,0,-43
21134,0,0,15,0,-15
21135,0,0,2,0,-2
21136,1,1,15,1276,1261
21137,0,0,4,0,-4
21138,1,1,136,2389,2253
21139,1,1,1696,1444,-252
21140,1,1,455,1951,1496
21141,0,0,93,0,-93
21142,1,0,95,0,-95
21143,1,0,109,0,-109
21144,1,1,2227,1302,-925
21145,1,0,25,0,-25
21146,1,0,53,0,-53
21147,0,0,39,0,-39
21148,0,0,19,0,-19
21149,1,0,125,0,-125
21150,1,0,11,0,-11
21151,0,0,62,0,-62
21152,0,0,82,0,-82
21153,0,0,83,0,-83
21154,1,0,140,0,-140
21155,0,0,64,0,-64
21156,0,0,51,0,-51
21157,0,0,108,0,-108
21158,1,0,63,0,-63
21159,1,1,1095,1384,289
21160,1,0,2,0,-2
21161,0,0,2,0,-2
21162,0,0,155,0,-155
21163,1,0,117,0,-117
21164,1,0,3,0,-3
21165,0,0,8,0,-8
21166,0,0,111,0,-111
21167,0,0,6,0,-6
21168,1,1,1231,1287,56
21169,1,0,6,0,-6
21170,1,1,79,1496,1417
21171,1,1,710,1823,1113
21172,1,0,156,0,-156
21173,0,0,0,0,0
21174,0,0,45,0,-45
21175,0,0,35,0,-35
21176,0,0,39,0,-39
21177,0,0,109,0,-109
21178,0,0,42,0,-42
21179,1,0,9,0,-9
21180,1,0,3,0,-3
21181,1,0,26,0,-26
21182,0,0,11,0,-11
21183,1,0,5,0,-5
21184,1,1,461,1306,845
21185,0,0,35,0,-35
21186,1,0,26,0,-26
21187,0,0,176,0,-176
21188,0,0,15,0,-15
21189,1,0,38,0,-38
21190,1,1,382,1488,1106
21191,1,0,18,0,-18
21192,1,0,40,0,-40
21193,0,0,89,0,-89
21194,1,1,2868,1285,-1583
21195,0,0,30,0,-30
21196,1,1,917,1760,843
21197,1,1,213,1525,1312
21198,1,1,345,1370,1025
21199,0,0,142,0,-142
21200,1,0,102,0,-102
21201,1,0,148,0,-148
21202,0,0,18,0,-18
21203,1,0,9,0,-9
21204,0,0,34,0,-34
21205,1,1,914,1258,344
21206,1,0,9,0,-9
21207,1,1,220,1279,1059
21208,1,1,833,1403,570
21209,0,0,31,0,-31
21210,1,0,36,0,-36
21211,0,0,45,0,-45
21212,1,0,13,0,-13
21213,1,0,9,0,-9
21214,1,1,306,1205,899
21215,1,1,496,1613,1117
21216,1,1,502,1206,704
21217,1,0,135,0,-135
21218,0,0,125,0,-125
21219,0,0,214,0,-214
21220,1,0,5,0,-5
21221,1,0,13,0,-13
21222,0,0,15,0,-15
21223,0,0,114,0,-114
21224,1,0,80,0,-80
21225,0,0,25,0,-25
21226,1,0,211,0,-211
21227,1,0,70,0,-70
21228,1,1,769,1661,892
21229,1,0,28,0,-28
21230,1,1,440,1223,783
21231,1,1,120,1356,1236
21232,1,0,35,0,-35
21233,1,1,312,1327,1015
21234,1,0,33,0,-33
21235,0,0,19,0,-19
21236,1,1,1045,1710,665
21237,0,0,144,0,-144
21238,1,0,42,0,-42
21239,1,1,41,1504,1463
21240,0,0,3,0,-3
21241,0,0,7,0,-7
21242,1,0,17,0,-17
21243,1,0,8,0,-8
21244,1,0,143,0,-143
21245,1,0,51,0,-51
21246,0,0,123,0,-123
21247,1,1,124,1276,1152
21248,1,0,12,0,-12
21249,0,0,43,0,-43
21250,1,0,75,0,-75
21251,1,1,1454,1792,338
21252,0,0,39,0,-39
21253,1,0,32,0,-32
21254,1,0,59,0,-59
21255,1,0,6,0,-6
21256,1,1,436,1343,907
21257,1,0,69,0,-69
21258,0,0,34,0,-34
21259,1,0,108,0,-108
21260,1,1,116,1260,1144
21261,1,1,79,1490,1411
21262,1,1,122,1235,1113
21263,0,0,18,0,-18
21264,1,1,409,1343,934
21265,1,1,196,1353,1157
21266,1,1,241,1299,1058
21267,1,0,118,0,-118
21268,1,1,77,1470,1393
21269,0,0,12,0,-12
21270,1,1,393,1496,1103
21271,1,0,15,0,-15
21272,0,0,7,0,-7
21273,1,1,331,1223,892
21274,1,0,79,0,-79
21275,1,0,16,0,-16
21276,1,0,5,0,-5
21277,1,0,14,0,-14
21278,0,0,22,0,-22
21279,1,0,99,0,-99
21280,1,0,29,0,-29
21281,1,1,276,1262,986
21282,1,0,47,0,-47
21283,1,1,436,1226,790
21284,1,1,1002,1736,734
21285,1,1,970,1323,353
21286,0,0,41,0,-41
21287,1,1,78,1278,1200
21288,1,0,104,0,-104
21289,0,0,39,0,-39
21290,1,0,79,0,-79
21291,1,0,17,0,-17
21292,0,0,7,0,-7
21293,1,0,64,0,-64
21294,1,1,425,1480,1055
21295,1,0,33,0,-33
21296,1,0,16,0,-16
21297,1,1,614,1228,614
21298,0,0,102,0,-102
21299,1,0,35,0,-35
21300,0,0,133,0,-133
21301,1,0,9,0,-9
21302,0,0,16,0,-16
21303,0,0,4,0,-4
21304,1,0,6,0,-6
21305,0,0,1,0,-1
21306,0,0,97,0,-97
21307,1,1,51,3975,3924
21308,1,1,40,2134,2094
21309,0,0,170,0,-170
21310,0,0,95,0,-95
21311,1,1,430,1842,1412
21312,1,1,487,4292,3805
21313,0,0,9,0,-9
21314,0,0,4,0,-4
21315,1,0,29,0,-29
21316,0,0,27,0,-27
21317,1,1,84,1491,1407
21318,1,1,69,1238,1169
21319,1,1,633,1340,707
21320,1,1,161,1266,1105
21321,1,1,88,1496,1408
21322,0,0,12,0,-12
21323,0,0,56,0,-56
21324,0,0,12,0,-12
21325,1,0,46,0,-46
21326,1,1,1920,1250,-670
21327,0,0,22,0,-22
21328,0,0,5,0,-5
21329,1,0,5,0,-5
21330,1,0,33,0,-33
21331,1,0,40,0,-40
21332,0,0,19,0,-19
21333,0,0,20,0,-20
21334,1,1,548,1537,989
21335,1,1,104,1507,1403
21336,1,1,167,1461,1294
21337,0,0,31,0,-31
21338,1,0,36,0,-36
21339,1,1,367,1223,856
21340,1,0,9,0,-9
21341,0,0,5,0,-5
21342,0,0,0,0,0
21343,0,0,46,0,-46
21344,1,1,482,2740,2258
21345,1,0,29,0,-29
21346,1,0,58,0,-58
21347,0,0,22,0,-22
21348,1,1,178,1313,1135
21349,1,1,1122,1431,309
21350,1,0,51,0,-51
21351,0,0,118,0,-118
21352,0,0,43,0,-43
21353,1,0,155,0,-155
21354,1,0,57,0,-57
21355,0,0,37,0,-37
21356,1,1,405,1264,859
21357,0,0,4,0,-4
21358,1,0,59,0,-59
21359,0,0,71,0,-71
21360,1,1,413,1596,1183
21361,0,0,6,0,-6
21362,1,1,464,1833,1369
21363,0,0,2,0,-2
21364,0,0,65,0,-65
21365,1,0,125,0,-125
21366,0,0,12,0,-12
21367,1,0,12,0,-12
21368,0,0,13,0,-13
21369,0,0,217,0,-217
21370,0,0,102,0,-102
21371,0,0,109,0,-109
21372,1,1,219,1275,1056
21373,1,0,54,0,-54
21374,0,0,63,0,-63
21375,0,0,2,0,-2
21376,0,0,22,0,-22
21377,1,0,47,0,-47
21378,1,0,3,0,-3
21379,1,1,1225,1232,7
21380,0,0,5,0,-5
21381,0,0,13,0,-13
21382,1,1,42,1378,1336
21383,0,0,11,0,-11
21384,1,0,12,0,-12
21385,1,1,952,1414,462
21386,1,1,451,1299,848
21387,1,0,20,0,-20
21388,1,1,235,1336,1101
21389,1,0,18,0,-18
21390,1,0,150,0,-150
21391,1,1,1120,1338,218
21392,1,1,119,1354,1235
21393,1,0,7,0,-7
21394,1,0,56,0,-56
21395,0,0,6,0,-6
21396,0,0,26,0,-26
21397,1,1,1648,1423,-225
21398,1,0,57,0,-57
21399,1,0,30,0,-30
21400,1,0,310,0,-310
21401,1,1,894,1598,704
21402,1,0,13,0,-13
21403,1,1,212,1284,1072
21404,1,0,2,0,-2
21405,1,0,80,0,-80
21406,1,1,184,1325,1141
21407,1,1,604,1227,623
21408,1,0,20,0,-20
21409,0,0,23,0,-23
21410,1,1,606,2221,1615
21411,1,0,5,0,-5
21412,1,1,53,1391,1338
21413,1,1,202,2339,2137
21414,0,0,35,0,-35
21415,1,0,12,0,-12
21416,0,0,24,0,-24
21417,0,0,24,0,-24
21418,0,0,26,0,-26
21419,0,0,29,0,-29
21420,0,0,22,0,-22
21421,1,0,17,0,-17
21422,0,0,26,0,-26
21423,1,1,1723,1657,-66
21424,1,0,100,0,-100
21425,1,0,90,0,-90
21426,0,0,8,0,-8
21427,1,1,413,1525,1112
21428,0,0,36,0,-36
21429,1,0,47,0,-47
21430,0,0,70,0,-70
21431,0,0,12,0,-12
21432,0,0,13,0,-13
21433,1,1,1061,1205,144
21434,0,0,42,0,-42
21435,0,0,51,0,-51
21436,0,0,15,0,-15
21437,1,0,51,0,-51
21438,1,1,717,4690,3973
21439,1,1,857,1338,481
21440,1,1,722,1325,603
21441,1,0,24,0,-24
21442,0,0,56,0,-56
21443,1,0,48,0,-48
21444,1,0,29,0,-29
21445,1,0,73,0,-73
21446,1,0,16,0,-16
21447,1,0,20,0,-20
21448,1,0,8,0,-8
21449,1,1,129,2819,2690
21450,1,1,386,1295,909
21451,0,0,42,0,-42
21452,1,0,58,0,-58
21453,1,0,38,0,-38
21454,1,1,37,1672,1635
21455,0,0,91,0,-91
21456,1,1,132,1786,1654
21457,1,1,477,1818,1341
21458,1,0,8,0,-8
21459,1,0,0,0,0
21460,0,0,47,0,-47
21461,1,0,54,0,-54
21462,1,0,81,0,-81
21463,0,0,65,0,-65
21464,1,0,20,0,-20
21465,0,0,17,0,-17
21466,1,0,3,0,-3
21467,0,0,25,0,-25
21468,1,0,22,0,-22
21469,1,1,237,1525,1288
21470,0,0,53,0,-53
21471,0,0,62,0,-62
21472,0,0,13,0,-13
21473,1,0,105,0,-105
21474,1,1,362,1819,1457
21475,1,0,2,0,-2
21476,1,0,11,0,-11
21477,1,1,854,1368,514
21478,1,0,15,0,-15
21479,0,0,32,0,-32
21480,0,0,76,0,-76
21481,1,0,28,0,-28
21482,0,0,33,0,-33
21483,1,1,472,1436,964
21484,0,0,102,0,-102
21485,1,1,325,1452,1127
21486,1,1,142,1254,1112
21487,1,1,147,1288,1141
21488,1,1,342,1432,1090
21489,1,1,647,1349,702
21490,1,0,69,0,-69
21491,1,1,1473,1440,-33
21492,1,0,14,0,-14
21493,1,0,19,0,-19
21494,0,0,60,0,-60
21495,0,0,5,0,-5
21496,1,0,81,0,-81
21497,1,1,640,1382,742
21498,1,0,85,0,-85
21499,1,1,370,1762,1392
21500,0,0,267,0,-267
21501,1,1,178,1905,1727
21502,1,0,146,0,-146
21503,1,0,23,0,-23
21504,0,0,4,0,-4
21505,0,0,15,0,-15
21506,0,0,8,0,-8
21507,1,0,71,0,-71
21508,0,0,47,0,-47
21509,0,0,33,0,-33
21510,1,0,159,0,-159
21511,0,0,35,0,-35
21512,1,1,1650,1203,-447
21513,0,0,202,0,-202
21514,1,0,57,0,-57
21515,0,0,40,0,-40
21516,0,0,30,0,-30
21517,0,0,126,0,-126
21518,0,0,42,0,-42
21519,0,0,18,0,-18
21520,0,0,19,0,-19
21521,1,1,259,1213,954
21522,1,1,709,1474,765
21523,1,1,1141,1641,500
21524,1,1,735,1688,953
21525,0,0,32,0,-32
21526,0,0,19,0,-19
21527,0,0,81,0,-81
21528,1,0,23,0,-23
21529,0,0,61,0,-61
21530,1,0,1,0,-1
21531,0,0,6,0,-6
21532,1,1,412,1398,986
21533,0,0,15,0,-15
21534,0,0,8,0,-8
21535,1,0,25,0,-25
21536,1,1,1539,2577,1038
21537,1,0,1,0,-1
21538,0,0,2,0,-2
21539,1,0,91,0,-91
21540,1,0,7,0,-7
21541,0,0,23,0,-23
21542,0,0,19,0,-19
21543,0,0,17,0,-17
21544,1,0,3,0,-3
21545,1,1,351,1542,1191
21546,1,1,729,1209,480
21547,0,0,11,0,-11
21548,1,1,387,1420,1033
21549,1,1,193,1796,1603
21550,1,1,516,1313,797
21551,0,0,5,0,-5
21552,0,0,27,0,-27
21553,1,1,67,1374,1307
21554,1,0,7,0,-7
21555,0,0,14,0,-14
21556,1,1,149,1252,1103
21557,0,0,10,0,-10
21558,1,1,105,1929,1824
21559,1,1,854,1305,451
21560,1,1,2010,2448,438
21561,1,0,46,0,-46
21562,1,0,57,0,-57
21563,1,1,253,1428,1175
21564,0,0,10,0,-10
21565,1,1,185,1526,1341
21566,1,1,182,1945,1763
21567,1,0,18,0,-18
21568,1,0,24,0,-24
21569,1,1,77,1747,1670
21570,0,0,108,0,-108
21571,0,0,63,0,-63
21572,0,0,23,0,-23
21573,0,0,56,0,-56
21574,1,1,193,1349,1156
21575,1,0,44,0,-44
21576,1,1,111,1245,1134
21577,1,0,14,0,-14
21578,1,1,888,1320,432
21579,0,0,6,0,-6
21580,1,0,47,0,-47
21581,0,0,16,0,-16
21582,1,0,21,0,-21
21583,1,1,32,1374,1342
21584,0,0,8,0,-8
21585,1,0,33,0,-33
21586,0,0,69,0,-69
21587,0,0,31,0,-31
21588,0,0,23,0,-23
21589,1,1,961,2259,1298
21590,1,0,222,0,-222
21591,0,0,50,0,-50
21592,1,0,24,0,-24
21593,0,0,22,0,-22
21594,1,1,68,1354,1286
21595,1,1,108,1508,1400
21596,0,0,26,0,-26
21597,1,0,40,0,-40
21598,0,0,32,0,-32
21599,1,0,115,0,-115
21600,1,1,258,1532,1274
21601,1,0,12,0,-12
21602,1,0,74,0,-74
21603,0,0,54,0,-54
21604,0,0,31,0,-31
21605,1,1,645,1447,802
21606,0,0,24,0,-24
21607,1,0,36,0,-36
21608,1,1,253,1495,1242
21609,0,0,57,0,-57
21610,1,1,176,1331,1155
21611,1,0,29,0,-29
21612,1,0,24,0,-24
21613,1,0,27,0,-27
21614,1,0,69,0,-69
21615,1,0,8,0,-8
21616,0,0,98,0,-98
21617,1,1,416,1554,1138
21618,1,1,422,1668,1246
21619,1,1,342,1327,985
21620,1,0,14,0,-14
21621,0,0,19,0,-19
21622,0,0,12,0,-12
21623,1,0,31,0,-31
21624,1,1,78,1226,1148
21625,0,0,2,0,-2
21626,1,1,554,1993,1439
21627,0,0,24,0,-24
21628,1,0,33,0,-33
21629,1,1,27,1516,1489
21630,0,0,0,0,0
21631,1,1,302,2159,1857
21632,1,0,2,0,-2
21633,0,0,14,0,-14
21634,0,0,101,0,-101
21635,0,0,50,0,-50
21636,1,1,128,1328,1200
21637,1,1,12,1782,1770
21638,1,0,3,0,-3
21639,1,0,55,0,-55
21640,0,0,8,0,-8
21641,1,0,88,0,-88
21642,0,0,1,0,-1
21643,0,0,59,0,-59
21644,1,1,127,1921,1794
21645,1,0,1,0,-1
21646,1,1,177,1395,1218
21647,1,1,253,2313,2060
21648,0,0,73,0,-73
21649,1,1,92,2925,2833
21650,1,1,458,1308,850
21651,1,0,52,0,-52
21652,1,1,680,1257,577
21653,1,1,13,2038,2025
21654,1,0,20,0,-20
21655,0,0,30,0,-30
21656,1,1,302,1336,1034
21657,0,0,10,0,-10
21658,1,0,111,0,-111
21659,0,0,156,0,-156
21660,0,0,106,0,-106
21661,1,0,42,0,-42
21662,0,0,2,0,-2
21663,0,0,5,0,-5
21664,1,1,1715,1202,-513
21665,1,0,4,0,-4
21666,1,0,115,0,-115
21667,1,1,142,1367,1225
21668,1,1,548,1225,677
21669,1,0,19,0,-19
21670,1,0,2,0,-2
21671,0,0,31,0,-31
21672,0,0,26,0,-26
21673,0,0,31,0,-31
21674,1,1,188,1677,1489
21675,1,0,7,0,-7
21676,0,0,87,0,-87
21677,0,0,38,0,-38
21678,1,0,1,0,-1
21679,0,0,61,0,-61
21680,0,0,51,0,-51
21681,1,1,904,1220,316
21682,0,0,27,0,-27
21683,1,1,15,2673,2658
21684,1,0,0,0,0
21685,1,0,27,0,-27
21686,1,0,71,0,-71
21687,1,1,135,1739,1604
21688,0,0,62,0,-62
21689,0,0,3,0,-3
21690,1,1,49,1752,1703
21691,0,0,3,0,-3
21692,0,0,75,0,-75
21693,0,0,5,0,-5
21694,0,0,20,0,-20
21695,1,1,255,1223,968
21696,0,0,14,0,-14
21697,0,0,62,0,-62
21698,0,0,14,0,-14
21699,1,1,1103,1350,247
21700,1,1,908,1419,511
21701,0,0,56,0,-56
21702,0,0,88,0,-88
21703,0,0,30,0,-30
21704,0,0,19,0,-19
21705,0,0,48,0,-48
21706,1,1,1828,2214,386
21707,0,0,24,0,-24
21708,1,1,189,2797,2608
21709,1,1,241,1268,1027
21710,1,1,309,1221,912
21711,1,1,232,1377,1145
21712,0,0,13,0,-13
21713,1,0,16,0,-16
21714,1,1,58,2947,2889
21715,1,1,620,1672,1052
21716,1,0,46,0,-46
21717,1,1,44,1505,1461
21718,1,1,696,1307,611
21719,1,1,1174,1613,439
21720,1,0,29,0,-29
21721,1,0,51,0,-51
21722,1,0,57,0,-57
21723,0,0,56,0,-56
21724,1,0,48,0,-48
21725,1,1,524,2444,1920
21726,1,0,52,0,-52
21727,1,0,28,0,-28
21728,1,1,321,1345,1024
21729,1,1,1200,1688,488
21730,1,1,57,1405,1348
21731,1,0,62,0,-62
21732,0,0,32,0,-32
21733,1,1,601,1269,668
21734,1,0,44,0,-44
21735,0,0,4,0,-4
21736,1,1,1046,1463,417
21737,1,0,22,0,-22
21738,1,1,356,1285,929
21739,1,0,0,0,0
21740,1,1,181,1264,1083
21741,1,1,70,1715,1645
21742,1,0,88,0,-88
21743,0,0,20,0,-20
21744,0,0,88,0,-88
21745,0,0,26,0,-26
21746,1,0,9,0,-9
21747,0,0,117,0,-117
21748,0,0,119,0,-119
21749,0,0,67,0,-67
21750,0,0,96,0,-96
21751,0,0,20,0,-20
21752,0,0,20,0,-20
21753,1,1,58,1371,1313
21754,1,1,552,1293,741
21755,1,0,88,0,-88
21756,0,0,124,0,-124
21757,0,0,66,0,-66
21758,1,0,56,0,-56
21759,1,1,102,1569,1467
21760,1,1,864,1215,351
21761,0,0,67,0,-67
21762,1,0,161,0,-161
21763,1,1,1593,1233,-360
21764,1,1,1326,1309,-17
21765,1,1,533,1482,949
21766,0,0,100,0,-100
21767,0,0,54,0,-54
21768,1,0,69,0,-69
21769,1,1,19,1294,1275
21770,0,0,5,0,-5
21771,1,0,116,0,-116
21772,1,1,122,1327,1205
21773,0,0,9,0,-9
21774,0,0,124,0,-124
21775,0,0,41,0,-41
21776,1,0,48,0,-48
21777,1,1,1157,1811,654
21778,1,0,13,0,-13
21779,1,0,9,0,-9
21780,1,0,99,0,-99
21781,1,0,8,0,-8
21782,1,1,467,1540,1073
21783,0,0,37,0,-37
21784,1,1,52,1858,1806
21785,1,1,240,1236,996
21786,1,1,155,1316,1161
21787,1,1,40,1389,1349
21788,0,0,48,0,-48
21789,1,1,177,1309,1132
21790,1,1,29,1604,1575
21791,0,0,43,0,-43
21792,1,1,341,1723,1382
21793,1,0,10,0,-10
21794,1,1,632,1594,962
21795,0,0,107,0,-107
21796,1,0,46,0,-46
21797,0,0,15,0,-15
21798,1,0,41,0,-41
21799,0,0,5,0,-5
21800,1,0,3,0,-3
21801,1,1,578,1457,879
21802,0,0,20,0,-20
21803,1,1,1183,1232,49
21804,1,0,96,0,-96
21805,1,1,653,1544,891
21806,1,0,7,0,-7
21807,1,0,19,0,-19
21808,1,0,8,0,-8
21809,1,1,545,1322,777
21810,1,0,15,0,-15
21811,0,0,3,0,-3
21812,1,1,327,1284,957
21813,0,0,7,0,-7
21814,1,1,475,1378,903
21815,0,0,21,0,-21
21816,1,0,79,0,-79
21817,0,0,33,0,-33
21818,0,0,36,0,-36
21819,1,1,286,1225,939
21820,1,1,255,1882,1627
21821,0,0,56,0,-56
21822,0,0,6,0,-6
21823,1,0,131,0,-131
21824,0,0,17,0,-17
21825,1,1,126,1217,1091
21826,0,0,84,0,-84
21827,1,0,32,0,-32
21828,0,0,23,0,-23
21829,1,1,174,3263,3089
21830,0,0,15,0,-15
21831,0,0,91,0,-91
21832,1,0,8,0,-8
21833,0,0,54,0,-54
21834,0,0,79,0,-79
21835,1,0,117,0,-117
21836,1,0,88,0,-88
21837,0,0,51,0,-51
21838,0,0,1,0,-1
21839,0,0,14,0,-14
21840,1,0,33,0,-33
21841,1,0,67,0,-67
21842,1,1,2313,1314,-999
21843,0,0,140,0,-140
21844,1,0,6,0,-6
21845,1,1,587,3133,2546
21846,1,1,126,1304,1178
21847,1,1,59,1298,1239
21848,1,1,976,1707,731
21849,0,0,15,0,-15
21850,1,0,200,0,-200
21851,1,1,1131,1224,93
21852,1,1,1298,1246,-52
21853,0,0,4,0,-4
21854,1,0,71,0,-71
21855,1,1,1222,1212,-10
21856,0,0,110,0,-110
21857,0,0,18,0,-18
21858,1,0,3,0,-3
21859,0,0,1,0,-1
21860,1,0,6,0,-6
21861,0,0,26,0,-26
21862,0,0,31,0,-31
21863,1,1,98,1244,1146
21864,1,0,204,0,-204
21865,1,0,23,0,-23
21866,0,0,1,0,-1
21867,0,0,38,0,-38
21868,0,0,52,0,-52
21869,1,0,6,0,-6
21870,1,0,45,0,-45
21871,1,0,25,0,-25
21872,1,0,88,0,-88
21873,1,0,35,0,-35
21874,1,0,1,0,-1
21875,1,0,41,0,-41
21876,1,1,113,1584,1471
21877,1,1,1771,1379,-392
21878,0,0,69,0,-69
21879,0,0,13,0,-13
21880,0,0,7,0,-7
21881,0,0,71,0,-71
21882,1,0,46,0,-46
21883,0,0,31,0,-31
21884,0,0,56,0,-56
21885,0,0,16,0,-16
21886,0,0,15,0,-15
21887,0,0,51,0,-51
21888,1,1,387,1465,1078
21889,0,0,13,0,-13
21890,1,0,4,0,-4
21891,1,0,77,0,-77
21892,0,0,50,0,-50
21893,1,1,14,1475,1461
21894,1,1,759,1258,499
21895,0,0,0,0,0
21896,1,0,8,0,-8
21897,0,0,109,0,-109
21898,1,0,27,0,-27
21899,0,0,79,0,-79
21900,1,0,83,0,-83
21901,1,1,393,1929,1536
21902,1,0,38,0,-38
21903,1,0,1,0,-1
21904,0,0,26,0,-26
21905,1,0,14,0,-14
21906,0,0,32,0,-32
21907,0,0,103,0,-103
21908,0,0,33,0,-33
21909,1,1,779,2002,1223
21910,1,0,38,0,-38
21911,1,0,123,0,-123
21912,0,0,96,0,-96
21913,0,0,16,0,-16
21914,1,0,40,0,-40
21915,1,0,69,0,-69
21916,0,0,25,0,-25
21917,1,0,13,0,-13
21918,1,1,386,1589,1203
21919,1,1,265,1497,1232
21920,1,0,37,0,-37
21921,1,0,60,0,-60
21922,1,0,38,0,-38
21923,1,0,10,0,-10
21924,1,1,606,1391,785
21925,0,0,6,0,-6
21926,1,1,114,1940,1826
21927,0,0,116,0,-116
21928,1,0,11,0,-11
21929,1,0,31,0,-31
21930,1,1,29,1654,1625
21931,0,0,75,0,-75
21932,1,1,73,1778,1705
21933,1,0,92,0,-92
21934,1,0,21,0,-21
21935,0,0,19,0,-19
21936,0,0,14,0,-14
21937,1,1,1271,1463,192
21938,1,1,663,1336,673
21939,1,0,16,0,-16
21940,0,0,20,0,-20
21941,1,1,311,2240,1929
21942,1,1,427,1844,1417
21943,1,1,1176,1644,468
21944,0,0,54,0,-54
21945,0,0,24,0,-24
21946,0,0,64,0,-64
21947,0,0,150,0,-150
21948,1,1,89,1297,1208
21949,1,1,869,1303,434
21950,0,0,28,0,-28
21951,1,0,96,0,-96
21952,1,1,70,1313,1243
21953,1,0,16,0,-16
21954,0,0,1,0,-1
21955,1,1,187,1212,1025
21956,1,1,109,1487,1378
21957,0,0,64,0,-64
21958,1,1,786,1577,791
21959,1,0,23,0,-23
21960,1,1,347,1673,1326
21961,1,0,16,0,-16
21962,1,1,470,1830,1360
21963,0,0,11,0,-11
21964,1,0,16,0,-16
21965,0,0,28,0,-28
21966,1,1,73,1716,1643
21967,1,1,838,1258,420
21968,0,0,60,0,-60
21969,1,0,0,0,0
21970,1,1,16,1306,1290
21971,0,0,5,0,-5
21972,0,0,84,0,-84
21973,1,0,139,0,-139
21974,1,1,117,1306,1189
21975,1,0,1,0,-1
21976,1,1,859,1246,387
21977,0,0,9,0,-9
21978,1,1,602,1444,842
21979,1,0,149,0,-149
21980,0,0,12,0,-12
21981,0,0,26,0,-26
21982,0,0,10,0,-10
21983,0,0,5,0,-5
21984,0,0,15,0,-15
21985,1,1,373,1243,870
21986,1,1,69,1315,1246
21987,1,1,99,1465,1366
21988,0,0,9,0,-9
21989,1,0,34,0,-34
21990,1,1,36,3080,3044
21991,1,1,710,1802,1092
21992,0,0,89,0,-89
21993,1,0,191,0,-191
21994,0,0,12,0,-12
21995,1,0,10,0,-10
21996,1,1,329,1234,905
21997,1,1,428,1217,789
21998,0,0,15,0,-15
21999,1,0,41,0,-41
22000,1,0,37,0,-37
22001,1,0,17,0,-17
22002,1,1,581,1223,642
22003,1,1,188,1249,1061
22004,1,0,16,0,-16
22005,0,0,69,0,-69
22006,1,0,1,0,-1
22007,1,0,5,0,-5
22008,0,0,76,0,-76
22009,1,0,5,0,-5
22010,0,0,3,0,-3
22011,1,1,838,1514,676
22012,0,0,210,0,-210
22013,1,1,529,1500,971
22014,1,0,121,0,-121
22015,1,1,353,1267,914
22016,0,0,7,0,-7
22017,1,1,171,1800,1629
22018,1,0,104,0,-104
22019,1,1,545,1582,1037
22020,0,0,18,0,-18
22021,0,0,96,0,-96
22022,0,0,9,0,-9
22023,0,0,126,0,-126
22024,0,0,10,0,-10
22025,1,0,50,0,-50
22026,1,1,241,1607,1366
22027,0,0,13,0,-13
22028,0,0,8,0,-8
22029,1,1,667,2032,1365
22030,0,0,5,0,-5
22031,1,0,2,0,-2
22032,1,0,14,0,-14
22033,1,0,99,0,-99
22034,1,0,6,0,-6
22035,1,0,49,0,-49
22036,1,0,22,0,-22
22037,1,0,4,0,-4
22038,0,0,27,0,-27
22039,0,0,78,0,-78
22040,1,1,326,1553,1227
22041,1,1,265,1227,962
22042,1,0,13,0,-13
22043,1,0,127,0,-127
22044,1,1,519,1668,1149
22045,1,1,865,1339,474
22046,1,1,286,1251,965
22047,1,0,73,0,-73
22048,1,0,9,0,-9
22049,0,0,111,0,-111
22050,1,1,46,1506,1460
22051,0,0,28,0,-28
22052,1,0,74,0,-74
22053,1,1,843,1265,422
22054,0,0,1,0,-1
22055,1,0,4,0,-4
22056,1,1,198,3290,3092
22057,1,0,2,0,-2
22058,1,1,101,1202,1101
22059,1,1,527,1408,881
22060,1,0,4,0,-4
22061,0,0,42,0,-42
22062,1,0,15,0,-15
22063,0,0,14,0,-14
22064,1,0,0,0,0
22065,1,0,0,0,0
22066,0,0,62,0,-62
22067,0,0,27,0,-27
22068,0,0,31,0,-31
22069,1,1,239,1704,1465
22070,1,1,236,1269,1033
22071,0,0,101,0,-101
22072,0,0,115,0,-115
22073,1,1,816,1784,968
22074,0,0,153,0,-153
22075,1,0,133,0,-133
22076,1,0,17,0,-17
22077,1,0,61,0,-61
22078,1,0,0,0,0
22079,0,0,55,0,-55
22080,1,1,394,1321,927
22081,0,0,81,0,-81
22082,1,0,23,0,-23
22083,0,0,48,0,-48
22084,1,1,330,1679,1349
22085,0,0,16,0,-16
22086,1,1,304,1204,900
22087,1,1,334,1322,988
22088,1,1,548,1460,912
22089,0,0,33,0,-33
22090,0,0,7,0,-7
22091,1,1,542,1828,1286
22092,0,0,22,0,-22
22093,1,0,17,0,-17
22094,1,1,597,1282,685
22095,1,1,292,1608,1316
22096,0,0,3,0,-3
22097,0,0,100,0,-100
22098,0,0,47,0,-47
22099,1,1,331,1444,1113
22100,0,0,73,0,-73
22101,1,1,295,1378,1083
22102,1,0,63,0,-63
22103,0,0,143,0,-143
22104,1,1,16,1401,1385
22105,1,0,9,0,-9
22106,1,1,63,1368,1305
22107,1,0,93,0,-93
22108,0,0,64,0,-64
22109,1,1,283,1613,1330
22110,1,0,139,0,-139
22111,1,1,448,1826,1378
22112,1,0,57,0,-57
22113,1,1,525,1269,744
22114,1,0,19,0,-19
22115,0,0,22,0,-22
22116,1,0,149,0,-149
22117,1,0,1,0,-1
22118,0,0,140,0,-140
22119,0,0,68,0,-68
22120,1,1,213,1253,1040
22121,1,1,198,1397,1199
22122,1,1,391,1243,852
22123,1,1,315,1223,908
22124,1,1,596,1647,1051
22125,0,0,15,0,-15
22126,1,0,42,0,-42
22127,1,0,80,0,-80
22128,0,0,2,0,-2
22129,0,0,26,0,-26
22130,1,1,161,2168,2007
22131,0,0,12,0,-12
22132,0,0,45,0,-45
22133,1,1,783,1423,640
22134,1,0,15,0,-15
22135,0,0,25,0,-25
22136,1,0,69,0,-69
22137,0,0,3,0,-3
22138,0,0,47,0,-47
22139,1,1,947,1604,657
22140,1,1,271,1207,936
22141,1,1,905,2046,1141
22142,1,1,753,1339,586
22143,0,0,19,0,-19
22144,1,0,12,0,-12
22145,1,1,6,1366,1360
22146,1,0,108,0,-108
22147,1,1,759,1529,770
22148,0,0,40,0,-40
22149,0,0,55,0,-55
22150,1,0,37,0,-37
22151,1,1,152,1224,1072
22152,1,1,1178,1338,160
22153,1,0,21,0,-21
22154,1,1,713,1430,717
22155,1,0,25,0,-25
22156,0,0,21,0,-21
22157,1,0,5,0,-5
22158,0,0,105,0,-105
22159,1,0,29,0,-29
22160,1,0,52,0,-52
22161,1,1,488,1448,960
22162,0,0,64,0,-64
22163,1,0,58,0,-58
22164,0,0,61,0,-61
22165,0,0,4,0,-4
22166,1,1,138,1316,1178
22167,0,0,1,0,-1
22168,0,0,2,0,-2
22169,0,0,2,0,-2
22170,1,1,580,1207,627
22171,1,0,49,0,-49
22172,1,0,72,0,-72
22173,0,0,31,0,-31
22174,1,1,146,1308,1162
22175,0,0,102,0,-102
22176,1,0,52,0,-52
22177,1,1,1308,1700,392
22178,1,0,2,0,-2
22179,1,1,634,1809,1175
22180,1,0,81,0,-81
22181,0,0,98,0,-98
22182,1,1,88,1447,1359
22183,0,0,2,0,-2
22184,0,0,88,0,-88
22185,0,0,19,0,-19
22186,1,1,741,1595,854
22187,0,0,183,0,-183
22188,0,0,102,0,-102
22189,1,1,439,1620,1181
22190,0,0,127,0,-127
22191,1,0,45,0,-45
22192,1,1,191,1479,1288
22193,1,1,245,1596,1351
22194,1,1,485,1495,1010
22195,1,0,14,0,-14
22196,1,0,16,0,-16
22197,0,0,8,0,-8
22198,0,0,102,0,-102
22199,0,0,61,0,-61
22200,0,0,101,0,-101
22201,1,0,16,0,-16
22202,0,0,37,0,-37
22203,1,1,369,1330,961
22204,1,0,32,0,-32
22205,1,0,12,0,-12
22206,1,1,189,1552,1363
22207,0,0,2,0,-2
22208,1,0,16,0,-16
22209,1,0,10,0,-10
22210,0,0,166,0,-166
22211,0,0,60,0,-60
22212,0,0,12,0,-12
22213,1,0,5,0,-5
22214,0,0,194,0,-194
22215,0,0,9,0,-9
22216,0,0,8,0,-8
22217,0,0,92,0,-92
22218,1,1,989,1292,303
22219,1,1,548,1487,939
22220,0,0,8,0,-8
22221,1,1,591,1552,961
22222,0,0,66,0,-66
22223,1,1,215,1201,986
22224,1,1,734,1256,522
22225,1,0,78,0,-78
22226,1,0,18,0,-18
22227,0,0,11,0,-11
22228,1,1,52,1424,1372
22229,1,0,76,0,-76
22230,1,0,1,0,-1
22231,1,0,39,0,-39
22232,1,0,22,0,-22
22233,0,0,7,0,-7
22234,1,1,313,2204,1891
22235,0,0,17,0,-17
22236,0,0,15,0,-15
22237,0,0,9,0,-9
22238,0,0,13,0,-13
22239,1,1,775,1761,986
22240,0,0,94,0,-94
22241,0,0,0,0,0
22242,1,1,514,1260,746
22243,1,0,105,0,-105
22244,1,0,22,0,-22
22245,0,0,75,0,-75
22246,1,1,107,2066,1959
22247,1,0,205,0,-205
22248,0,0,51,0,-51
22249,1,1,19,1344,1325
22250,1,1,474,1766,1292
22251,0,0,36,0,-36
22252,0,0,1,0,-1
22253,1,0,165,0,-165
22254,0,0,92,0,-92
22255,1,0,25,0,-25
22256,1,1,595,2202,1607
22257,1,0,135,0,-135
22258,0,0,6,0,-6
22259,1,0,39,0,-39
22260,0,0,49,0,-49
22261,1,0,38,0,-38
22262,1,0,14,0,-14
22263,1,1,164,1965,1801
22264,1,1,136,1280,1144
22265,1,0,77,0,-77
22266,1,0,25,0,-25
22267,0,0,148,0,-148
22268,1,0,2,0,-2
22269,0,0,74,0,-74
22270,1,1,183,1685,1502
22271,1,0,18,0,-18
22272,0,0,44,0,-44
22273,1,0,107,0,-107
22274,0,0,8,0,-8
22275,1,0,77,0,-77
22276,0,0,35,0,-35
22277,0,0,34,0,-34
22278,1,1,225,2582,2357
22279,1,0,20,0,-20
22280,1,0,24,0,-24
22281,0,0,22,0,-22
22282,0,0,27,0,-27
22283,0,0,134,0,-134
22284,0,0,88,0,-88
22285,1,0,37,0,-37
22286,1,1,974,1398,424
22287,0,0,39,0,-39
22288,0,0,0,0,0
22289,1,1,654,1554,900
22290,1,1,681,1314,633
22291,1,1,128,1490,1362
22292,0,0,513,0,-513
22293,1,1,202,1295,1093
22294,1,1,795,1388,593
22295,1,0,43,0,-43
22296,1,0,0,0,0
22297,0,0,30,0,-30
22298,1,0,11,0,-11
22299,1,0,16,0,-16
22300,1,0,43,0,-43
22301,1,0,3,0,-3
22302,0,0,227,0,-227
22303,1,0,25,0,-25
22304,1,0,86,0,-86
22305,1,0,109,0,-109
22306,1,1,573,1240,667
22307,0,0,54,0,-54
22308,1,0,28,0,-28
22309,1,0,35,0,-35
22310,1,1,3763,1569,-2194
22311,0,0,8,0,-8
22312,1,0,48,0,-48
22313,1,1,1443,1448,5
22314,1,0,4,0,-4
22315,1,0,58,0,-58
22316,1,0,52,0,-52
22317,1,0,4,0,-4
22318,0,0,25,0,-25
22319,1,0,35,0,-35
22320,1,1,129,2567,2438
22321,1,0,24,0,-24
22322,0,0,68,0,-68
22323,0,0,26,0,-26
22324,1,1,902,1895,993
22325,1,1,1417,1253,-164
22326,0,0,31,0,-31
22327,1,1,158,1330,1172
22328,0,0,151,0,-151
22329,0,0,31,0,-31
22330,1,0,8,0,-8
22331,0,0,30,0,-30
22332,0,0,37,0,-37
22333,0,0,29,0,-29
22334,1,0,126,0,-126
22335,1,0,10,0,-10
22336,1,0,26,0,-26
22337,0,0,14,0,-14
22338,1,1,425,1210,785
22339,0,0,77,0,-77
22340,1,1,1074,1345,271
22341,0,0,42,0,-42
22342,1,0,13,0,-13
22343,0,0,70,0,-70
22344,1,0,8,0,-8
22345,1,0,28,0,-28
22346,1,0,56,0,-56
22347,1,1,279,1497,1218
22348,1,0,17,0,-17
22349,1,1,255,1339,1084
22350,0,0,36,0,-36
22351,0,0,41,0,-41
22352,0,0,27,0,-27
22353,1,1,388,1674,1286
22354,1,1,221,2193,1972
22355,1,1,73,1225,1152
22356,0,0,50,0,-50
22357,0,0,26,0,-26
22358,1,0,1,0,-1
22359,1,0,8,0,-8
22360,0,0,21,0,-21
22361,0,0,33,0,-33
22362,0,0,4,0,-4
22363,1,1,316,1513,1197
22364,0,0,56,0,-56
22365,1,0,106,0,-106
22366,0,0,36,0,-36
22367,1,0,7,0,-7
22368,1,0,13,0,-13
22369,1,0,36,0,-36
22370,1,0,1,0,-1
22371,1,0,35,0,-35
22372,0,0,3,0,-3
22373,1,0,4,0,-4
22374,0,0,1,0,-1
22375,1,0,63,0,-63
22376,0,0,47,0,-47
22377,1,1,415,1323,908
22378,1,1,248,1554,1306
22379,1,1,154,1249,1095
22380,1,1,174,1293,1119
22381,1,1,118,1446,1328
22382,1,1,582,1329,747
22383,1,1,494,1296,802
22384,1,0,17,0,-17
22385,0,0,109,0,-109
22386,1,0,8,0,-8
22387,0,0,59,0,-59
22388,0,0,4,0,-4
22389,1,0,111,0,-111
22390,1,1,31,1465,1434
22391,1,1,366,1533,1167
22392,0,0,25,0,-25
22393,0,0,25,0,-25
22394,0,0,68,0,-68
22395,1,0,66,0,-66
22396,0,0,19,0,-19
22397,0,0,16,0,-16
22398,1,0,4,0,-4
22399,1,0,41,0,-41
22400,0,0,89,0,-89
22401,1,0,16,0,-16
22402,1,0,3,0,-3
22403,1,0,136,0,-136
22404,0,0,27,0,-27
22405,0,0,44,0,-44
22406,0,0,56,0,-56
22407,1,1,56,1408,1352
22408,1,1,208,1293,1085
22409,0,0,15,0,-15
22410,1,0,5,0,-5
22411,1,0,45,0,-45
22412,1,0,156,0,-156
22413,1,1,1781,1642,-139
22414,1,1,66,1827,1761
22415,1,1,254,1767,1513
22416,1,0,20,0,-20
22417,0,0,20,0,-20
22418,1,1,124,1393,1269
22419,1,0,87,0,-87
22420,1,1,105,1228,1123
22421,1,1,898,1829,931
22422,1,0,116,0,-116
22423,1,0,295,0,-295
22424,1,1,390,1221,831
22425,0,0,286,0,-286
22426,0,0,42,0,-42
22427,0,0,187,0,-187
22428,1,0,39,0,-39
22429,1,0,5,0,-5
22430,0,0,0,0,0
22431,0,0,115,0,-115
22432,1,1,717,1529,812
22433,1,0,89,0,-89
22434,1,1,948,1608,660
22435,1,1,353,1645,1292
22436,0,0,24,0,-24
22437,0,0,25,0,-25
22438,0,0,54,0,-54
22439,0,0,53,0,-53
22440,1,1,1321,1466,145
22441,0,0,2,0,-2
22442,0,0,41,0,-41
22443,0,0,16,0,-16
22444,1,0,162,0,-162
22445,1,0,2,0,-2
22446,1,1,830,1254,424
22447,1,0,21,0,-21
22448,0,0,24,0,-24
22449,1,1,893,1229,336
22450,1,1,568,1318,750
22451,1,1,901,1855,954
22452,1,0,110,0,-110
22453,0,0,28,0,-28
22454,1,0,41,0,-41
22455,1,1,616,1997,1381
22456,1,0,108,0,-108
22457,0,0,45,0,-45
22458,0,0,4,0,-4
22459,1,0,5,0,-5
22460,0,0,22,0,-22
22461,1,1,549,1304,755
22462,0,0,20,0,-20
22463,0,0,31,0,-31
22464,0,0,28,0,-28
22465,1,1,61,1498,1437
22466,1,1,597,1228,631
22467,1,1,248,1252,1004
22468,1,0,5,0,-5
22469,1,0,20,0,-20
22470,1,0,108,0,-108
22471,1,1,318,1783,1465
22472,1,0,52,0,-52
22473,1,0,129,0,-129
22474,1,0,136,0,-136
22475,1,0,96,0,-96
22476,1,1,93,1395,1302
22477,1,1,110,1444,1334
22478,1,1,73,1570,1497
22479,0,0,50,0,-50
22480,1,0,140,0,-140
22481,1,1,572,1220,648
22482,1,0,50,0,-50
22483,1,0,57,0,-57
22484,1,0,11,0,-11
22485,1,1,128,1347,1219
22486,1,1,450,2630,2180
22487,0,0,147,0,-147
22488,0,0,4,0,-4
22489,1,1,567,1537,970
22490,1,1,77,1299,1222
22491,0,0,26,0,-26
22492,0,0,25,0,-25
22493,1,0,213,0,-213
22494,1,1,490,1487,997
22495,0,0,87,0,-87
22496,1,1,939,2094,1155
22497,1,1,476,1247,771
22498,0,0,36,0,-36
22499,0,0,10,0,-10
22500,0,0,39,0,-39
22501,0,0,28,0,-28
22502,0,0,9,0,-9
22503,0,0,4,0,-4
22504,1,1,240,2102,1862
22505,0,0,52,0,-52
22506,1,1,1462,2487,1025
22507,0,0,40,0,-40
22508,0,0,21,0,-21
22509,1,1,703,1240,537
22510,1,1,416,1281,865
22511,0,0,260,0,-260
22512,0,0,69,0,-69
22513,0,0,5,0,-5
22514,1,1,243,1599,1356
22515,1,1,289,1272,983
22516,1,1,917,1480,563
22517,0,0,43,0,-43
22518,1,1,397,1312,915
22519,0,0,29,0,-29
22520,0,0,50,0,-50
22521,1,0,67,0,-67
22522,1,0,25,0,-25
22523,1,1,164,1783,1619
22524,1,0,57,0,-57
22525,1,1,94,1353,1259
22526,1,1,100,1329,1229
22527,0,0,27,0,-27
22528,1,0,20,0,-20
22529,1,0,38,0,-38
22530,1,0,32,0,-32
22531,0,0,71,0,-71
22532,0,0,7,0,-7
22533,0,0,7,0,-7
22534,0,0,23,0,-23
22535,1,0,174,0,-174
22536,1,1,46,1336,1290
22537,0,0,5,0,-5
22538,0,0,38,0,-38
22539,0,0,99,0,-99
22540,1,1,673,1211,538
22541,1,0,26,0,-26
22542,1,0,204,0,-204
22543,0,0,54,0,-54
22544,1,0,29,0,-29
22545,0,0,93,0,-93
22546,1,1,258,1272,1014
22547,1,0,2,0,-2
22548,1,1,609,3431,2822
22549,1,0,12,0,-12
22550,1,1,606,1278,672
22551,0,0,36,0,-36
22552,1,1,1425,1911,486
22553,0,0,1,0,-1
22554,1,0,13,0,-13
22555,1,1,151,1253,1102
22556,1,0,84,0,-84
22557,0,0,104,0,-104
22558,1,1,436,1920,1484
22559,0,0,40,0,-40
22560,1,1,24,1395,1371
22561,1,1,339,1731,1392
22562,1,0,6,0,-6
22563,0,0,22,0,-22
22564,1,1,656,1426,770
22565,1,0,25,0,-25
22566,1,0,50,0,-50
22567,1,0,32,0,-32
22568,1,0,148,0,-148
22569,0,0,97,0,-97
22570,1,0,82,0,-82
22571,1,1,1161,1813,652
22572,0,0,3,0,-3
22573,1,1,116,2012,1896
22574,1,1,347,1326,979
22575,1,0,72,0,-72
22576,0,0,5,0,-5
22577,1,0,42,0,-42
22578,1,1,915,1458,543
22579,1,1,202,1246,1044
22580,0,0,37,0,-37
22581,0,0,26,0,-26
22582,1,0,15,0,-15
22583,1,0,7,0,-7
22584,1,0,5,0,-5
22585,0,0,47,0,-47
22586,1,0,89,0,-89
22587,0,0,38,0,-38
22588,1,1,275,1326,1051
22589,1,1,443,5414,4971
22590,0,0,118,0,-118
22591,0,0,37,0,-37
22592,0,0,16,0,-16
22593,0,0,11,0,-11
22594,0,0,8,0,-8
22595,0,0,52,0,-52
22596,1,0,12,0,-12
22597,0,0,48,0,-48
22598,0,0,195,0,-195
22599,1,0,35,0,-35
22600,0,0,54,0,-54
22601,0,0,87,0,-87
22602,1,0,10,0,-10
22603,1,0,70,0,-70
22604,0,0,75,0,-75
22605,0,0,189,0,-189
22606,1,1,68,1369,1301
22607,0,0,72,0,-72
22608,1,1,275,1275,1000
22609,1,0,36,0,-36
22610,0,0,133,0,-133
22611,0,0,72,0,-72
22612,1,1,160,2401,2241
22613,1,0,40,0,-40
22614,1,1,186,2039,1853
22615,1,1,352,1853,1501
22616,1,1,522,1476,954
22617,1,1,251,1505,1254
22618,1,0,75,0,-75
22619,0,0,60,0,-60
22620,0,0,0,0,0
22621,0,0,6,0,-6
22622,0,0,171,0,-171
22623,1,0,51,0,-51
22624,1,1,397,1741,1344
22625,0,0,90,0,-90
22626,0,0,138,0,-138
22627,1,1,1405,1232,-173
22628,0,0,14,0,-14
22629,0,0,58,0,-58
22630,1,0,62,0,-62
22631,0,0,18,0,-18
22632,0,0,110,0,-110
22633,1,1,139,1370,1231
22634,0,0,135,0,-135
22635,1,1,469,1239,770
22636,1,1,575,2147,1572
22637,1,1,580,1605,1025
22638,0,0,13,0,-13
22639,1,0,36,0,-36
22640,1,0,52,0,-52
22641,1,0,128,0,-128
22642,0,0,23,0,-23
22643,1,0,179,0,-179
22644,1,1,608,1650,1042
22645,1,1,561,1705,1144
22646,1,0,54,0,-54
22647,0,0,16,0,-16
22648,1,1,160,4262,4102
22649,0,0,45,0,-45
22650,1,1,566,1600,1034
22651,1,0,93,0,-93
22652,1,0,34,0,-34
22653,0,0,115,0,-115
22654,0,0,16,0,-16
22655,0,0,20,0,-20
22656,1,1,322,1286,964
22657,1,1,89,2262,2173
22658,1,0,110,0,-110
22659,0,0,82,0,-82
22660,0,0,13,0,-13
22661,1,1,364,1405,1041
22662,1,1,594,1473,879
22663,1,0,117,0,-117
22664,1,1,126,1397,1271
22665,1,0,1,0,-1
22666,1,1,564,2181,1617
22667,0,0,180,0,-180
22668,1,1,187,1411,1224
22669,0,0,22,0,-22
22670,0,0,23,0,-23
22671,0,0,102,0,-102
22672,0,0,21,0,-21
22673,1,1,672,1340,668
22674,1,0,11,0,-11
22675,0,0,3,0,-3
22676,1,0,0,0,0
22677,1,0,63,0,-63
22678,1,0,8,0,-8
22679,0,0,7,0,-7
22680,1,1,334,1227,893
22681,0,0,38,0,-38
22682,1,0,43,0,-43
22683,1,1,527,1224,697
22684,0,0,115,0,-115
22685,0,0,87,0,-87
22686,0,0,1,0,-1
22687,1,0,42,0,-42
22688,1,1,253,2201,1948
22689,0,0,77,0,-77
22690,1,0,67,0,-67
22691,0,0,90,0,-90
22692,1,0,9,0,-9
22693,1,0,26,0,-26
22694,0,0,15,0,-15
22695,1,0,92,0,-92
22696,1,1,145,1840,1695
22697,0,0,4,0,-4
22698,1,1,130,1569,1439
22699,1,1,1569,1309,-260
22700,0,0,13,0,-13
22701,1,0,11,0,-11
22702,0,0,18,0,-18
22703,1,1,467,2089,1622
22704,0,0,18,0,-18
22705,0,0,42,0,-42
22706,0,0,8,0,-8
22707,0,0,17,0,-17
22708,1,1,680,1481,801
22709,1,1,654,2021,1367
22710,1,1,31,1433,1402
22711,1,1,59,1355,1296
22712,1,1,300,1726,1426
22713,1,1,226,1224,998
22714,0,0,36,0,-36
22715,0,0,33,0,-33
22716,1,1,1131,1255,124
22717,1,0,7,0,-7
22718,1,1,600,1516,916
22719,1,0,34,0,-34
22720,1,0,63,0,-63
22721,1,0,83,0,-83
22722,1,0,0,0,0
22723,1,1,126,1241,1115
22724,1,1,288,2024,1736
22725,0,0,0,0,0
22726,1,1,747,1566,819
22727,0,0,41,0,-41
22728,1,0,3,0,-3
22729,1,0,42,0,-42
22730,1,0,62,0,-62
22731,1,1,1173,2137,964
22732,1,0,48,0,-48
22733,1,1,29,2151,2122
22734,1,1,448,1372,924
22735,0,0,127,0,-127
22736,1,0,62,0,-62
22737,0,0,10,0,-10
22738,1,0,8,0,-8
22739,0,0,16,0,-16
22740,1,0,68,0,-68
22741,0,0,10,0,-10
22742,1,1,1231,1263,32
22743,1,1,225,1549,1324
22744,1,1,662,1646,984
22745,1,1,472,2309,1837
22746,0,0,27,0,-27
22747,1,0,104,0,-104
22748,1,0,23,0,-23
22749,0,0,43,0,-43
22750,1,1,202,1348,1146
22751,1,1,2337,1373,-964
22752,0,0,82,0,-82
22753,1,1,745,1341,596
22754,0,0,7,0,-7
22755,1,0,30,0,-30
22756,1,0,26,0,-26
22757,1,0,24,0,-24
22758,1,0,89,0,-89
22759,0,0,4,0,-4
22760,1,0,15,0,-15
22761,0,0,22,0,-22
22762,0,0,12,0,-12
22763,1,1,1146,1536,390
22764,1,1,231,1931,1700
22765,1,1,276,1524,1248
22766,1,1,235,1454,1219
22767,0,0,42,0,-42
22768,1,1,79,1261,1182
22769,0,0,20,0,-20
22770,1,0,186,0,-186
22771,1,0,11,0,-11
22772,1,0,15,0,-15
22773,0,0,3,0,-3
22774,1,1,301,1438,1137
22775,1,1,73,1490,1417
22776,0,0,67,0,-67
22777,0,0,35,0,-35
22778,1,0,61,0,-61
22779,0,0,4,0,-4
22780,1,0,7,0,-7
22781,1,1,949,1203,254
22782,0,0,11,0,-11
22783,1,1,111,1200,1089
22784,1,1,933,1635,702
22785,1,1,317,1732,1415
22786,1,0,26,0,-26
22787,0,0,142,0,-142
22788,1,1,433,1529,1096
22789,1,0,37,0,-37
22790,1,1,407,1960,1553
22791,0,0,8,0,-8
22792,1,0,26,0,-26
22793,0,0,59,0,-59
22794,0,0,13,0,-13
22795,0,0,9,0,-9
22796,0,0,49,0,-49
22797,1,0,9,0,-9
22798,0,0,6,0,-6
22799,1,1,56,1292,1236
22800,0,0,36,0,-36
22801,1,1,142,1640,1498
22802,1,1,469,1271,802
22803,1,0,29,0,-29
22804,0,0,12,0,-12
22805,1,1,190,1717,1527
22806,1,1,418,1245,827
22807,1,0,30,0,-30
22808,1,1,487,1250,763
22809,1,1,483,2212,1729
22810,0,0,6,0,-6
22811,1,0,36,0,-36
22812,1,0,7,0,-7
22813,0,0,24,0,-24
22814,1,0,37,0,-37
22815,1,0,5,0,-5
22816,1,0,34,0,-34
22817,1,0,21,0,-21
22818,1,0,20,0,-20
22819,0,0,1,0,-1
22820,1,1,719,1212,493
22821,1,1,908,1760,852
22822,0,0,0,0,0
22823,0,0,40,0,-40
22824,0,0,97,0,-97
22825,0,0,22,0,-22
22826,1,1,150,1258,1108
22827,1,1,441,1642,1201
22828,1,0,16,0,-16
22829,0,0,1,0,-1
22830,0,0,55,0,-55
22831,1,1,305,1238,933
22832,1,0,75,0,-75
22833,1,1,321,1257,936
22834,1,0,99,0,-99
22835,0,0,27,0,-27
22836,0,0,14,0,-14
22837,0,0,23,0,-23
22838,0,0,22,0,-22
22839,1,1,109,1837,1728
22840,1,1,712,1205,493
22841,1,0,2,0,-2
22842,0,0,43,0,-43
22843,0,0,52,0,-52
22844,1,1,53,1943,1890
22845,1,0,10,0,-10
22846,1,1,334,2056,1722
22847,1,1,243,1254,1011
22848,1,1,637,1648,1011
22849,1,0,63,0,-63
22850,1,0,23,0,-23
22851,0,0,107,0,-107
22852,0,0,30,0,-30
22853,1,1,1148,1547,399
22854,0,0,23,0,-23
22855,1,0,79,0,-79
22856,0,0,13,0,-13
22857,1,0,124,0,-124
22858,0,0,16,0,-16
22859,1,0,14,0,-14
22860,1,1,168,1306,1138
22861,0,0,39,0,-39
22862,0,0,141,0,-141
22863,1,0,101,0,-101
22864,1,0,60,0,-60
22865,1,0,6,0,-6
22866,1,1,680,1741,1061
22867,1,1,195,1679,1484
22868,1,0,80,0,-80
22869,1,0,41,0,-41
22870,1,1,47,1226,1179
22871,0,0,111,0,-111
22872,0,0,2,0,-2
22873,0,0,29,0,-29
22874,1,1,425,2526,2101
22875,0,0,2,0,-2
22876,0,0,37,0,-37
22877,1,1,124,1352,1228
22878,1,1,1049,1388,339
22879,0,0,131,0,-131
22880,0,0,3,0,-3
22881,1,0,37,0,-37
22882,0,0,11,0,-11
22883,1,1,211,1291,1080
22884,1,1,635,1753,1118
22885,0,0,32,0,-32
22886,1,1,789,1413,624
22887,0,0,18,0,-18
22888,1,1,225,1688,1463
22889,1,0,59,0,-59
22890,0,0,18,0,-18
22891,0,0,5,0,-5
22892,1,1,312,1206,894
22893,1,0,12,0,-12
22894,1,0,71,0,-71
22895,1,1,307,1232,925
22896,0,0,21,0,-21
22897,0,0,11,0,-11
22898,1,1,281,1353,1072
22899,1,1,322,1372,1050
22900,1,0,14,0,-14
22901,1,0,26,0,-26
22902,0,0,13,0,-13
22903,1,0,7,0,-7
22904,1,1,45,1266,1221
22905,0,0,12,0,-12
22906,0,0,1,0,-1
22907,1,1,472,2174,1702
22908,0,0,3,0,-3
22909,1,0,11,0,-11
22910,1,1,176,3491,3315
22911,0,0,9,0,-9
22912,1,1,403,1605,1202
22913,0,0,41,0,-41
22914,0,0,8,0,-8
22915,1,1,1408,1266,-142
22916,1,1,349,1598,1249
22917,1,1,97,1300,1203
22918,1,1,1650,1555,-95
22919,0,0,11,0,-11
22920,0,0,55,0,-55
22921,0,0,39,0,-39
22922,1,0,6,0,-6
22923,1,1,752,1209,457
22924,1,0,11,0,-11
22925,0,0,31,0,-31
22926,0,0,9,0,-9
22927,0,0,82,0,-82
22928,1,0,2,0,-2
22929,0,0,43,0,-43
22930,1,1,24,2862,2838
22931,1,0,51,0,-51
22932,0,0,159,0,-159
22933,0,0,0,0,0
22934,0,0,53,0,-53
22935,1,0,38,0,-38
22936,1,0,69,0,-69
22937,0,0,33,0,-33
22938,0,0,17,0,-17
22939,1,1,138,1336,1198
22940,1,0,17,0,-17
22941,1,1,2080,1583,-497
22942,0,0,123,0,-123
22943,0,0,117,0,-117
22944,0,0,16,0,-16
22945,0,0,68,0,-68
22946,0,0,32,0,-32
22947,0,0,4,0,-4
22948,0,0,124,0,-124
22949,0,0,57,0,-57
22950,1,1,869,1766,897
22951,0,0,7,0,-7
22952,0,0,10,0,-10
22953,0,0,8,0,-8
22954,1,0,28,0,-28
22955,0,0,22,0,-22
22956,1,1,6,1526,1520
22957,0,0,2,0,-2
22958,1,1,514,1552,1038
22959,1,0,172,0,-172
22960,1,0,146,0,-146
22961,1,1,1171,1720,549
22962,0,0,32,0,-32
22963,1,0,18,0,-18
22964,1,1,693,1557,864
22965,1,0,7,0,-7
22966,1,1,358,1202,844
22967,1,1,496,1376,880
22968,1,0,12,0,-12
22969,0,0,28,0,-28
22970,0,0,17,0,-17
22971,0,0,88,0,-88
22972,1,1,100,1972,1872
22973,1,1,132,3106,2974
22974,1,0,53,0,-53
22975,1,1,1683,1528,-155
22976,0,0,14,0,-14
22977,0,0,201,0,-201
22978,1,1,395,1227,832
22979,1,1,610,1754,1144
22980,1,0,25,0,-25
22981,0,0,23,0,-23
22982,1,0,19,0,-19
22983,1,1,680,1202,522
22984,1,0,49,0,-49
22985,0,0,50,0,-50
22986,0,0,1,0,-1
22987,0,0,263,0,-263
22988,0,0,34,0,-34
22989,0,0,207,0,-207
22990,1,1,334,1268,934
22991,1,0,35,0,-35
22992,1,1,244,1730,1486
22993,0,0,83,0,-83
22994,1,1,157,1273,1116
22995,1,0,1,0,-1
22996,0,0,10,0,-10
22997,0,0,28,0,-28
22998,0,0,24,0,-24
22999,0,0,57,0,-57
23000,1,1,297,1789,1492
23001,0,0,17,0,-17
23002,1,1,453,1368,915
23003,1,1,583,1301,718
23004,1,0,1,0,-1
23005,1,1,116,1620,1504
23006,1,1,74,1434,1360
23007,1,0,17,0,-17
23008,1,1,201,1411,1210
23009,1,1,554,1380,826
23010,0,0,8,0,-8
23011,0,0,54,0,-54
23012,0,0,42,0,-42
23013,1,1,412,1465,1053
23014,1,0,24,0,-24
23015,1,0,134,0,-134
23016,1,1,177,1210,1033
23017,1,1,1572,1257,-315
23018,1,1,472,1281,809
23019,1,1,377,1259,882
23020,0,0,21,0,-21
23021,1,1,1347,1208,-139
23022,1,0,40,0,-40
23023,1,1,83,1421,1338
23024,0,0,34,0,-34
23025,0,0,36,0,-36
23026,1,0,17,0,-17
23027,1,1,127,1433,1306
23028,1,1,190,1209,1019
23029,1,1,708,1210,502
23030,1,1,1029,1438,409
23031,1,0,58,0,-58
23032,1,1,557,1438,881
23033,1,0,36,0,-36
23034,1,0,17,0,-17
23035,1,0,10,0,-10
23036,1,1,724,1279,555
23037,1,0,39,0,-39
23038,1,1,183,1318,1135
23039,1,1,314,1261,947
23040,0,0,72,0,-72
23041,0,0,9,0,-9
23042,1,1,102,1210,1108
23043,1,0,96,0,-96
23044,0,0,27,0,-27
23045,1,1,64,1289,1225
23046,1,1,370,1268,898
23047,1,0,91,0,-91
23048,0,0,14,0,-14
23049,0,0,36,0,-36
23050,1,1,155,1361,1206
23051,0,0,55,0,-55
23052,1,0,0,0,0
23053,0,0,61,0,-61
23054,0,0,26,0,-26
23055,1,1,40,1260,1220
23056,1,0,79,0,-79
23057,1,1,810,1201,391
23058,1,0,23,0,-23
23059,1,0,55,0,-55
23060,0,0,36,0,-36
23061,0,0,85,0,-85
23062,1,1,164,1524,1360
23063,1,0,11,0,-11
23064,0,0,38,0,-38
23065,1,0,30,0,-30
23066,0,0,38,0,-38
23067,0,0,32,0,-32
23068,1,1,404,2367,1963
23069,0,0,85,0,-85
23070,0,0,4,0,-4
23071,0,0,54,0,-54
23072,0,0,29,0,-29
23073,1,0,31,0,-31
23074,0,0,16,0,-16
23075,1,1,248,1462,1214
23076,0,0,26,0,-26
23077,1,1,200,1455,1255
23078,0,0,64,0,-64
23079,1,1,787,2043,1256
23080,1,0,48,0,-48
23081,1,0,24,0,-24
23082,0,0,30,0,-30
23083,1,1,655,1205,550
23084,0,0,61,0,-61
23085,1,1,639,2017,1378
23086,0,0,9,0,-9
23087,0,0,123,0,-123
23088,1,1,34,1750,1716
23089,1,1,868,1511,643
23090,0,0,32,0,-32
23091,0,0,24,0,-24
23092,1,1,155,2096,1941
23093,0,0,61,0,-61
23094,0,0,116,0,-116
23095,1,1,262,1411,1149
23096,0,0,36,0,-36
23097,0,0,2,0,-2
23098,1,1,547,4632,4085
23099,1,1,764,1233,469
23100,1,1,754,1295,541
23101,1,1,215,1263,1048
23102,1,1,307,1685,1378
23103,1,1,295,1361,1066
23104,1,1,219,2853,2634
23105,1,1,388,1370,982
23106,1,1,574,1318,744
23107,1,1,877,2313,1436
23108,0,0,118,0,-118
23109,1,1,596,1314,718
23110,1,0,212,0,-212
23111,0,0,8,0,-8
23112,1,0,74,0,-74
23113,1,0,6,0,-6
23114,0,0,96,0,-96
23115,0,0,57,0,-57
23116,1,1,1572,1235,-337
23117,1,0,48,0,-48
23118,0,0,153,0,-153
23119,0,0,45,0,-45
23120,0,0,12,0,-12
23121,1,0,16,0,-16
23122,1,1,279,1288,1009
23123,1,1,512,1527,1015
23124,0,0,9,0,-9
23125,1,1,149,1501,1352
23126,0,0,35,0,-35
23127,1,1,1815,2461,646
23128,0,0,19,0,-19
23129,1,0,12,0,-12
23130,0,0,40,0,-40
23131,1,0,9,0,-9
23132,0,0,69,0,-69
23133,0,0,11,0,-11
23134,0,0,61,0,-61
23135,1,1,497,2490,1993
23136,0,0,39,0,-39
23137,0,0,238,0,-238
23138,0,0,195,0,-195
23139,0,0,52,0,-52
23140,0,0,3,0,-3
23141,1,1,249,1594,1345
23142,1,1,812,1423,611
23143,1,0,79,0,-79
23144,1,1,259,1417,1158
23145,0,0,5,0,-5
23146,1,1,112,1251,1139
23147,1,1,624,1571,947
23148,1,1,1313,2457,1144
23149,1,1,385,1227,842
23150,1,0,6,0,-6
23151,0,0,25,0,-25
23152,0,0,5,0,-5
23153,0,0,149,0,-149
23154,1,0,11,0,-11
23155,1,1,1120,1906,786
23156,1,0,25,0,-25
23157,0,0,105,0,-105
23158,1,0,43,0,-43
23159,1,0,64,0,-64
23160,1,1,130,1448,1318
23161,1,1,58,1453,1395
23162,1,0,124,0,-124
23163,1,0,96,0,-96
23164,0,0,12,0,-12
23165,1,1,649,1338,689
23166,1,1,514,1286,772
23167,1,1,848,1455,607
23168,1,0,23,0,-23
23169,1,0,82,0,-82
23170,1,1,340,1896,1556
23171,0,0,2,0,-2
23172,1,1,202,1436,1234
23173,0,0,15,0,-15
23174,0,0,11,0,-11
23175,0,0,77,0,-77
23176,1,0,55,0,-55
23177,1,1,898,1549,651
23178,1,1,194,1215,1021
23179,0,0,34,0,-34
23180,1,1,239,1471,1232
23181,0,0,28,0,-28
23182,1,0,83,0,-83
23183,1,1,162,2090,1928
23184,0,0,21,0,-21
23185,0,0,22,0,-22
23186,0,0,90,0,-90
23187,0,0,5,0,-5
23188,0,0,49,0,-49
23189,1,1,65,1247,1182
23190,1,1,1966,2155,189
23191,0,0,95,0,-95
23192,0,0,25,0,-25
23193,0,0,20,0,-20
23194,1,1,756,1434,678
23195,1,0,70,0,-70
23196,1,1,500,1711,1211
23197,1,1,603,1528,925
23198,1,1,716,1839,1123
23199,0,0,6,0,-6
23200,0,0,12,0,-12
23201,0,0,32,0,-32
23202,1,1,415,1234,819
23203,1,0,5,0,-5
23204,1,1,297,1232,935
23205,1,1,215,1205,990
23206,0,0,46,0,-46
23207,0,0,11,0,-11
23208,1,0,339,0,-339
23209,1,1,270,1216,946
23210,1,1,534,1369,835
23211,1,1,312,1706,1394
23212,0,0,4,0,-4
23213,0,0,59,0,-59
23214,1,0,4,0,-4
23215,0,0,70,0,-70
23216,0,0,20,0,-20
23217,1,1,549,1419,870
23218,1,0,19,0,-19
23219,1,1,202,1386,1184
23220,1,0,58,0,-58
23221,1,0,0,0,0
23222,1,1,107,1340,1233
23223,1,1,915,1612,697
23224,0,0,8,0,-8
23225,1,1,1822,1200,-622
23226,0,0,8,0,-8
23227,1,1,262,1252,990
23228,1,0,121,0,-121
23229,1,1,254,1559,1305
23230,1,1,921,1533,612
23231,1,1,148,2533,2385
23232,0,0,19,0,-19
23233,1,0,95,0,-95
23234,1,1,629,1296,667
23235,1,1,244,1683,1439
23236,0,0,7,0,-7
23237,0,0,71,0,-71
23238,1,0,0,0,0
23239,0,0,7,0,-7
23240,0,0,59,0,-59
23241,0,0,41,0,-41
23242,0,0,46,0,-46
23243,0,0,118,0,-118
23244,0,0,7,0,-7
23245,1,1,846,1405,559
23246,0,0,102,0,-102
23247,0,0,234,0,-234
23248,1,0,86,0,-86
23249,1,1,899,1466,567
23250,1,0,34,0,-34
23251,1,0,14,0,-14
23252,1,0,38,0,-38
23253,1,0,64,0,-64
23254,1,0,136,0,-136
23255,0,0,47,0,-47
23256,0,0,133,0,-133
23257,1,1,623,1432,809
23258,1,1,692,1388,696
23259,1,1,184,1432,1248
23260,1,0,57,0,-57
23261,1,1,479,1661,1182
23262,0,0,4,0,-4
23263,1,0,123,0,-123
23264,1,0,83,0,-83
23265,0,0,81,0,-81
23266,1,0,12,0,-12
23267,0,0,202,0,-202
23268,1,1,448,1286,838
23269,1,1,170,1305,1135
23270,0,0,143,0,-143
23271,0,0,23,0,-23
23272,1,1,77,2291,2214
23273,1,1,405,1769,1364
23274,0,0,84,0,-84
23275,1,1,151,1252,1101
23276,1,0,32,0,-32
23277,0,0,38,0,-38
23278,1,0,62,0,-62
23279,1,1,1923,1213,-710
23280,1,1,27,1425,1398
23281,0,0,8,0,-8
23282,0,0,32,0,-32
23283,0,0,127,0,-127
23284,1,1,493,1649,1156
23285,0,0,4,0,-4
23286,0,0,58,0,-58
23287,1,0,4,0,-4
23288,0,0,24,0,-24
23289,0,0,36,0,-36
23290,1,1,268,1747,1479
23291,1,1,67,1286,1219
23292,1,0,27,0,-27
23293,0,0,85,0,-85
23294,0,0,87,0,-87
23295,1,1,227,1304,1077
23296,1,0,87,0,-87
23297,1,0,65,0,-65
23298,0,0,108,0,-108
23299,0,0,95,0,-95
23300,1,1,256,1365,1109
23301,0,0,1,0,-1
23302,1,0,23,0,-23
23303,1,1,495,1272,777
23304,1,1,1848,1213,-635
23305,0,0,109,0,-109
23306,0,0,20,0,-20
23307,0,0,31,0,-31
23308,0,0,0,0,0
23309,0,0,11,0,-11
23310,1,0,111,0,-111
23311,1,1,123,1202,1079
23312,0,0,108,0,-108
23313,1,0,14,0,-14
23314,1,0,46,0,-46
23315,0,0,33,0,-33
23316,0,0,4,0,-4
23317,1,0,17,0,-17
23318,1,1,1056,1227,171
23319,1,0,69,0,-69
23320,1,0,3,0,-3
23321,1,1,370,1296,926
23322,0,0,12,0,-12
23323,1,0,9,0,-9
23324,1,1,799,1843,1044
23325,0,0,83,0,-83
23326,1,1,80,2075,1995
23327,0,0,45,0,-45
23328,1,1,329,1496,1167
23329,1,1,948,1342,394
23330,1,0,55,0,-55
23331,0,0,49,0,-49
23332,1,0,37,0,-37
23333,1,1,349,1458,1109
23334,0,0,0,0,0
23335,0,0,35,0,-35
23336,1,1,427,1202,775
23337,1,1,470,1261,791
23338,1,1,310,2331,2021
23339,1,1,254,1356,1102
23340,0,0,3,0,-3
23341,0,0,20,0,-20
23342,0,0,44,0,-44
23343,1,1,1258,1672,414
23344,1,1,1860,1233,-627
23345,1,1,328,1322,994
23346,1,0,33,0,-33
23347,1,0,81,0,-81
23348,1,1,1355,1408,53
23349,1,0,25,0,-25
23350,1,0,45,0,-45
23351,1,0,54,0,-54
23352,0,0,49,0,-49
23353,1,0,6,0,-6
23354,0,0,0,0,0
23355,0,0,84,0,-84
23356,1,1,56,1287,1231
23357,1,0,51,0,-51
23358,1,1,403,1571,1168
23359,1,1,375,1420,1045
23360,1,1,1734,2251,517
23361,0,0,78,0,-78
23362,1,0,40,0,-40
23363,1,1,352,1272,920
23364,1,1,1904,2077,173
23365,1,1,144,1254,1110
23366,1,0,15,0,-15
23367,0,0,80,0,-80
23368,0,0,70,0,-70
23369,0,0,79,0,-79
23370,0,0,48,0,-48
23371,0,0,30,0,-30
23372,1,0,133,0,-133
23373,1,0,39,0,-39
23374,1,1,288,1227,939
23375,0,0,84,0,-84
23376,0,0,49,0,-49
23377,1,1,204,1914,1710
23378,0,0,2,0,-2
23379,1,0,73,0,-73
23380,1,1,765,1276,511
23381,1,0,12,0,-12
23382,0,0,4,0,-4
23383,1,1,389,1343,954
23384,1,0,216,0,-216
23385,0,0,5,0,-5
23386,1,1,294,1214,920
23387,1,1,408,1811,1403
23388,0,0,92,0,-92
23389,1,1,110,1615,1505
23390,1,1,1586,1451,-135
23391,1,0,27,0,-27
23392,0,0,4,0,-4
23393,1,0,6,0,-6
23394,1,1,94,1235,1141
23395,1,1,341,1802,1461
23396,0,0,9,0,-9
23397,1,0,22,0,-22
23398,1,1,1287,1203,-84
23399,0,0,30,0,-30
23400,1,1,479,1561,1082
23401,1,0,6,0,-6
23402,0,0,2,0,-2
23403,1,0,58,0,-58
23404,0,0,69,0,-69
23405,0,0,59,0,-59
23406,0,0,60,0,-60
23407,0,0,25,0,-25
23408,0,0,9,0,-9
23409,1,1,156,1572,1416
23410,0,0,56,0,-56
23411,1,1,64,1319,1255
23412,0,0,27,0,-27
23413,1,1,813,2296,1483
23414,0,0,33,0,-33
23415,0,0,1,0,-1
23416,0,0,0,0,0
23417,0,0,1,0,-1
23418,1,0,53,0,-53
23419,1,0,25,0,-25
23420,1,1,1225,3031,1806
23421,0,0,15,0,-15
23422,1,0,40,0,-40
23423,0,0,70,0,-70
23424,1,1,306,1589,1283
23425,1,0,21,0,-21
23426,1,0,6,0,-6
23427,0,0,19,0,-19
23428,1,1,764,1500,736
23429,0,0,291,0,-291
23430,0,0,23,0,-23
23431,0,0,84,0,-84
23432,0,0,32,0,-32
23433,0,0,1,0,-1
23434,1,1,1097,1208,111
23435,1,0,33,0,-33
23436,1,0,38,0,-38
23437,0,0,125,0,-125
23438,1,0,38,0,-38
23439,1,1,397,1253,856
23440,0,0,78,0,-78
23441,1,1,1378,1209,-169
23442,1,1,1047,1320,273
23443,1,0,33,0,-33
23444,1,1,414,1726,1312
23445,0,0,153,0,-153
23446,1,1,905,1494,589
23447,0,0,77,0,-77
23448,1,0,32,0,-32
23449,0,0,219,0,-219
23450,1,1,197,1580,1383
23451,1,1,1032,1664,632
23452,1,1,492,1546,1054
23453,1,1,374,2283,1909
23454,0,0,70,0,-70
23455,0,0,9,0,-9
23456,0,0,121,0,-121
23457,0,0,12,0,-12
23458,1,0,36,0,-36
23459,1,0,6,0,-6
23460,0,0,14,0,-14
23461,1,1,86,1369,1283
23462,1,0,18,0,-18
23463,1,0,23,0,-23
23464,1,1,633,1606,973
23465,1,1,2104,1501,-603
23466,0,0,11,0,-11
23467,0,0,165,0,-165
23468,0,0,61,0,-61
23469,1,0,37,0,-37
23470,1,0,44,0,-44
23471,1,1,654,1457,803
23472,0,0,144,0,-144
23473,0,0,55,0,-55
23474,1,1,1420,1372,-48
23475,0,0,157,0,-157
23476,0,0,37,0,-37
23477,1,0,125,0,-125
23478,1,0,11,0,-11
23479,1,0,36,0,-36
23480,1,1,1284,1206,-78
23481,1,0,35,0,-35
23482,1,0,19,0,-19
23483,1,1,284,1520,1236
23484,1,1,752,1757,1005
23485,1,0,113,0,-113
23486,0,0,18,0,-18
23487,1,1,261,2244,1983
23488,1,1,147,1250,1103
23489,0,0,44,0,-44
23490,1,1,166,2156,1990
23491,0,0,75,0,-75
23492,0,0,49,0,-49
23493,1,1,928,1201,273
23494,1,1,610,1419,809
23495,1,0,44,0,-44
23496,1,0,15,0,-15
23497,0,0,41,0,-41
23498,1,0,72,0,-72
23499,1,1,129,1395,1266
23500,0,0,27,0,-27
23501,0,0,22,0,-22
23502,0,0,65,0,-65
23503,1,1,345,1268,923
23504,1,0,45,0,-45
23505,0,0,3,0,-3
23506,0,0,64,0,-64
23507,1,0,13,0,-13
23508,0,0,96,0,-96
23509,1,0,67,0,-67
23510,0,0,129,0,-129
23511,0,0,93,0,-93
23512,0,0,58,0,-58
23513,1,0,16,0,-16
23514,0,0,53,0,-53
23515,1,1,288,1234,946
23516,0,0,54,0,-54
23517,0,0,10,0,-10
23518,1,1,2532,1451,-1081
23519,0,0,19,0,-19
23520,1,1,330,1382,1052
23521,1,1,247,1281,1034
23522,1,0,1,0,-1
23523,1,0,19,0,-19
23524,1,0,33,0,-33
23525,1,0,43,0,-43
23526,1,0,40,0,-40
23527,1,1,256,1244,988
23528,0,0,86,0,-86
23529,1,0,32,0,-32
23530,1,0,61,0,-61
23531,0,0,135,0,-135
23532,1,1,80,1382,1302
23533,1,0,29,0,-29
23534,0,0,0,0,0
23535,0,0,50,0,-50
23536,1,1,164,1273,1109
23537,1,1,163,1916,1753
23538,1,1,693,1427,734
23539,1,0,133,0,-133
23540,1,0,114,0,-114
23541,1,1,434,1418,984
23542,0,0,35,0,-35
23543,1,0,89,0,-89
23544,0,0,68,0,-68
23545,1,0,190,0,-190
23546,0,0,55,0,-55
23547,1,0,187,0,-187
23548,1,1,72,2214,2142
23549,1,0,224,0,-224
23550,1,0,9,0,-9
23551,0,0,8,0,-8
23552,0,0,93,0,-93
23553,0,0,15,0,-15
23554,0,0,8,0,-8
23555,0,0,55,0,-55
23556,0,0,42,0,-42
23557,0,0,6,0,-6
23558,1,1,243,1372,1129
23559,1,1,961,1301,340
23560,0,0,128,0,-128
23561,0,0,18,0,-18
23562,1,0,14,0,-14
23563,1,1,221,1364,1143
23564,0,0,88,0,-88
23565,0,0,50,0,-50
23566,0,0,48,0,-48
23567,1,0,24,0,-24
23568,1,1,281,1267,986
23569,1,1,1274,1341,67
23570,1,1,976,1531,555
23571,1,1,535,2041,1506
23572,0,0,27,0,-27
23573,0,0,46,0,-46
23574,0,0,63,0,-63
23575,1,1,58,1712,1654
23576,0,0,15,0,-15
23577,1,1,329,1366,1037
23578,0,0,2,0,-2
23579,1,1,127,1754,1627
23580,0,0,95,0,-95
23581,0,0,6,0,-6
23582,0,0,3,0,-3
23583,1,1,273,1233,960
23584,1,0,79,0,-79
23585,1,1,81,1224,1143
23586,1,0,60,0,-60
23587,1,0,0,0,0
23588,1,1,337,2254,1917
23589,1,0,12,0,-12
23590,0,0,20,0,-20
23591,1,1,100,1902,1802
23592,1,1,378,1611,1233
23593,1,1,514,2719,2205
23594,1,1,173,1352,1179
23595,1,1,472,1436,964
23596,1,1,1596,2045,449
23597,1,0,0,0,0
23598,1,0,5,0,-5
23599,1,1,650,1226,576
23600,0,0,94,0,-94
23601,1,1,461,1337,876
23602,0,0,72,0,-72
23603,0,0,81,0,-81
23604,1,0,18,0,-18
23605,1,0,54,0,-54
23606,0,0,56,0,-56
23607,1,0,32,0,-32
23608,0,0,4,0,-4
23609,1,0,4,0,-4
23610,0,0,52,0,-52
23611,1,1,846,1227,381
23612,0,0,71,0,-71
23613,0,0,63,0,-63
23614,1,1,184,1281,1097
23615,0,0,74,0,-74
23616,1,1,1202,1259,57
23617,0,0,14,0,-14
23618,1,0,77,0,-77
23619,0,0,64,0,-64
23620,0,0,1,0,-1
23621,0,0,16,0,-16
23622,1,1,716,1424,708
23623,0,0,18,0,-18
23624,1,1,1292,1920,628
23625,1,0,15,0,-15
23626,1,1,63,1422,1359
23627,1,0,28,0,-28
23628,0,0,84,0,-84
23629,1,1,1210,1257,47
23630,0,0,39,0,-39
23631,0,0,3,0,-3
23632,1,0,68,0,-68
23633,1,0,39,0,-39
23634,0,0,71,0,-71
23635,0,0,53,0,-53
23636,1,1,54,1292,1238
23637,1,1,821,1921,1100
23638,1,0,9,0,-9
23639,1,1,506,1392,886
23640,0,0,18,0,-18
23641,1,1,1066,1240,174
23642,0,0,37,0,-37
23643,1,0,17,0,-17
23644,1,0,16,0,-16
23645,1,1,262,2918,2656
23646,1,1,358,1215,857
23647,1,0,75,0,-75
23648,0,0,40,0,-40
23649,0,0,15,0,-15
23650,1,1,27,1454,1427
23651,0,0,72,0,-72
23652,0,0,58,0,-58
23653,0,0,36,0,-36
23654,1,0,20,0,-20
23655,1,0,72,0,-72
23656,1,0,55,0,-55
23657,0,0,85,0,-85
23658,0,0,32,0,-32
23659,1,0,82,0,-82
23660,0,0,86,0,-86
23661,1,0,16,0,-16
23662,1,1,897,2152,1255
23663,0,0,9,0,-9
23664,1,1,214,1263,1049
23665,0,0,50,0,-50
23666,0,0,92,0,-92
23667,0,0,38,0,-38
23668,0,0,22,0,-22
23669,1,1,292,3144,2852
23670,0,0,11,0,-11
23671,0,0,12,0,-12
23672,1,1,33,1391,1358
23673,1,1,1067,1235,168
23674,0,0,95,0,-95
23675,0,0,31,0,-31
23676,1,0,111,0,-111
23677,0,0,18,0,-18
23678,1,1,946,2089,1143
23679,0,0,98,0,-98
23680,1,1,733,1819,1086
23681,0,0,57,0,-57
23682,0,0,211,0,-211
23683,0,0,189,0,-189
23684,1,0,18,0,-18
23685,0,0,2,0,-2
23686,0,0,27,0,-27
23687,1,1,345,1253,908
23688,0,0,87,0,-87
23689,1,0,150,0,-150
23690,1,0,54,0,-54
23691,0,0,43,0,-43
23692,1,1,864,1381,517
23693,1,1,924,5579,4655
23694,1,0,23,0,-23
23695,1,0,40,0,-40
23696,0,0,17,0,-17
23697,0,0,12,0,-12
23698,1,1,179,1252,1073
23699,0,0,0,0,0
23700,0,0,37,0,-37
23701,0,0,45,0,-45
23702,1,1,1144,1440,296
23703,1,1,277,1792,1515
23704,0,0,15,0,-15
23705,1,0,24,0,-24
23706,0,0,22,0,-22
23707,1,0,26,0,-26
23708,0,0,19,0,-19
23709,0,0,13,0,-13
23710,0,0,9,0,-9
23711,0,0,10,0,-10
23712,0,0,53,0,-53
23713,1,0,38,0,-38
23714,0,0,31,0,-31
23715,1,0,77,0,-77
23716,0,0,32,0,-32
23717,1,1,1157,3483,2326
23718,1,1,55,1436,1381
23719,1,1,253,1405,1152
23720,0,0,11,0,-11
23721,0,0,5,0,-5
23722,1,0,51,0,-51
23723,0,0,25,0,-25
23724,1,0,33,0,-33
23725,0,0,45,0,-45
23726,0,0,11,0,-11
23727,0,0,45,0,-45
23728,1,0,42,0,-42
23729,0,0,97,0,-97
23730,1,1,97,1382,1285
23731,1,1,946,1508,562
23732,0,0,62,0,-62
23733,1,1,79,1374,1295
23734,1,1,287,1565,1278
23735,1,1,826,2499,1673
23736,1,0,120,0,-120
23737,0,0,13,0,-13
23738,0,0,63,0,-63
23739,1,0,24,0,-24
23740,1,1,1093,2015,922
23741,1,1,1233,1321,88
23742,0,0,128,0,-128
23743,0,0,23,0,-23
23744,1,0,2,0,-2
23745,1,1,467,1216,749
23746,1,0,37,0,-37
23747,1,0,5,0,-5
23748,0,0,5,0,-5
23749,1,0,22,0,-22
23750,1,1,720,1260,540
23751,1,0,3,0,-3
23752,0,0,30,0,-30
23753,1,0,52,0,-52
23754,0,0,17,0,-17
23755,0,0,72,0,-72
23756,1,0,34,0,-34
23757,1,0,53,0,-53
23758,0,0,3,0,-3
23759,1,0,0,0,0
23760,1,1,826,1357,531
23761,1,0,8,0,-8
23762,1,1,465,1349,884
23763,0,0,77,0,-77
23764,1,1,87,1502,1415
23765,1,1,508,1600,1092
23766,1,1,492,2495,2003
23767,1,1,305,1745,1440
23768,0,0,206,0,-206
23769,0,0,65,0,-65
23770,0,0,61,0,-61
23771,0,0,44,0,-44
23772,1,1,758,1239,481
23773,1,0,47,0,-47
23774,1,1,186,1210,1024
23775,0,0,103,0,-103
23776,1,0,43,0,-43
23777,1,0,41,0,-41
23778,0,0,74,0,-74
23779,0,0,6,0,-6
23780,0,0,111,0,-111
23781,0,0,27,0,-27
23782,1,1,133,1416,1283
23783,0,0,12,0,-12
23784,1,1,409,2171,1762
23785,1,1,1287,1279,-8
23786,0,0,27,0,-27
23787,1,1,115,1337,1222
23788,1,0,42,0,-42
23789,1,1,1273,1327,54
23790,1,1,836,3838,3002
23791,1,1,146,1221,1075
23792,1,1,449,1208,759
23793,1,0,84,0,-84
23794,0,0,74,0,-74
23795,1,0,31,0,-31
23796,1,0,15,0,-15
23797,1,1,736,1652,916
23798,1,0,54,0,-54
23799,1,1,347,1312,965
23800,1,1,481,1232,751
23801,1,0,79,0,-79
23802,0,0,0,0,0
23803,1,1,73,2026,1953
23804,1,0,233,0,-233
23805,1,0,13,0,-13
23806,1,0,270,0,-270
23807,1,0,161,0,-161
23808,0,0,21,0,-21
23809,0,0,12,0,-12
23810,1,0,30,0,-30
23811,1,1,562,1233,671
23812,1,1,1751,1615,-136
23813,1,1,617,2243,1626
23814,1,1,343,1394,1051
23815,1,1,152,1243,1091
23816,0,0,124,0,-124
23817,0,0,8,0,-8
23818,1,1,334,1642,1308
23819,1,1,574,1543,969
23820,0,0,10,0,-10
23821,1,1,580,1402,822
23822,0,0,11,0,-11
23823,1,1,1043,1466,423
23824,1,1,291,1267,976
23825,1,1,417,2285,1868
23826,1,1,245,1229,984
23827,0,0,123,0,-123
23828,1,1,314,2004,1690
23829,1,0,91,0,-91
23830,0,0,51,0,-51
23831,1,1,376,6409,6033
23832,1,0,85,0,-85
23833,1,0,37,0,-37
23834,1,1,88,1224,1136
23835,0,0,123,0,-123
23836,0,0,22,0,-22
23837,1,1,131,4932,4801
23838,0,0,135,0,-135
23839,1,1,330,1430,1100
23840,1,1,166,1985,1819
23841,1,0,80,0,-80
23842,1,1,505,1428,923
23843,1,1,412,1202,790
23844,0,0,16,0,-16
23845,0,0,238,0,-238
23846,1,0,14,0,-14
23847,1,0,64,0,-64
23848,1,0,29,0,-29
23849,0,0,45,0,-45
23850,1,1,228,1596,1368
23851,1,0,75,0,-75
23852,1,1,299,1267,968
23853,1,1,192,1495,1303
23854,0,0,9,0,-9
23855,0,0,55,0,-55
23856,0,0,44,0,-44
23857,1,0,107,0,-107
23858,1,0,6,0,-6
23859,0,0,79,0,-79
23860,1,0,1,0,-1
23861,0,0,72,0,-72
23862,1,0,13,0,-13
23863,0,0,71,0,-71
23864,1,0,13,0,-13
23865,1,0,32,0,-32
23866,1,0,55,0,-55
23867,0,0,9,0,-9
23868,1,0,74,0,-74
23869,1,0,183,0,-183
23870,1,1,50,1676,1626
23871,0,0,0,0,0
23872,1,0,21,0,-21
23873,0,0,32,0,-32
23874,0,0,83,0,-83
23875,1,1,392,1303,911
23876,1,1,152,1731,1579
23877,0,0,29,0,-29
23878,0,0,9,0,-9
23879,1,1,2999,1238,-1761
23880,0,0,2,0,-2
23881,0,0,43,0,-43
23882,0,0,27,0,-27
23883,1,0,21,0,-21
23884,0,0,70,0,-70
23885,0,0,210,0,-210
23886,0,0,79,0,-79
23887,1,1,509,2086,1577
23888,0,0,72,0,-72
23889,1,0,11,0,-11
23890,1,0,51,0,-51
23891,1,0,45,0,-45
23892,1,1,218,1835,1617
23893,0,0,117,0,-117
23894,1,0,111,0,-111
23895,0,0,83,0,-83
23896,1,0,11,0,-11
23897,0,0,36,0,-36
23898,0,0,73,0,-73
23899,1,0,56,0,-56
23900,0,0,0,0,0
23901,1,0,97,0,-97
23902,1,0,0,0,0
23903,1,1,347,1244,897
23904,1,0,22,0,-22
23905,1,0,21,0,-21
23906,1,0,12,0,-12
23907,1,1,761,1758,997
23908,1,1,724,1538,814
23909,1,0,45,0,-45
23910,0,0,37,0,-37
23911,0,0,112,0,-112
23912,1,0,59,0,-59
23913,0,0,156,0,-156
23914,0,0,5,0,-5
23915,1,1,935,1312,377
23916,0,0,51,0,-51
23917,1,1,516,1808,1292
23918,0,0,70,0,-70
23919,0,0,92,0,-92
23920,1,0,59,0,-59
23921,1,1,1133,2359,1226
23922,1,0,26,0,-26
23923,0,0,4,0,-4
23924,1,1,804,1234,430
23925,0,0,26,0,-26
23926,1,0,8,0,-8
23927,0,0,87,0,-87
23928,0,0,124,0,-124
23929,0,0,63,0,-63
23930,0,0,27,0,-27
23931,1,0,41,0,-41
23932,0,0,103,0,-103
23933,1,0,134,0,-134
23934,1,0,51,0,-51
23935,1,0,11,0,-11
23936,1,0,181,0,-181
23937,0,0,7,0,-7
23938,1,1,218,1480,1262
23939,1,0,1,0,-1
23940,1,0,45,0,-45
23941,1,1,1349,1876,527
23942,1,1,85,1658,1573
23943,0,0,41,0,-41
23944,0,0,1,0,-1
23945,0,0,22,0,-22
23946,1,0,156,0,-156
23947,0,0,19,0,-19
23948,0,0,13,0,-13
23949,1,1,79,1222,1143
23950,0,0,7,0,-7
23951,0,0,11,0,-11
23952,1,1,107,1436,1329
23953,1,0,42,0,-42
23954,0,0,56,0,-56
23955,1,0,35,0,-35
23956,0,0,85,0,-85
23957,0,0,2,0,-2
23958,1,1,685,1371,686
23959,1,0,3,0,-3
23960,1,1,310,1347,1037
23961,0,0,38,0,-38
23962,1,0,56,0,-56
23963,0,0,40,0,-40
23964,1,1,860,1234,374
23965,1,0,42,0,-42
23966,1,1,248,1347,1099
23967,1,1,530,1445,915
23968,1,1,298,1475,1177
23969,0,0,105,0,-105
23970,1,0,49,0,-49
23971,1,0,29,0,-29
23972,1,1,826,2326,1500
23973,1,1,106,3388,3282
23974,1,0,14,0,-14
23975,0,0,61,0,-61
23976,0,0,12,0,-12
23977,0,0,70,0,-70
23978,1,0,46,0,-46
23979,0,0,6,0,-6
23980,1,1,281,1351,1070
23981,0,0,67,0,-67
23982,0,0,12,0,-12
23983,1,1,726,1741,1015
23984,1,0,52,0,-52
23985,1,0,263,0,-263
23986,1,1,556,1567,1011
23987,0,0,32,0,-32
23988,0,0,15,0,-15
23989,1,0,38,0,-38
23990,0,0,37,0,-37
23991,1,1,455,1474,1019
23992,0,0,17,0,-17
23993,0,0,23,0,-23
23994,1,0,42,0,-42
23995,1,1,728,1216,488
23996,0,0,145,0,-145
23997,0,0,5,0,-5
23998,1,0,80,0,-80
23999,1,1,625,1281,656
24000,0,0,76,0,-76
24001,1,1,457,2028,1571
24002,1,0,17,0,-17
24003,1,0,2,0,-2
24004,1,1,366,1217,851
24005,0,0,86,0,-86
24006,1,0,92,0,-92
24007,0,0,26,0,-26
24008,1,0,41,0,-41
24009,1,1,1302,1505,203
24010,0,0,54,0,-54
24011,1,1,622,1954,1332
24012,1,1,178,2667,2489
24013,1,1,42,1675,1633
24014,1,1,809,1364,555
24015,1,1,149,1367,1218
24016,1,1,1906,1550,-356
24017,0,0,40,0,-40
24018,1,0,121,0,-121
24019,1,1,168,1377,1209
24020,0,0,99,0,-99
24021,1,1,312,1256,944
24022,1,0,38,0,-38
24023,1,0,37,0,-37
24024,1,1,197,2402,2205
24025,0,0,123,0,-123
24026,0,0,69,0,-69
24027,0,0,1,0,-1
24028,0,0,70,0,-70
24029,1,0,71,0,-71
24030,0,0,36,0,-36
24031,0,0,19,0,-19
24032,1,0,65,0,-65
24033,1,1,239,1879,1640
24034,1,0,25,0,-25
24035,1,1,164,1686,1522
24036,1,0,45,0,-45
24037,0,0,34,0,-34
24038,1,0,45,0,-45
24039,0,0,58,0,-58
24040,1,1,588,1457,869
24041,1,1,243,1223,980
24042,0,0,6,0,-6
24043,0,0,22,0,-22
24044,1,0,90,0,-90
24045,0,0,43,0,-43
24046,1,1,283,1525,1242
24047,1,0,161,0,-161
24048,1,1,29,1363,1334
24049,0,0,2,0,-2
24050,0,0,0,0,0
24051,0,0,7,0,-7
24052,0,0,59,0,-59
24053,1,0,21,0,-21
24054,1,0,10,0,-10
24055,1,0,27,0,-27
24056,1,1,175,1284,1109
24057,1,1,37,1398,1361
24058,0,0,10,0,-10
24059,1,0,1,0,-1
24060,0,0,31,0,-31
24061,0,0,11,0,-11
24062,1,1,174,1408,1234
24063,0,0,20,0,-20
24064,1,1,333,1542,1209
24065,0,0,23,0,-23
24066,1,0,12,0,-12
24067,0,0,4,0,-4
24068,0,0,58,0,-58
24069,1,0,0,0,0
24070,1,1,542,1356,814
24071,1,1,123,1205,1082
24072,0,0,32,0,-32
24073,0,0,11,0,-11
24074,1,0,45,0,-45
24075,0,0,22,0,-22
24076,1,0,74,0,-74
24077,0,0,27,0,-27
24078,0,0,4,0,-4
24079,1,1,60,1248,1188
24080,0,0,84,0,-84
24081,1,0,26,0,-26
24082,1,1,935,1987,1052
24083,0,0,55,0,-55
24084,1,0,49,0,-49
24085,0,0,1,0,-1
24086,1,1,180,1493,1313
24087,0,0,15,0,-15
24088,1,1,15,1636,1621
24089,1,1,292,2794,2502
24090,1,0,5,0,-5
24091,1,1,516,1511,995
24092,1,0,40,0,-40
24093,1,0,29,0,-29
24094,1,0,45,0,-45
24095,1,1,111,1319,1208
24096,1,1,679,1517,838
24097,1,0,32,0,-32
24098,0,0,161,0,-161
24099,1,0,21,0,-21
24100,1,1,2559,1216,-1343
24101,0,0,6,0,-6
24102,1,0,66,0,-66
24103,1,1,294,2562,2268
24104,0,0,46,0,-46
24105,1,0,37,0,-37
24106,1,0,150,0,-150
24107,0,0,14,0,-14
24108,1,0,139,0,-139
24109,1,0,75,0,-75
24110,0,0,60,0,-60
24111,1,0,11,0,-11
24112,0,0,68,0,-68
24113,0,0,12,0,-12
24114,1,0,73,0,-73
24115,0,0,28,0,-28
24116,1,1,1586,1578,-8
24117,1,1,165,1339,1174
24118,0,0,22,0,-22
24119,1,1,477,1409,932
24120,1,1,1089,2932,1843
24121,1,1,139,1224,1085
24122,1,1,432,2368,1936
24123,1,1,64,1222,1158
24124,1,0,38,0,-38
24125,0,0,25,0,-25
24126,1,1,68,1203,1135
24127,1,0,8,0,-8
24128,0,0,0,0,0
24129,1,0,26,0,-26
24130,0,0,43,0,-43
24131,0,0,32,0,-32
24132,1,0,4,0,-4
24133,1,0,29,0,-29
24134,1,0,25,0,-25
24135,1,0,51,0,-51
24136,1,1,249,1250,1001
24137,0,0,3,0,-3
24138,1,1,255,1239,984
24139,1,0,68,0,-68
24140,0,0,4,0,-4
24141,1,0,17,0,-17
24142,1,0,58,0,-58
24143,0,0,9,0,-9
24144,0,0,57,0,-57
24145,0,0,13,0,-13
24146,1,0,29,0,-29
24147,1,1,111,3129,3018
24148,1,1,184,1823,1639
24149,1,0,30,0,-30
24150,1,1,220,1624,1404
24151,1,0,25,0,-25
24152,1,0,7,0,-7
24153,1,0,125,0,-125
24154,0,0,41,0,-41
24155,0,0,28,0,-28
24156,1,0,6,0,-6
24157,1,0,9,0,-9
24158,1,1,78,1228,1150
24159,1,1,20,2439,2419
24160,1,0,27,0,-27
24161,1,0,80,0,-80
24162,1,0,14,0,-14
24163,0,0,0,0,0
24164,0,0,22,0,-22
24165,1,0,47,0,-47
24166,1,1,2069,1301,-768
24167,1,0,98,0,-98
24168,0,0,0,0,0
24169,1,0,51,0,-51
24170,1,1,16,1323,1307
24171,1,1,869,2039,1170
24172,0,0,1,0,-1
24173,0,0,60,0,-60
24174,1,0,21,0,-21
24175,1,1,560,1204,644
24176,1,1,371,2262,1891
24177,1,1,1319,1500,181
24178,1,1,228,1411,1183
24179,1,1,754,1254,500
24180,0,0,15,0,-15
24181,1,1,94,1301,1207
24182,1,0,37,0,-37
24183,0,0,33,0,-33
24184,1,1,792,1412,620
24185,1,1,730,1672,942
24186,1,0,52,0,-52
24187,1,0,3,0,-3
24188,1,0,16,0,-16
24189,1,1,966,1233,267
24190,0,0,8,0,-8
24191,1,0,42,0,-42
24192,1,0,109,0,-109
24193,1,1,172,1245,1073
24194,0,0,37,0,-37
24195,0,0,7,0,-7
24196,1,0,124,0,-124
24197,0,0,15,0,-15
24198,1,0,8,0,-8
24199,0,0,32,0,-32
24200,1,0,48,0,-48
24201,0,0,109,0,-109
24202,0,0,4,0,-4
24203,1,0,77,0,-77
24204,1,1,181,1296,1115
24205,1,0,39,0,-39
24206,1,0,41,0,-41
24207,0,0,22,0,-22
24208,0,0,14,0,-14
24209,1,1,236,1400,1164
24210,0,0,59,0,-59
24211,1,0,91,0,-91
24212,1,0,5,0,-5
24213,1,1,497,1411,914
24214,1,1,257,1287,1030
24215,0,0,7,0,-7
24216,0,0,27,0,-27
24217,0,0,178,0,-178
24218,1,0,10,0,-10
24219,1,1,367,1200,833
24220,0,0,80,0,-80
24221,1,0,24,0,-24
24222,0,0,85,0,-85
24223,1,1,95,1354,1259
24224,0,0,34,0,-34
24225,1,0,14,0,-14
24226,1,0,6,0,-6
24227,0,0,2,0,-2
24228,1,1,418,1299,881
24229,0,0,10,0,-10
24230,1,1,359,1308,949
24231,0,0,118,0,-118
24232,1,1,409,2497,2088
24233,1,1,1728,1381,-347
24234,1,0,62,0,-62
24235,1,0,86,0,-86
24236,1,0,8,0,-8
24237,0,0,47,0,-47
24238,1,0,18,0,-18
24239,1,1,378,1913,1535
24240,0,0,274,0,-274
24241,1,1,821,4380,3559
24242,1,1,52,1308,1256
24243,1,1,837,1244,407
24244,1,0,27,0,-27
24245,1,0,51,0,-51
24246,1,1,1126,1809,683
24247,1,0,143,0,-143
24248,0,0,7,0,-7
24249,1,0,25,0,-25
24250,1,1,342,1322,980
24251,0,0,15,0,-15
24252,1,1,1794,1304,-490
24253,0,0,30,0,-30
24254,1,0,64,0,-64
24255,0,0,3,0,-3
24256,1,0,92,0,-92
24257,1,1,879,1532,653
24258,0,0,1,0,-1
24259,0,0,56,0,-56
24260,1,1,290,1288,998
24261,0,0,18,0,-18
24262,1,0,25,0,-25
24263,1,1,491,1241,750
24264,0,0,48,0,-48
24265,0,0,14,0,-14
24266,0,0,23,0,-23
24267,1,1,442,1830,1388
24268,1,1,947,1282,335
24269,1,1,179,1611,1432
24270,0,0,38,0,-38
24271,1,1,757,1434,677
24272,1,1,1078,1611,533
24273,0,0,48,0,-48
24274,1,1,1224,1521,297
24275,1,0,30,0,-30
24276,0,0,55,0,-55
24277,1,1,158,1208,1050
24278,1,1,896,1223,327
24279,0,0,25,0,-25
24280,0,0,26,0,-26
24281,0,0,95,0,-95
24282,0,0,72,0,-72
24283,1,0,40,0,-40
24284,1,0,101,0,-101
24285,0,0,31,0,-31
24286,1,0,26,0,-26
24287,1,1,914,1412,498
24288,1,0,33,0,-33
24289,1,1,448,1290,842
24290,1,0,96,0,-96
24291,1,0,25,0,-25
24292,1,0,27,0,-27
24293,0,0,6,0,-6
24294,1,0,21,0,-21
24295,0,0,134,0,-134
24296,0,0,55,0,-55
24297,1,0,116,0,-116
24298,0,0,5,0,-5
24299,0,0,45,0,-45
24300,0,0,66,0,-66
24301,0,0,32,0,-32
24302,0,0,20,0,-20
24303,0,0,9,0,-9
24304,1,0,83,0,-83
24305,1,1,280,1320,1040
24306,1,1,623,1462,839
24307,1,0,82,0,-82
24308,0,0,41,0,-41
24309,0,0,46,0,-46
24310,0,0,82,0,-82
24311,0,0,42,0,-42
24312,0,0,123,0,-123
24313,1,1,19,1414,1395
24314,1,0,21,0,-21
24315,1,0,92,0,-92
24316,1,1,70,1967,1897
24317,1,1,284,1553,1269
24318,0,0,32,0,-32
24319,0,0,100,0,-100
24320,1,0,154,0,-154
24321,1,1,308,1707,1399
24322,1,0,145,0,-145
24323,0,0,74,0,-74
24324,0,0,78,0,-78
24325,1,0,86,0,-86
24326,0,0,28,0,-28
24327,1,0,52,0,-52
24328,1,0,23,0,-23
24329,0,0,138,0,-138
24330,1,1,110,1480,1370
24331,1,1,146,1314,1168
24332,1,1,923,1283,360
24333,1,1,520,1589,1069
24334,0,0,129,0,-129
24335,0,0,25,0,-25
24336,0,0,23,0,-23
24337,0,0,56,0,-56
24338,1,0,3,0,-3
24339,1,1,642,1418,776
24340,1,0,34,0,-34
24341,1,0,23,0,-23
24342,1,1,252,4335,4083
24343,1,1,552,2670,2118
24344,1,1,1130,2406,1276
24345,0,0,48,0,-48
24346,1,1,1313,1220,-93
24347,0,0,16,0,-16
24348,0,0,42,0,-42
24349,1,1,429,1281,852
24350,1,0,57,0,-57
24351,1,0,103,0,-103
24352,1,1,1508,1413,-95
24353,1,0,1,0,-1
24354,0,0,61,0,-61
24355,1,1,1299,2081,782
24356,0,0,32,0,-32
24357,1,0,10,0,-10
24358,1,0,8,0,-8
24359,1,0,8,0,-8
24360,1,1,945,1261,316
24361,0,0,3,0,-3
24362,0,0,11,0,-11
24363,1,0,17,0,-17
24364,0,0,32,0,-32
24365,1,1,319,1381,1062
24366,0,0,15,0,-15
24367,1,0,19,0,-19
24368,0,0,51,0,-51
24369,1,0,1,0,-1
24370,1,1,784,1662,878
24371,1,1,127,1390,1263
24372,0,0,41,0,-41
24373,0,0,81,0,-81
24374,0,0,33,0,-33
24375,0,0,7,0,-7
24376,0,0,9,0,-9
24377,0,0,204,0,-204
24378,1,0,125,0,-125
24379,1,0,167,0,-167
24380,0,0,44,0,-44
24381,1,0,245,0,-245
24382,1,0,58,0,-58
24383,0,0,9,0,-9
24384,1,1,651,1286,635
24385,1,1,226,1362,1136
24386,1,1,7,1487,1480
24387,0,0,126,0,-126
24388,0,0,0,0,0
24389,1,0,75,0,-75
24390,0,0,7,0,-7
24391,0,0,22,0,-22
24392,1,1,98,1230,1132
24393,0,0,20,0,-20
24394,1,1,253,1220,967
24395,1,1,1013,1399,386
24396,1,1,448,1367,919
24397,1,0,130,0,-130
24398,1,1,139,1566,1427
24399,0,0,2,0,-2
24400,1,0,47,0,-47
24401,1,1,1358,1392,34
24402,0,0,140,0,-140
24403,1,1,191,1945,1754
24404,0,0,4,0,-4
24405,1,0,27,0,-27
24406,1,1,47,1320,1273
24407,0,0,2,0,-2
24408,1,0,18,0,-18
24409,1,0,370,0,-370
24410,1,0,103,0,-103
24411,1,0,2,0,-2
24412,0,0,35,0,-35
24413,0,0,4,0,-4
24414,0,0,55,0,-55
24415,0,0,1,0,-1
24416,0,0,45,0,-45
24417,0,0,70,0,-70
24418,0,0,33,0,-33
24419,1,1,880,1335,455
24420,1,0,0,0,0
24421,0,0,91,0,-91
24422,0,0,23,0,-23
24423,1,0,11,0,-11
24424,1,0,29,0,-29
24425,1,1,854,1340,486
24426,0,0,39,0,-39
24427,1,0,93,0,-93
24428,1,0,53,0,-53
24429,1,0,91,0,-91
24430,1,1,714,1376,662
24431,0,0,56,0,-56
24432,1,1,474,1212,738
24433,1,1,1101,1225,124
24434,1,1,553,1654,1101
24435,1,0,17,0,-17
24436,0,0,42,0,-42
24437,1,0,48,0,-48
24438,0,0,44,0,-44
24439,0,0,76,0,-76
24440,1,0,53,0,-53
24441,1,0,87,0,-87
24442,0,0,57,0,-57
24443,0,0,60,0,-60
24444,0,0,20,0,-20
24445,1,1,127,1232,1105
24446,1,0,46,0,-46
24447,0,0,18,0,-18
24448,1,0,19,0,-19
24449,1,1,161,1588,1427
24450,1,0,4,0,-4
24451,1,1,1488,1379,-109
24452,1,1,349,1708,1359
24453,1,0,74,0,-74
24454,1,0,30,0,-30
24455,1,0,91,0,-91
24456,1,1,206,2012,1806
24457,0,0,92,0,-92
24458,0,0,29,0,-29
24459,1,1,974,1258,284
24460,1,1,407,1223,816
24461,1,1,549,1251,702
24462,0,0,3,0,-3
24463,0,0,8,0,-8
24464,1,1,516,1259,743
24465,0,0,9,0,-9
24466,1,1,414,2788,2374
24467,0,0,22,0,-22
24468,0,0,104,0,-104
24469,0,0,42,0,-42
24470,0,0,1,0,-1
24471,1,1,988,1208,220
24472,1,1,725,1303,578
24473,1,1,666,1419,753
24474,0,0,33,0,-33
24475,1,0,33,0,-33
24476,1,1,891,1200,309
24477,1,0,27,0,-27
24478,1,1,1803,1214,-589
24479,0,0,10,0,-10
24480,0,0,95,0,-95
24481,0,0,43,0,-43
24482,1,0,25,0,-25
24483,1,1,188,1758,1570
24484,1,0,7,0,-7
24485,0,0,50,0,-50
24486,1,1,1982,1411,-571
24487,0,0,22,0,-22
24488,1,0,11,0,-11
24489,1,0,53,0,-53
24490,0,0,164,0,-164
24491,0,0,4,0,-4
24492,1,1,861,1860,999
24493,0,0,161,0,-161
24494,1,0,19,0,-19
24495,0,0,101,0,-101
24496,0,0,7,0,-7
24497,0,0,3,0,-3
24498,1,0,105,0,-105
24499,1,1,705,1253,548
24500,1,0,13,0,-13
24501,1,0,30,0,-30
24502,1,1,403,2299,1896
24503,1,1,392,1613,1221
24504,1,1,149,1463,1314
24505,0,0,20,0,-20
24506,1,1,806,1226,420
24507,1,1,94,1225,1131
24508,0,0,105,0,-105
24509,1,0,128,0,-128
24510,0,0,50,0,-50
24511,0,0,17,0,-17
24512,0,0,7,0,-7
24513,1,1,286,1378,1092
24514,1,1,244,1558,1314
24515,1,0,125,0,-125
24516,1,0,6,0,-6
24517,1,1,33,1549,1516
24518,1,1,73,1712,1639
24519,0,0,48,0,-48
24520,1,0,47,0,-47
24521,1,1,1038,1365,327
24522,0,0,9,0,-9
24523,1,1,1061,1233,172
24524,1,1,98,1272,1174
24525,1,1,335,1250,915
24526,1,1,276,1409,1133
24527,0,0,13,0,-13
24528,0,0,24,0,-24
24529,0,0,8,0,-8
24530,0,0,0,0,0
24531,1,0,82,0,-82
24532,1,0,76,0,-76
24533,0,0,13,0,-13
24534,1,1,2230,2994,764
24535,0,0,36,0,-36
24536,1,0,10,0,-10
24537,1,1,687,1468,781
24538,1,1,286,1221,935
24539,1,0,56,0,-56
24540,1,1,301,1639,1338
24541,1,1,51,1361,1310
24542,1,0,114,0,-114
24543,1,1,526,1238,712
24544,1,1,2168,1805,-363
24545,1,1,158,1536,1378
24546,0,0,9,0,-9
24547,0,0,21,0,-21
24548,0,0,68,0,-68
24549,1,1,386,1614,1228
24550,1,0,5,0,-5
24551,0,0,89,0,-89
24552,1,1,86,1735,1649
24553,0,0,19,0,-19
24554,1,0,9,0,-9
24555,1,0,17,0,-17
24556,1,1,265,1207,942
24557,1,0,30,0,-30
24558,0,0,134,0,-134
24559,0,0,37,0,-37
24560,1,1,438,1240,802
24561,1,0,38,0,-38
24562,1,1,420,1243,823
24563,1,1,926,1240,314
24564,1,0,12,0,-12
24565,1,0,103,0,-103
24566,0,0,78,0,-78
24567,1,1,1071,2255,1184
24568,0,0,52,0,-52
24569,1,1,1181,1773,592
24570,0,0,39,0,-39
24571,1,1,2134,1242,-892
24572,1,0,82,0,-82
24573,1,0,122,0,-122
24574,0,0,1,0,-1
24575,1,1,321,1417,1096
24576,1,1,123,1730,1607
24577,0,0,9,0,-9
24578,1,1,826,1713,887
24579,0,0,35,0,-35
24580,0,0,36,0,-36
24581,1,1,173,1443,1270
24582,1,0,12,0,-12
24583,0,0,27,0,-27
24584,0,0,60,0,-60
24585,1,1,232,1699,1467
24586,0,0,83,0,-83
24587,1,1,717,1509,792
24588,1,1,476,2312,1836
24589,0,0,57,0,-57
24590,1,1,136,1341,1205
24591,0,0,5,0,-5
24592,1,1,499,1510,1011
24593,0,0,77,0,-77
24594,1,1,139,1258,1119
24595,1,1,24,1203,1179
24596,0,0,20,0,-20
24597,0,0,18,0,-18
24598,1,1,187,1485,1298
24599,1,1,1784,1272,-512
24600,1,0,2,0,-2
24601,1,1,314,1436,1122
24602,0,0,10,0,-10
24603,0,0,61,0,-61
24604,1,1,358,1269,911
24605,1,1,713,1239,526
24606,0,0,29,0,-29
24607,0,0,90,0,-90
24608,0,0,9,0,-9
24609,1,1,247,1321,1074
24610,0,0,2,0,-2
24611,1,1,233,1298,1065
24612,0,0,11,0,-11
24613,1,0,152,0,-152
24614,1,1,111,1607,1496
24615,1,0,124,0,-124
24616,1,1,307,1242,935
24617,1,1,476,1568,1092
24618,0,0,43,0,-43
24619,1,0,54,0,-54
24620,1,1,214,1250,1036
24621,0,0,85,0,-85
24622,1,1,792,1279,487
24623,0,0,2,0,-2
24624,0,0,27,0,-27
24625,0,0,38,0,-38
24626,0,0,190,0,-190
24627,1,0,132,0,-132
24628,1,1,166,1701,1535
24629,1,0,52,0,-52
24630,1,1,150,1412,1262
24631,1,0,107,0,-107
24632,0,0,13,0,-13
24633,1,1,383,1492,1109
24634,0,0,60,0,-60
24635,1,1,368,1515,1147
24636,1,1,361,1948,1587
24637,0,0,70,0,-70
24638,1,0,138,0,-138
24639,1,0,32,0,-32
24640,0,0,1,0,-1
24641,0,0,21,0,-21
24642,0,0,66,0,-66
24643,0,0,12,0,-12
24644,0,0,60,0,-60
24645,1,0,77,0,-77
24646,1,1,561,1849,1288
24647,1,1,296,1231,935
24648,1,0,9,0,-9
24649,0,0,26,0,-26
24650,1,0,2,0,-2
24651,1,0,33,0,-33
24652,1,1,356,1317,961
24653,1,1,29,1255,1226
24654,0,0,58,0,-58
24655,0,0,61,0,-61
24656,1,1,4049,1318,-2731
24657,1,0,77,0,-77
24658,1,1,245,2215,1970
24659,0,0,111,0,-111
24660,0,0,18,0,-18
24661,1,0,14,0,-14
24662,1,0,1,0,-1
24663,0,0,12,0,-12
24664,1,0,10,0,-10
24665,1,1,637,1276,639
24666,1,0,5,0,-5
24667,0,0,69,0,-69
24668,1,1,744,1586,842
24669,1,0,9,0,-9
24670,1,1,106,1394,1288
24671,1,0,31,0,-31
24672,0,0,11,0,-11
24673,0,0,6,0,-6
24674,1,1,150,1679,1529
24675,1,1,1346,2213,867
24676,1,1,352,1852,1500
24677,1,0,98,0,-98
24678,1,0,154,0,-154
24679,0,0,41,0,-41
24680,0,0,26,0,-26
24681,1,1,1048,1248,200
24682,1,0,55,0,-55
24683,1,1,242,2242,2000
24684,0,0,86,0,-86
24685,1,1,62,1554,1492
24686,1,0,55,0,-55
24687,0,0,4,0,-4
24688,1,1,806,2462,1656
24689,0,0,25,0,-25
24690,0,0,134,0,-134
24691,1,0,2,0,-2
24692,1,0,23,0,-23
24693,1,1,765,1432,667
24694,1,0,158,0,-158
24695,1,1,223,1201,978
24696,0,0,8,0,-8
24697,0,0,53,0,-53
24698,1,1,591,1531,940
24699,1,0,56,0,-56
24700,1,0,26,0,-26
24701,0,0,54,0,-54
24702,0,0,1,0,-1
24703,1,1,34,1312,1278
24704,1,1,1995,1383,-612
24705,0,0,13,0,-13
24706,1,1,355,1249,894
24707,1,1,588,1540,952
24708,0,0,6,0,-6
24709,0,0,91,0,-91
24710,0,0,31,0,-31
24711,1,0,14,0,-14
24712,1,1,1386,2403,1017
24713,0,0,71,0,-71
24714,1,0,27,0,-27
24715,1,0,23,0,-23
24716,1,0,10,0,-10
24717,0,0,44,0,-44
24718,1,0,52,0,-52
24719,0,0,18,0,-18
24720,1,1,1315,2844,1529
24721,1,1,376,1207,831
24722,1,0,19,0,-19
24723,1,1,243,2012,1769
24724,1,0,10,0,-10
24725,1,0,2,0,-2
24726,0,0,35,0,-35
24727,1,1,149,1360,1211
24728,1,1,19,1372,1353
24729,0,0,24,0,-24
24730,0,0,63,0,-63
24731,0,0,29,0,-29
24732,1,0,1,0,-1
24733,1,1,1127,1388,261
24734,0,0,17,0,-17
24735,0,0,42,0,-42
24736,0,0,30,0,-30
24737,1,1,791,1202,411
24738,1,0,110,0,-110
24739,0,0,42,0,-42
24740,1,0,23,0,-23
24741,1,1,343,1979,1636
24742,1,1,2500,1435,-1065
24743,0,0,77,0,-77
24744,1,1,27,1255,1228
24745,1,0,36,0,-36
24746,0,0,72,0,-72
24747,1,1,1338,2444,1106
24748,1,0,48,0,-48
24749,0,0,1,0,-1
24750,0,0,45,0,-45
24751,1,1,499,1403,904
24752,1,1,186,3213,3027
24753,1,1,577,1733,1156
24754,1,0,13,0,-13
24755,1,1,1489,1954,465
24756,1,1,909,2043,1134
24757,1,1,623,1434,811
24758,0,0,7,0,-7
24759,1,0,15,0,-15
24760,1,1,127,1342,1215
24761,1,0,15,0,-15
24762,0,0,21,0,-21
24763,1,0,124,0,-124
24764,0,0,65,0,-65
24765,1,1,198,1505,1307
24766,0,0,6,0,-6
24767,0,0,34,0,-34
24768,1,1,146,1439,1293
24769,0,0,2,0,-2
24770,1,0,116,0,-116
24771,1,1,986,2427,1441
24772,0,0,29,0,-29
24773,1,0,19,0,-19
24774,1,0,71,0,-71
24775,1,1,213,1493,1280
24776,1,0,23,0,-23
24777,1,1,71,1394,1323
24778,1,1,399,1363,964
24779,1,0,67,0,-67
24780,0,0,105,0,-105
24781,0,0,2,0,-2
24782,1,0,37,0,-37
24783,1,1,1094,1274,180
24784,0,0,31,0,-31
24785,0,0,90,0,-90
24786,0,0,17,0,-17
24787,1,1,511,1203,692
24788,0,0,17,0,-17
24789,0,0,4,0,-4
24790,0,0,115,0,-115
24791,1,0,2,0,-2
24792,1,0,71,0,-71
24793,1,1,760,1358,598
24794,0,0,30,0,-30
24795,1,1,153,2168,2015
24796,1,1,287,1321,1034
24797,1,0,54,0,-54
24798,0,0,37,0,-37
24799,1,0,61,0,-61
24800,1,0,21,0,-21
24801,0,0,30,0,-30
24802,1,1,247,1373,1126
24803,1,0,34,0,-34
24804,1,1,529,1202,673
24805,0,0,73,0,-73
24806,0,0,1,0,-1
24807,1,1,548,2057,1509
24808,1,0,22,0,-22
24809,0,0,2,0,-2
24810,0,0,33,0,-33
24811,1,0,132,0,-132
24812,0,0,48,0,-48
24813,1,0,80,0,-80
24814,1,0,55,0,-55
24815,0,0,87,0,-87
24816,1,1,381,1441,1060
24817,1,1,1639,2243,604
24818,1,0,1,0,-1
24819,0,0,21,0,-21
24820,0,0,32,0,-32
24821,1,1,224,2537,2313
24822,0,0,54,0,-54
24823,1,0,25,0,-25
24824,1,0,1,0,-1
24825,1,1,518,1283,765
24826,0,0,14,0,-14
24827,1,0,7,0,-7
24828,1,0,182,0,-182
24829,0,0,24,0,-24
24830,0,0,74,0,-74
24831,1,1,417,2008,1591
24832,1,0,117,0,-117
24833,0,0,52,0,-52
24834,1,1,70,1259,1189
24835,0,0,47,0,-47
24836,1,0,39,0,-39
24837,1,0,14,0,-14
24838,1,1,785,1685,900
24839,0,0,47,0,-47
24840,1,0,5,0,-5
24841,1,0,19,0,-19
24842,1,0,39,0,-39
24843,1,0,11,0,-11
24844,1,0,3,0,-3
24845,0,0,98,0,-98
24846,1,0,46,0,-46
24847,0,0,105,0,-105
24848,1,1,681,2341,1660
24849,0,0,3,0,-3
24850,1,0,27,0,-27
24851,1,0,33,0,-33
24852,0,0,25,0,-25
24853,0,0,58,0,-58
24854,0,0,81,0,-81
24855,1,0,10,0,-10
24856,1,0,4,0,-4
24857,0,0,126,0,-126
24858,1,0,173,0,-173
24859,1,0,119,0,-119
24860,1,1,1276,1413,137
24861,0,0,63,0,-63
24862,0,0,86,0,-86
24863,0,0,70,0,-70
24864,1,0,27,0,-27
24865,1,0,138,0,-138
24866,1,0,6,0,-6
24867,1,1,881,1636,755
24868,0,0,66,0,-66
24869,0,0,121,0,-121
24870,0,0,8,0,-8
24871,1,0,0,0,0
24872,0,0,1,0,-1
24873,1,0,202,0,-202
24874,0,0,87,0,-87
24875,0,0,172,0,-172
24876,1,1,328,1244,916
24877,1,1,1182,3743,2561
24878,1,1,299,1486,1187
24879,1,1,625,1729,1104
24880,1,1,691,1458,767
24881,0,0,17,0,-17
24882,1,0,3,0,-3
24883,1,0,17,0,-17
24884,0,0,72,0,-72
24885,0,0,22,0,-22
24886,1,1,817,1366,549
24887,1,1,909,1251,342
24888,1,1,394,2963,2569
24889,1,0,16,0,-16
24890,1,0,2,0,-2
24891,1,1,1420,1452,32
24892,1,0,15,0,-15
24893,1,1,317,1707,1390
24894,0,0,16,0,-16
24895,1,1,1067,1517,450
24896,1,0,12,0,-12
24897,1,1,195,1387,1192
24898,1,0,0,0,0
24899,1,1,574,1655,1081
24900,1,1,826,1245,419
24901,0,0,40,0,-40
24902,0,0,2,0,-2
24903,0,0,69,0,-69
24904,0,0,5,0,-5
24905,0,0,34,0,-34
24906,0,0,4,0,-4
24907,1,1,274,1360,1086
24908,1,1,174,1243,1069
24909,1,1,246,2726,2480
24910,1,1,799,2972,2173
24911,1,1,115,1266,1151
24912,1,0,109,0,-109
24913,1,0,20,0,-20
24914,1,1,307,1587,1280
24915,1,0,76,0,-76
24916,1,1,279,2176,1897
24917,1,1,465,1960,1495
24918,0,0,21,0,-21
24919,1,0,206,0,-206
24920,1,1,490,1767,1277
24921,0,0,3,0,-3
24922,1,1,488,1724,1236
24923,1,1,127,1578,1451
24924,0,0,21,0,-21
24925,1,0,8,0,-8
24926,0,0,99,0,-99
24927,1,1,466,1353,887
24928,0,0,23,0,-23
24929,1,1,55,1209,1154
24930,0,0,93,0,-93
24931,0,0,0,0,0
24932,0,0,98,0,-98
24933,1,0,51,0,-51
24934,0,0,47,0,-47
24935,1,0,8,0,-8
24936,1,0,14,0,-14
24937,1,0,69,0,-69
24938,1,0,3,0,-3
24939,0,0,120,0,-120
24940,1,0,93,0,-93
24941,0,0,6,0,-6
24942,0,0,0,0,0
24943,0,0,105,0,-105
24944,0,0,19,0,-19
24945,1,1,691,1351,660
24946,1,0,1,0,-1
24947,0,0,96,0,-96
24948,1,1,1085,1439,354
24949,1,1,415,1217,802
24950,0,0,41,0,-41
24951,1,1,88,1302,1214
24952,1,0,24,0,-24
24953,1,0,22,0,-22
24954,0,0,31,0,-31
24955,0,0,8,0,-8
24956,1,0,31,0,-31
24957,1,1,495,1299,804
24958,1,0,4,0,-4
24959,1,1,824,1839,1015
24960,1,0,8,0,-8
24961,0,0,0,0,0
24962,1,1,651,1926,1275
24963,0,0,59,0,-59
24964,1,0,17,0,-17
24965,1,1,282,1270,988
24966,1,1,399,1299,900
24967,0,0,181,0,-181
24968,0,0,66,0,-66
24969,0,0,14,0,-14
24970,1,1,283,2286,2003
24971,1,1,178,1310,1132
24972,1,0,137,0,-137
24973,0,0,1,0,-1
24974,1,1,85,1446,1361
24975,1,1,1356,1261,-95
24976,1,0,15,0,-15
24977,1,1,998,1501,503
24978,1,0,31,0,-31
24979,1,0,38,0,-38
24980,0,0,10,0,-10
24981,1,0,223,0,-223
24982,0,0,10,0,-10
24983,0,0,82,0,-82
24984,0,0,25,0,-25
24985,1,0,116,0,-116
24986,0,0,66,0,-66
24987,1,0,0,0,0
24988,1,0,10,0,-10
24989,0,0,40,0,-40
24990,0,0,124,0,-124
24991,0,0,7,0,-7
24992,0,0,3,0,-3
24993,0,0,61,0,-61
24994,1,0,10,0,-10
24995,1,1,200,1438,1238
24996,1,0,4,0,-4
24997,1,0,87,0,-87
24998,0,0,49,0,-49
24999,0,0,0,0,0
25000,0,0,60,0,-60
25001,1,1,126,1586,1460
25002,1,0,0,0,0
25003,1,0,12,0,-12
25004,1,1,678,1408,730
25005,0,0,132,0,-132
25006,1,0,32,0,-32
25007,1,0,92,0,-92
25008,1,0,1,0,-1
25009,0,0,78,0,-78
25010,0,0,52,0,-52
25011,1,1,745,1358,613
25012,1,1,129,1301,1172
25013,1,0,3,0,-3
25014,0,0,34,0,-34
25015,0,0,109,0,-109
25016,1,1,585,1212,627
25017,0,0,13,0,-13
25018,1,0,14,0,-14
25019,0,0,2,0,-2
25020,0,0,41,0,-41
25021,0,0,15,0,-15
25022,0,0,24,0,-24
25023,1,0,7,0,-7
25024,1,0,65,0,-65
25025,1,0,10,0,-10
25026,0,0,138,0,-138
25027,0,0,170,0,-170
25028,1,1,85,1666,1581
25029,0,0,38,0,-38
25030,1,0,48,0,-48
25031,0,0,25,0,-25
25032,1,0,0,0,0
25033,1,1,442,1309,867
25034,1,1,262,1222,960
25035,1,1,298,1332,1034
25036,0,0,1,0,-1
25037,1,1,131,1591,1460
25038,1,0,6,0,-6
25039,1,0,7,0,-7
25040,0,0,75,0,-75
25041,0,0,44,0,-44
25042,1,0,1,0,-1
25043,1,1,640,1469,829
25044,0,0,81,0,-81
25045,1,1,421,1383,962
25046,1,0,50,0,-50
25047,1,1,619,2064,1445
25048,1,1,188,1526,1338
25049,1,0,29,0,-29
25050,1,0,7,0,-7
25051,1,0,4,0,-4
25052,1,0,29,0,-29
25053,1,1,717,2015,1298
25054,0,0,25,0,-25
25055,1,0,11,0,-11
25056,0,0,12,0,-12
25057,1,1,43,1711,1668
25058,1,0,221,0,-221
25059,1,1,94,1651,1557
25060,0,0,104,0,-104
25061,1,1,254,1293,1039
25062,0,0,14,0,-14
25063,0,0,4,0,-4
25064,0,0,20,0,-20
25065,1,0,30,0,-30
25066,0,0,1,0,-1
25067,0,0,68,0,-68
25068,1,1,478,1201,723
25069,0,0,56,0,-56
25070,1,1,198,1438,1240
25071,0,0,29,0,-29
25072,0,0,39,0,-39
25073,1,1,178,1717,1539
25074,1,0,9,0,-9
25075,0,0,19,0,-19
25076,1,0,55,0,-55
25077,0,0,29,0,-29
25078,1,0,80,0,-80
25079,1,1,1174,1598,424
25080,1,1,304,3277,2973
25081,1,1,810,1386,576
25082,1,0,58,0,-58
25083,0,0,10,0,-10
25084,1,1,1491,1304,-187
25085,1,1,90,1370,1280
25086,0,0,167,0,-167
25087,1,0,103,0,-103
25088,0,0,14,0,-14
25089,0,0,2,0,-2
25090,1,1,492,1379,887
25091,1,0,10,0,-10
25092,0,0,138,0,-138
25093,1,1,243,2331,2088
25094,1,1,442,1200,758
25095,0,0,3,0,-3
25096,0,0,16,0,-16
25097,1,0,64,0,-64
25098,1,0,85,0,-85
25099,0,0,11,0,-11
25100,1,0,204,0,-204
25101,0,0,11,0,-11
25102,1,0,247,0,-247
25103,0,0,48,0,-48
25104,1,1,669,2470,1801
25105,1,1,338,2541,2203
25106,1,1,601,1439,838
25107,1,1,572,2194,1622
25108,1,0,78,0,-78
25109,1,0,86,0,-86
25110,1,1,263,1355,1092
25111,0,0,56,0,-56
25112,1,0,11,0,-11
25113,1,1,974,1708,734
25114,0,0,72,0,-72
25115,0,0,2,0,-2
25116,1,0,125,0,-125
25117,1,0,12,0,-12
25118,0,0,56,0,-56
25119,0,0,25,0,-25
25120,1,1,508,1219,711
25121,0,0,69,0,-69
25122,1,1,339,1973,1634
25123,1,0,91,0,-91
25124,1,1,714,6408,5694
25125,0,0,64,0,-64
25126,1,0,13,0,-13
25127,1,1,156,1582,1426
25128,0,0,37,0,-37
25129,1,1,436,2241,1805
25130,1,0,96,0,-96
25131,0,0,30,0,-30
25132,1,1,2791,1846,-945
25133,1,1,833,1667,834
25134,0,0,0,0,0
25135,1,0,58,0,-58
25136,1,1,688,1715,1027
25137,1,0,18,0,-18
25138,1,0,10,0,-10
25139,1,1,269,1307,1038
25140,0,0,164,0,-164
25141,0,0,26,0,-26
25142,0,0,49,0,-49
25143,1,1,579,1315,736
25144,1,1,987,1439,452
25145,1,0,38,0,-38
25146,1,1,528,1535,1007
25147,1,1,1319,1417,98
25148,0,0,47,0,-47
25149,0,0,70,0,-70
25150,1,1,250,1396,1146
25151,0,0,48,0,-48
25152,0,0,39,0,-39
25153,0,0,2,0,-2
25154,0,0,117,0,-117
25155,0,0,32,0,-32
25156,0,0,75,0,-75
25157,1,1,926,1542,616
25158,0,0,13,0,-13
25159,0,0,66,0,-66
25160,1,1,734,1363,629
25161,0,0,154,0,-154
25162,0,0,59,0,-59
25163,0,0,43,0,-43
25164,0,0,5,0,-5
25165,0,0,46,0,-46
25166,1,1,124,1393,1269
25167,1,1,133,1281,1148
25168,0,0,91,0,-91
25169,1,1,283,1212,929
25170,1,1,1322,1296,-26
25171,1,0,64,0,-64
25172,1,0,55,0,-55
25173,0,0,35,0,-35
25174,1,0,12,0,-12
25175,1,1,240,1332,1092
25176,1,0,30,0,-30
25177,1,0,81,0,-81
25178,1,0,34,0,-34
25179,0,0,71,0,-71
25180,1,0,14,0,-14
25181,1,1,75,1261,1186
25182,1,0,37,0,-37
25183,0,0,16,0,-16
25184,1,0,1,0,-1
25185,0,0,24,0,-24
25186,0,0,113,0,-113
25187,0,0,35,0,-35
25188,1,1,83,1606,1523
25189,0,0,106,0,-106
25190,1,1,625,1718,1093
25191,0,0,8,0,-8
25192,1,1,528,1369,841
25193,1,1,181,1955,1774
25194,1,0,15,0,-15
25195,0,0,39,0,-39
25196,1,0,46,0,-46
25197,1,1,51,1375,1324
25198,0,0,129,0,-129
25199,1,0,69,0,-69
25200,1,0,26,0,-26
25201,1,0,34,0,-34
25202,0,0,61,0,-61
25203,1,0,34,0,-34
25204,1,1,1046,1384,338
25205,1,1,506,1352,846
25206,0,0,283,0,-283
25207,1,0,182,0,-182
25208,0,0,59,0,-59
25209,1,1,37,2102,2065
25210,1,0,3,0,-3
25211,0,0,23,0,-23
25212,1,1,387,1703,1316
25213,1,1,177,2727,2550
25214,1,0,15,0,-15
25215,0,0,7,0,-7
25216,0,0,35,0,-35
25217,0,0,22,0,-22
25218,1,1,331,1295,964
25219,1,0,27,0,-27
25220,0,0,8,0,-8
25221,1,1,63,1795,1732
25222,0,0,182,0,-182
25223,1,1,151,1216,1065
25224,1,0,21,0,-21
25225,0,0,25,0,-25
25226,0,0,4,0,-4
25227,1,0,76,0,-76
25228,1,0,195,0,-195
25229,0,0,7,0,-7
25230,0,0,201,0,-201
25231,1,0,5,0,-5
25232,0,0,7,0,-7
25233,1,0,153,0,-153
25234,1,1,1356,1267,-89
25235,1,1,469,1481,1012
25236,1,1,1114,1692,578
25237,0,0,125,0,-125
25238,1,0,23,0,-23
25239,1,1,349,1732,1383
25240,0,0,32,0,-32
25241,1,0,119,0,-119
25242,0,0,26,0,-26
25243,1,0,64,0,-64
25244,1,1,727,1233,506
25245,0,0,25,0,-25
25246,1,0,19,0,-19
25247,1,0,72,0,-72
25248,1,0,7,0,-7
25249,1,1,185,2343,2158
25250,0,0,45,0,-45
25251,0,0,16,0,-16
25252,1,0,30,0,-30
25253,1,1,264,2212,1948
25254,0,0,4,0,-4
25255,1,0,54,0,-54
25256,1,1,83,1521,1438
25257,0,0,29,0,-29
25258,0,0,0,0,0
25259,0,0,54,0,-54
25260,0,0,33,0,-33
25261,0,0,74,0,-74
25262,1,0,8,0,-8
25263,0,0,241,0,-241
25264,0,0,28,0,-28
25265,0,0,0,0,0
25266,1,0,0,0,0
25267,0,0,6,0,-6
25268,1,0,16,0,-16
25269,1,0,61,0,-61
25270,1,1,333,1414,1081
25271,0,0,1,0,-1
25272,0,0,23,0,-23
25273,1,1,106,1611,1505
25274,1,0,20,0,-20
25275,0,0,41,0,-41
25276,1,1,86,1497,1411
25277,1,1,6,1265,1259
25278,0,0,13,0,-13
25279,0,0,35,0,-35
25280,0,0,10,0,-10
25281,0,0,13,0,-13
25282,1,0,37,0,-37
25283,1,0,4,0,-4
25284,1,1,370,1355,985
25285,0,0,1,0,-1
25286,1,0,100,0,-100
25287,0,0,73,0,-73
25288,0,0,3,0,-3
25289,0,0,34,0,-34
25290,0,0,29,0,-29
25291,1,1,161,1314,1153
25292,0,0,5,0,-5
25293,1,0,46,0,-46
25294,1,1,1505,1343,-162
25295,1,0,84,0,-84
25296,1,1,286,1568,1282
25297,0,0,37,0,-37
25298,1,0,16,0,-16
25299,1,0,2,0,-2
25300,0,0,48,0,-48
25301,0,0,33,0,-33
25302,0,0,14,0,-14
25303,0,0,53,0,-53
25304,1,1,148,1602,1454
25305,0,0,113,0,-113
25306,1,1,303,1262,959
25307,0,0,82,0,-82
25308,0,0,52,0,-52
25309,1,1,31,1473,1442
25310,0,0,7,0,-7
25311,0,0,59,0,-59
25312,0,0,10,0,-10
25313,1,0,1,0,-1
25314,1,1,388,1201,813
25315,1,0,44,0,-44
25316,0,0,108,0,-108
25317,1,0,43,0,-43
25318,1,0,56,0,-56
25319,1,0,5,0,-5
25320,1,0,18,0,-18
25321,0,0,65,0,-65
25322,1,0,29,0,-29
25323,0,0,39,0,-39
25324,1,1,697,1476,779
25325,1,1,119,1731,1612
25326,1,0,6,0,-6
25327,0,0,8,0,-8
25328,1,0,6,0,-6
25329,0,0,7,0,-7
25330,1,1,80,1617,1537
25331,1,0,32,0,-32
25332,0,0,31,0,-31
25333,0,0,0,0,0
25334,1,0,52,0,-52
25335,1,1,89,1820,1731
25336,1,0,7,0,-7
25337,0,0,151,0,-151
25338,1,1,939,2016,1077
25339,1,1,742,1496,754
25340,0,0,4,0,-4
25341,1,0,10,0,-10
25342,0,0,49,0,-49
25343,1,0,36,0,-36
25344,1,0,16,0,-16
25345,1,1,1356,1204,-152
25346,0,0,36,0,-36
25347,1,1,16,1572,1556
25348,1,1,225,1211,986
25349,1,1,484,1244,760
25350,0,0,18,0,-18
25351,1,1,414,1371,957
25352,1,0,19,0,-19
25353,1,1,1155,1242,87
25354,0,0,6,0,-6
25355,0,0,42,0,-42
25356,0,0,115,0,-115
25357,1,1,279,1348,1069
25358,1,0,0,0,0
25359,0,0,42,0,-42
25360,1,1,1663,1374,-289
25361,1,1,408,1235,827
25362,0,0,71,0,-71
25363,1,1,238,1698,1460
25364,0,0,88,0,-88
25365,1,1,556,1637,1081
25366,1,0,36,0,-36
25367,1,1,173,1415,1242
25368,0,0,17,0,-17
25369,1,1,316,1977,1661
25370,1,1,295,1654,1359
25371,0,0,64,0,-64
25372,1,0,53,0,-53
25373,1,0,172,0,-172
25374,1,1,908,1678,770
25375,0,0,198,0,-198
25376,1,0,268,0,-268
25377,0,0,96,0,-96
25378,1,1,1225,1499,274
25379,1,1,100,1371,1271
25380,0,0,63,0,-63
25381,0,0,57,0,-57
25382,1,1,404,1307,903
25383,1,0,9,0,-9
25384,0,0,17,0,-17
25385,0,0,205,0,-205
25386,1,1,558,1939,1381
25387,1,0,116,0,-116
25388,1,1,168,1588,1420
25389,1,0,25,0,-25
25390,0,0,31,0,-31
25391,1,1,17,1328,1311
25392,1,0,31,0,-31
25393,0,0,1,0,-1
25394,1,1,275,1543,1268
25395,0,0,75,0,-75
25396,0,0,8,0,-8
25397,0,0,36,0,-36
25398,0,0,95,0,-95
25399,1,1,569,2128,1559
25400,0,0,1,0,-1
25401,0,0,1,0,-1
25402,1,0,4,0,-4
25403,0,0,41,0,-41
25404,0,0,45,0,-45
25405,1,1,596,1318,722
25406,0,0,63,0,-63
25407,0,0,110,0,-110
25408,1,0,35,0,-35
25409,1,0,32,0,-32
25410,0,0,64,0,-64
25411,0,0,136,0,-136
25412,1,1,492,1258,766
25413,1,1,594,1312,718
25414,0,0,5,0,-5
25415,0,0,70,0,-70
25416,1,0,44,0,-44
25417,1,1,833,2347,1514
25418,1,0,37,0,-37
25419,0,0,7,0,-7
25420,0,0,8,0,-8
25421,1,0,44,0,-44
25422,1,1,388,1367,979
25423,0,0,22,0,-22
25424,0,0,70,0,-70
25425,0,0,19,0,-19
25426,0,0,3,0,-3
25427,0,0,113,0,-113
25428,1,1,516,1416,900
25429,0,0,2,0,-2
25430,0,0,111,0,-111
25431,0,0,8,0,-8
25432,1,0,42,0,-42
25433,0,0,2,0,-2
25434,1,1,707,1213,506
25435,1,0,106,0,-106
25436,0,0,50,0,-50
25437,1,1,1781,1327,-454
25438,1,1,370,1303,933
25439,0,0,7,0,-7
25440,1,0,51,0,-51
25441,0,0,22,0,-22
25442,1,1,868,2842,1974
25443,1,0,56,0,-56
25444,1,1,157,1454,1297
25445,1,0,17,0,-17
25446,0,0,22,0,-22
25447,1,1,200,1303,1103
25448,0,0,95,0,-95
25449,1,0,4,0,-4
25450,1,0,18,0,-18
25451,1,0,80,0,-80
25452,0,0,52,0,-52
25453,0,0,49,0,-49
25454,1,0,5,0,-5
25455,0,0,7,0,-7
25456,1,1,437,1649,1212
25457,0,0,11,0,-11
25458,0,0,79,0,-79
25459,1,1,1011,1452,441
25460,1,0,1,0,-1
25461,1,1,258,1232,974
25462,0,0,37,0,-37
25463,1,1,3033,1625,-1408
25464,1,1,1095,1225,130
25465,0,0,22,0,-22
25466,0,0,14,0,-14
25467,1,0,7,0,-7
25468,1,1,865,1573,708
25469,1,1,589,1414,825
25470,1,1,259,1266,1007
25471,1,0,116,0,-116
25472,0,0,31,0,-31
25473,0,0,26,0,-26
25474,0,0,56,0,-56
25475,0,0,30,0,-30
25476,1,1,148,1317,1169
25477,1,0,14,0,-14
25478,1,1,49,1260,1211
25479,1,1,578,1232,654
25480,0,0,7,0,-7
25481,1,1,1706,1217,-489
25482,1,0,12,0,-12
25483,1,0,94,0,-94
25484,1,0,32,0,-32
25485,1,0,133,0,-133
25486,1,1,184,1231,1047
25487,0,0,65,0,-65
25488,1,1,33,1269,1236
25489,1,1,1815,1325,-490
25490,1,0,12,0,-12
25491,0,0,32,0,-32
25492,1,0,62,0,-62
25493,1,1,965,1263,298
25494,1,1,349,1227,878
25495,1,1,316,1538,1222
25496,0,0,134,0,-134
25497,1,1,564,1321,757
25498,0,0,50,0,-50
25499,0,0,12,0,-12
25500,0,0,16,0,-16
25501,1,1,47,1910,1863
25502,1,0,6,0,-6
25503,0,0,85,0,-85
25504,1,0,29,0,-29
25505,1,0,7,0,-7
25506,1,0,188,0,-188
25507,0,0,75,0,-75
25508,1,0,22,0,-22
25509,1,0,19,0,-19
25510,1,1,354,1455,1101
25511,0,0,85,0,-85
25512,0,0,11,0,-11
25513,0,0,76,0,-76
25514,1,0,48,0,-48
25515,0,0,4,0,-4
25516,0,0,13,0,-13
25517,0,0,72,0,-72
25518,0,0,29,0,-29
25519,1,1,211,1201,990
25520,0,0,50,0,-50
25521,1,1,346,1240,894
25522,0,0,16,0,-16
25523,1,1,299,1712,1413
25524,0,0,81,0,-81
25525,1,1,615,2288,1673
25526,1,0,5,0,-5
25527,1,0,99,0,-99
25528,1,1,45,1641,1596
25529,1,0,66,0,-66
25530,1,0,7,0,-7
25531,1,0,76,0,-76
25532,1,1,446,2188,1742
25533,1,1,242,2248,2006
25534,0,0,20,0,-20
25535,0,0,69,0,-69
25536,0,0,14,0,-14
25537,1,0,271,0,-271
25538,1,1,385,1214,829
25539,0,0,1,0,-1
25540,1,1,309,1218,909
25541,0,0,51,0,-51
25542,0,0,22,0,-22
25543,0,0,7,0,-7
25544,0,0,26,0,-26
25545,1,0,31,0,-31
25546,0,0,80,0,-80
25547,1,1,609,1568,959
25548,1,0,24,0,-24
25549,1,0,46,0,-46
25550,1,1,959,1259,300
25551,1,0,24,0,-24
25552,0,0,25,0,-25
25553,0,0,17,0,-17
25554,1,0,84,0,-84
25555,0,0,35,0,-35
25556,0,0,9,0,-9
25557,1,1,256,1663,1407
25558,0,0,23,0,-23
25559,0,0,5,0,-5
25560,0,0,17,0,-17
25561,0,0,52,0,-52
25562,0,0,66,0,-66
25563,1,0,4,0,-4
25564,0,0,19,0,-19
25565,1,1,210,1882,1672
25566,0,0,71,0,-71
25567,0,0,6,0,-6
25568,0,0,47,0,-47
25569,0,0,222,0,-222
25570,1,1,494,1213,719
25571,1,1,158,1317,1159
25572,1,1,608,1348,740
25573,1,1,233,1270,1037
25574,1,1,381,2399,2018
25575,0,0,51,0,-51
25576,0,0,8,0,-8
25577,0,0,11,0,-11
25578,0,0,23,0,-23
25579,0,0,75,0,-75
25580,1,1,176,1372,1196
25581,0,0,26,0,-26
25582,0,0,59,0,-59
25583,1,1,336,1617,1281
25584,1,0,78,0,-78
25585,1,0,27,0,-27
25586,1,0,109,0,-109
25587,1,1,238,1387,1149
25588,1,1,287,1325,1038
25589,1,0,64,0,-64
25590,0,0,46,0,-46
25591,0,0,3,0,-3
25592,1,1,511,1328,817
25593,1,0,50,0,-50
25594,0,0,41,0,-41
25595,0,0,122,0,-122
25596,1,1,1430,1730,300
25597,0,0,120,0,-120
25598,0,0,82,0,-82
25599,1,0,205,0,-205
25600,0,0,1,0,-1
25601,1,0,38,0,-38
25602,1,1,305,1347,1042
25603,1,0,107,0,-107
25604,1,0,18,0,-18
25605,0,0,18,0,-18
25606,0,0,5,0,-5
25607,1,0,17,0,-17
25608,0,0,71,0,-71
25609,0,0,8,0,-8
25610,1,1,935,1515,580
25611,0,0,137,0,-137
25612,1,0,118,0,-118
25613,1,1,457,1265,808
25614,0,0,47,0,-47
25615,0,0,20,0,-20
25616,1,1,1691,1966,275
25617,0,0,2,0,-2
25618,1,0,28,0,-28
25619,0,0,38,0,-38
25620,0,0,43,0,-43
25621,1,0,62,0,-62
25622,0,0,61,0,-61
25623,0,0,52,0,-52
25624,1,0,19,0,-19
25625,1,0,81,0,-81
25626,0,0,33,0,-33
25627,1,1,131,1394,1263
25628,1,0,17,0,-17
25629,1,1,809,2420,1611
25630,1,1,122,1531,1409
25631,0,0,194,0,-194
25632,1,0,7,0,-7
25633,1,0,6,0,-6
25634,1,0,50,0,-50
25635,1,1,354,1468,1114
25636,1,0,154,0,-154
25637,0,0,12,0,-12
25638,1,0,51,0,-51
25639,1,0,14,0,-14
25640,1,0,19,0,-19
25641,0,0,235,0,-235
25642,1,1,247,1537,1290
25643,1,1,277,1769,1492
25644,1,0,107,0,-107
25645,0,0,43,0,-43
25646,1,0,38,0,-38
25647,1,1,569,1328,759
25648,0,0,42,0,-42
25649,1,1,1371,1681,310
25650,1,0,7,0,-7
25651,0,0,18,0,-18
25652,0,0,21,0,-21
25653,1,1,369,1231,862
25654,1,1,479,1725,1246
25655,1,0,31,0,-31
25656,0,0,19,0,-19
25657,0,0,20,0,-20
25658,1,1,848,2082,1234
25659,1,1,6,1276,1270
25660,0,0,17,0,-17
25661,1,0,15,0,-15
25662,1,1,359,1320,961
25663,1,1,341,1233,892
25664,1,1,493,1491,998
25665,1,1,1085,1645,560
25666,1,1,772,1972,1200
25667,0,0,10,0,-10
25668,0,0,73,0,-73
25669,1,0,55,0,-55
25670,1,1,997,1602,605
25671,0,0,157,0,-157
25672,1,0,109,0,-109
25673,1,1,169,1285,1116
25674,1,1,288,1385,1097
25675,0,0,64,0,-64
25676,1,0,44,0,-44
25677,0,0,10,0,-10
25678,1,1,302,1541,1239
25679,0,0,19,0,-19
25680,1,0,139,0,-139
25681,0,0,72,0,-72
25682,1,0,12,0,-12
25683,1,1,166,1651,1485
25684,1,1,190,1369,1179
25685,0,0,112,0,-112
25686,1,0,27,0,-27
25687,0,0,3,0,-3
25688,1,0,0,0,0
25689,1,1,306,1487,1181
25690,1,1,312,1301,989
25691,0,0,13,0,-13
25692,1,1,320,1371,1051
25693,0,0,92,0,-92
25694,1,0,4,0,-4
25695,0,0,15,0,-15
25696,1,1,523,1496,973
25697,1,0,4,0,-4
25698,1,1,156,1610,1454
25699,1,1,189,1265,1076
25700,0,0,6,0,-6
25701,1,0,96,0,-96
25702,1,0,10,0,-10
25703,1,1,647,1717,1070
25704,1,0,41,0,-41
25705,1,1,110,1202,1092
25706,0,0,34,0,-34
25707,0,0,18,0,-18
25708,1,0,32,0,-32
25709,0,0,24,0,-24
25710,0,0,89,0,-89
25711,1,0,14,0,-14
25712,0,0,12,0,-12
25713,0,0,16,0,-16
25714,1,0,17,0,-17
25715,0,0,23,0,-23
25716,1,0,95,0,-95
25717,1,1,761,1303,542
25718,1,1,160,1233,1073
25719,0,0,29,0,-29
25720,0,0,86,0,-86
25721,1,1,104,1205,1101
25722,1,1,631,1231,600
25723,1,0,36,0,-36
25724,0,0,28,0,-28
25725,0,0,84,0,-84
25726,0,0,5,0,-5
25727,1,1,826,2292,1466
25728,1,0,12,0,-12
25729,1,1,353,1271,918
25730,1,1,102,1320,1218
25731,0,0,91,0,-91
25732,1,0,17,0,-17
25733,1,0,36,0,-36
25734,1,0,3,0,-3
25735,1,0,21,0,-21
25736,1,1,531,1219,688
25737,0,0,20,0,-20
25738,0,0,8,0,-8
25739,1,1,226,1254,1028
25740,1,1,130,2376,2246
25741,0,0,42,0,-42
25742,1,1,411,1263,852
25743,1,0,21,0,-21
25744,0,0,8,0,-8
25745,1,0,4,0,-4
25746,0,0,31,0,-31
25747,0,0,33,0,-33
25748,1,0,78,0,-78
25749,1,0,25,0,-25
25750,1,0,145,0,-145
25751,1,0,57,0,-57
25752,0,0,7,0,-7
25753,1,0,46,0,-46
25754,1,0,206,0,-206
25755,0,0,72,0,-72
25756,0,0,40,0,-40
25757,1,1,124,1804,1680
25758,1,0,16,0,-16
25759,1,1,128,2398,2270
25760,1,0,40,0,-40
25761,1,0,118,0,-118
25762,1,1,636,2442,1806
25763,1,1,175,1251,1076
25764,1,1,571,2317,1746
25765,1,0,140,0,-140
25766,1,1,86,1210,1124
25767,1,1,576,1291,715
25768,0,0,2,0,-2
25769,1,0,0,0,0
25770,0,0,89,0,-89
25771,1,0,55,0,-55
25772,0,0,34,0,-34
25773,0,0,14,0,-14
25774,0,0,134,0,-134
25775,1,1,619,1292,673
25776,1,1,1246,1435,189
25777,1,0,87,0,-87
25778,1,1,888,1203,315
25779,0,0,31,0,-31
25780,0,0,111,0,-111
25781,1,1,255,1374,1119
25782,0,0,1,0,-1
25783,0,0,166,0,-166
25784,1,1,584,1427,843
25785,1,0,191,0,-191
25786,0,0,47,0,-47
25787,1,1,246,1401,1155
25788,0,0,89,0,-89
25789,1,0,37,0,-37
25790,0,0,29,0,-29
25791,1,0,13,0,-13
25792,1,0,54,0,-54
25793,1,0,56,0,-56
25794,1,1,112,1478,1366
25795,0,0,43,0,-43
25796,1,0,224,0,-224
25797,1,0,11,0,-11
25798,0,0,44,0,-44
25799,0,0,7,0,-7
25800,1,0,6,0,-6
25801,1,1,180,1281,1101
25802,1,1,617,1324,707
25803,1,0,3,0,-3
25804,0,0,50,0,-50
25805,0,0,28,0,-28
25806,1,0,13,0,-13
25807,1,1,106,1559,1453
25808,1,1,289,1499,1210
25809,0,0,33,0,-33
25810,1,1,43,1537,1494
25811,1,1,39,1608,1569
25812,0,0,1,0,-1
25813,1,1,226,2855,2629
25814,1,0,56,0,-56
25815,1,0,32,0,-32
25816,0,0,10,0,-10
25817,1,0,31,0,-31
25818,1,1,246,2369,2123
25819,0,0,21,0,-21
25820,1,0,30,0,-30
25821,1,0,13,0,-13
25822,1,0,17,0,-17
25823,1,0,16,0,-16
25824,1,1,2090,1211,-879
25825,1,0,127,0,-127
25826,0,0,73,0,-73
25827,1,0,14,0,-14
25828,0,0,106,0,-106
25829,1,0,37,0,-37
25830,1,1,67,1957,1890
25831,0,0,13,0,-13
25832,1,1,40,1208,1168
25833,0,0,28,0,-28
25834,0,0,30,0,-30
25835,1,1,173,1234,1061
25836,0,0,28,0,-28
25837,1,0,54,0,-54
25838,1,0,77,0,-77
25839,0,0,108,0,-108
25840,1,0,1,0,-1
25841,1,0,0,0,0
25842,1,0,13,0,-13
25843,0,0,11,0,-11
25844,0,0,80,0,-80
25845,0,0,65,0,-65
25846,1,0,4,0,-4
25847,1,1,1479,1326,-153
25848,1,0,13,0,-13
25849,0,0,52,0,-52
25850,1,1,684,1560,876
25851,1,1,25,1713,1688
25852,1,1,314,1481,1167
25853,0,0,1,0,-1
25854,1,0,0,0,0
25855,0,0,135,0,-135
25856,1,0,27,0,-27
25857,1,0,8,0,-8
25858,1,1,2475,2077,-398
25859,0,0,15,0,-15
25860,1,1,1304,1553,249
25861,1,1,792,1244,452
25862,1,1,245,1202,957
25863,0,0,8,0,-8
25864,0,0,3,0,-3
25865,1,0,51,0,-51
25866,1,0,53,0,-53
25867,1,1,97,1361,1264
25868,1,1,124,1494,1370
25869,1,0,24,0,-24
25870,1,0,34,0,-34
25871,1,1,169,2884,2715
25872,0,0,87,0,-87
25873,1,0,15,0,-15
25874,0,0,30,0,-30
25875,1,1,216,1451,1235
25876,1,0,196,0,-196
25877,0,0,10,0,-10
25878,0,0,101,0,-101
25879,1,0,32,0,-32
25880,1,0,28,0,-28
25881,1,0,2,0,-2
25882,0,0,47,0,-47
25883,0,0,1,0,-1
25884,1,1,111,1529,1418
25885,1,1,782,1241,459
25886,0,0,14,0,-14
25887,1,0,35,0,-35
25888,1,1,355,1412,1057
25889,0,0,33,0,-33
25890,1,0,16,0,-16
25891,0,0,19,0,-19
25892,0,0,66,0,-66
25893,0,0,58,0,-58
25894,1,1,341,1269,928
25895,1,0,256,0,-256
25896,1,1,369,1928,1559
25897,0,0,56,0,-56
25898,0,0,43,0,-43
25899,0,0,23,0,-23
25900,0,0,17,0,-17
25901,1,0,154,0,-154
25902,0,0,4,0,-4
25903,1,1,679,1241,562
25904,1,0,16,0,-16
25905,1,1,257,1240,983
25906,1,0,16,0,-16
25907,1,0,17,0,-17
25908,1,1,530,1416,886
25909,0,0,11,0,-11
25910,0,0,50,0,-50
25911,0,0,35,0,-35
25912,1,1,229,1456,1227
25913,1,1,88,1218,1130
25914,0,0,0,0,0
25915,1,1,11,1474,1463
25916,0,0,30,0,-30
25917,1,0,72,0,-72
25918,1,0,3,0,-3
25919,1,1,506,2053,1547
25920,0,0,54,0,-54
25921,1,1,211,1218,1007
25922,1,0,27,0,-27
25923,0,0,4,0,-4
25924,1,1,85,1604,1519
25925,0,0,17,0,-17
25926,0,0,61,0,-61
25927,1,1,814,3033,2219
25928,1,0,45,0,-45
25929,0,0,68,0,-68
25930,0,0,27,0,-27
25931,1,1,402,1239,837
25932,0,0,15,0,-15
25933,0,0,14,0,-14
25934,1,0,29,0,-29
25935,1,1,3258,1484,-1774
25936,1,0,153,0,-153
25937,0,0,70,0,-70
25938,0,0,51,0,-51
25939,1,0,0,0,0
25940,1,1,2114,1216,-898
25941,1,0,50,0,-50
25942,1,1,820,1673,853
25943,0,0,49,0,-49
25944,0,0,3,0,-3
25945,1,0,7,0,-7
25946,1,1,613,1220,607
25947,1,0,8,0,-8
25948,1,0,7,0,-7
25949,1,1,452,1360,908
25950,1,1,529,1737,1208
25951,1,0,39,0,-39
25952,0,0,0,0,0
25953,0,0,135,0,-135
25954,1,0,38,0,-38
25955,1,1,1046,1340,294
25956,1,1,83,2838,2755
25957,0,0,32,0,-32
25958,0,0,1,0,-1
25959,1,1,71,2509,2438
25960,0,0,85,0,-85
25961,1,0,76,0,-76
25962,1,1,575,1620,1045
25963,1,0,39,0,-39
25964,1,0,54,0,-54
25965,1,0,48,0,-48
25966,1,1,341,1387,1046
25967,1,0,16,0,-16
25968,1,1,524,1575,1051
25969,0,0,16,0,-16
25970,0,0,35,0,-35
25971,0,0,8,0,-8
25972,0,0,73,0,-73
25973,0,0,8,0,-8
25974,1,1,170,1469,1299
25975,0,0,18,0,-18
25976,1,0,32,0,-32
25977,1,1,1048,1343,295
25978,0,0,53,0,-53
25979,1,0,17,0,-17
25980,1,0,76,0,-76
25981,1,1,1332,2063,731
25982,0,0,74,0,-74
25983,1,0,76,0,-76
25984,0,0,52,0,-52
25985,1,1,141,1209,1068
25986,0,0,8,0,-8
25987,1,1,140,1254,1114
25988,1,0,2,0,-2
25989,0,0,139,0,-139
25990,1,1,1254,2088,834
25991,0,0,23,0,-23
25992,0,0,97,0,-97
25993,1,0,55,0,-55
25994,0,0,81,0,-81
25995,1,0,25,0,-25
25996,1,1,155,3213,3058
25997,1,0,78,0,-78
25998,0,0,49,0,-49
25999,1,1,890,1603,713
26000,1,1,449,1295,846
26001,0,0,13,0,-13
26002,1,0,169,0,-169
26003,1,1,421,1218,797
26004,0,0,10,0,-10
26005,0,0,17,0,-17
26006,1,0,64,0,-64
26007,1,1,409,1599,1190
26008,0,0,75,0,-75
26009,0,0,5,0,-5
26010,1,1,601,1372,771
26011,0,0,15,0,-15
26012,0,0,20,0,-20
26013,1,1,184,1595,1411
26014,1,0,6,0,-6
26015,1,0,28,0,-28
26016,0,0,51,0,-51
26017,0,0,26,0,-26
26018,1,0,35,0,-35
26019,0,0,84,0,-84
26020,0,0,99,0,-99
26021,1,0,27,0,-27
26022,1,1,362,1259,897
26023,1,0,10,0,-10
26024,1,0,39,0,-39
26025,0,0,1,0,-1
26026,1,0,6,0,-6
26027,1,1,802,1341,539
26028,0,0,54,0,-54
26029,0,0,58,0,-58
26030,0,0,5,0,-5
26031,1,1,275,1529,1254
26032,1,1,426,1747,1321
26033,0,0,140,0,-140
26034,0,0,21,0,-21
26035,0,0,67,0,-67
26036,1,1,780,2094,1314
26037,0,0,42,0,-42
26038,0,0,117,0,-117
26039,1,0,418,0,-418
26040,0,0,4,0,-4
26041,1,0,7,0,-7
26042,1,0,103,0,-103
26043,1,0,153,0,-153
26044,1,1,1165,1715,550
26045,0,0,3,0,-3
26046,1,0,95,0,-95
26047,0,0,71,0,-71
26048,1,1,861,1398,537
26049,0,0,55,0,-55
26050,0,0,22,0,-22
26051,0,0,113,0,-113
26052,1,1,407,1312,905
26053,0,0,21,0,-21
26054,1,0,85,0,-85
26055,1,1,637,1301,664
26056,1,0,1,0,-1
26057,0,0,52,0,-52
26058,1,1,382,1325,943
26059,1,1,143,1325,1182
26060,1,0,11,0,-11
26061,1,1,168,2190,2022
26062,0,0,0,0,0
26063,1,1,1562,1419,-143
26064,1,1,120,3537,3417
26065,0,0,13,0,-13
26066,1,0,27,0,-27
26067,1,1,71,1286,1215
26068,1,1,927,1381,454
26069,0,0,87,0,-87
26070,0,0,124,0,-124
26071,1,0,24,0,-24
26072,1,1,336,1457,1121
26073,1,1,163,1491,1328
26074,0,0,17,0,-17
26075,1,0,116,0,-116
26076,0,0,48,0,-48
26077,1,0,19,0,-19
26078,1,1,146,2578,2432
26079,1,0,27,0,-27
26080,1,1,819,1353,534
26081,1,0,76,0,-76
26082,1,1,185,2624,2439
26083,1,0,4,0,-4
26084,1,1,277,1238,961
26085,1,1,1512,1492,-20
26086,1,0,55,0,-55
26087,1,0,0,0,0
26088,1,0,28,0,-28
26089,1,1,80,2456,2376
26090,0,0,9,0,-9
26091,0,0,29,0,-29
26092,1,1,351,2025,1674
26093,0,0,323,0,-323
26094,1,1,179,1338,1159
26095,1,0,191,0,-191
26096,0,0,21,0,-21
26097,0,0,6,0,-6
26098,0,0,40,0,-40
26099,1,0,174,0,-174
26100,0,0,41,0,-41
26101,1,1,788,1463,675
26102,1,1,273,1243,970
26103,0,0,135,0,-135
26104,0,0,36,0,-36
26105,1,1,448,1297,849
26106,1,0,51,0,-51
26107,0,0,153,0,-153
26108,1,0,148,0,-148
26109,1,0,240,0,-240
26110,1,0,17,0,-17
26111,1,0,36,0,-36
26112,0,0,8,0,-8
26113,1,0,92,0,-92
26114,1,0,186,0,-186
26115,1,1,193,2695,2502
26116,1,0,44,0,-44
26117,0,0,45,0,-45
26118,0,0,70,0,-70
26119,1,0,40,0,-40
26120,0,0,16,0,-16
26121,0,0,138,0,-138
26122,1,0,38,0,-38
26123,0,0,28,0,-28
26124,1,1,48,1444,1396
26125,1,1,484,1587,1103
26126,0,0,11,0,-11
26127,0,0,66,0,-66
26128,1,1,362,1535,1173
26129,0,0,41,0,-41
26130,1,1,763,1659,896
26131,0,0,0,0,0
26132,1,0,13,0,-13
26133,1,1,156,2319,2163
26134,0,0,42,0,-42
26135,1,1,368,1391,1023
26136,1,1,197,1467,1270
26137,0,0,102,0,-102
26138,1,1,91,1223,1132
26139,0,0,20,0,-20
26140,1,1,117,1211,1094
26141,0,0,20,0,-20
26142,1,1,277,2552,2275
26143,0,0,11,0,-11
26144,1,1,154,3337,3183
26145,1,1,132,1772,1640
26146,1,1,493,1456,963
26147,1,1,60,1245,1185
26148,1,0,140,0,-140
26149,1,1,294,1438,1144
26150,0,0,8,0,-8
26151,0,0,10,0,-10
26152,1,1,151,1428,1277
26153,1,1,1130,1200,70
26154,0,0,56,0,-56
26155,1,0,3,0,-3
26156,1,1,434,1209,775
26157,0,0,23,0,-23
26158,1,0,33,0,-33
26159,1,1,701,2068,1367
26160,1,1,295,2046,1751
26161,1,1,1689,1267,-422
26162,0,0,72,0,-72
26163,1,0,2,0,-2
26164,0,0,44,0,-44
26165,1,1,319,1316,997
26166,1,0,42,0,-42
26167,0,0,64,0,-64
26168,0,0,151,0,-151
26169,0,0,5,0,-5
26170,1,0,11,0,-11
26171,1,0,77,0,-77
26172,1,0,276,0,-276
26173,1,1,232,1563,1331
26174,1,0,135,0,-135
26175,1,1,97,1746,1649
26176,1,1,478,2019,1541
26177,0,0,18,0,-18
26178,1,1,284,1640,1356
26179,1,0,36,0,-36
26180,0,0,155,0,-155
26181,0,0,22,0,-22
26182,0,0,98,0,-98
26183,1,0,87,0,-87
26184,0,0,5,0,-5
26185,1,1,1126,1492,366
26186,1,1,55,3363,3308
26187,1,0,50,0,-50
26188,1,1,1177,2202,1025
26189,0,0,46,0,-46
26190,1,0,1,0,-1
26191,0,0,4,0,-4
26192,0,0,61,0,-61
26193,0,0,107,0,-107
26194,1,0,52,0,-52
26195,1,0,35,0,-35
26196,1,1,129,1224,1095
26197,0,0,64,0,-64
26198,0,0,151,0,-151
26199,0,0,4,0,-4
26200,0,0,22,0,-22
26201,0,0,39,0,-39
26202,0,0,38,0,-38
26203,0,0,65,0,-65
26204,1,1,1044,1749,705
26205,1,1,868,1315,447
26206,1,0,95,0,-95
26207,1,1,562,1323,761
26208,1,0,24,0,-24
26209,0,0,35,0,-35
26210,0,0,27,0,-27
26211,0,0,178,0,-178
26212,1,1,801,1612,811
26213,1,0,68,0,-68
26214,1,0,126,0,-126
26215,1,1,199,1440,1241
26216,1,1,214,1722,1508
26217,0,0,40,0,-40
26218,1,1,386,1276,890
26219,0,0,52,0,-52
26220,0,0,3,0,-3
26221,0,0,65,0,-65
26222,1,1,283,1581,1298
26223,1,1,283,1345,1062
26224,1,0,19,0,-19
26225,1,1,776,1289,513
26226,0,0,59,0,-59
26227,1,1,662,1754,1092
26228,1,0,86,0,-86
26229,0,0,84,0,-84
26230,1,0,18,0,-18
26231,0,0,85,0,-85
26232,1,0,90,0,-90
26233,1,1,684,1284,600
26234,0,0,94,0,-94
26235,1,1,453,1264,811
26236,1,0,52,0,-52
26237,1,0,105,0,-105
26238,0,0,9,0,-9
26239,1,1,551,1553,1002
26240,1,1,518,2502,1984
26241,0,0,81,0,-81
26242,0,0,10,0,-10
26243,0,0,30,0,-30
26244,1,0,0,0,0
26245,0,0,27,0,-27
26246,0,0,20,0,-20
26247,0,0,9,0,-9
26248,1,1,420,2819,2399
26249,0,0,3,0,-3
26250,1,1,612,1604,992
26251,1,0,65,0,-65
26252,1,1,453,2333,1880
26253,0,0,129,0,-129
26254,1,0,53,0,-53
26255,1,0,4,0,-4
26256,1,1,136,1471,1335
26257,0,0,32,0,-32
26258,0,0,22,0,-22
26259,1,1,1349,8477,7128
26260,1,1,102,1473,1371
26261,1,1,310,1253,943
26262,1,1,194,1210,1016
26263,0,0,74,0,-74
26264,0,0,58,0,-58
26265,1,1,486,1245,759
26266,1,0,11,0,-11
26267,0,0,60,0,-60
26268,0,0,43,0,-43
26269,0,0,7,0,-7
26270,0,0,46,0,-46
26271,1,0,20,0,-20
26272,1,1,181,1217,1036
26273,1,0,4,0,-4
26274,1,0,115,0,-115
26275,1,0,91,0,-91
26276,1,1,214,1282,1068
26277,0,0,0,0,0
26278,1,0,50,0,-50
26279,1,1,2097,1335,-762
26280,1,1,221,1498,1277
26281,1,0,0,0,0
26282,1,0,14,0,-14
26283,1,1,855,1530,675
26284,0,0,2,0,-2
26285,1,1,403,1222,819
26286,1,1,382,1304,922
26287,0,0,17,0,-17
26288,0,0,41,0,-41
26289,1,1,1799,1352,-447
26290,1,0,116,0,-116
26291,1,1,2597,1400,-1197
26292,1,0,126,0,-126
26293,0,0,3,0,-3
26294,1,0,115,0,-115
26295,1,0,22,0,-22
26296,1,0,69,0,-69
26297,0,0,46,0,-46
26298,0,0,14,0,-14
26299,1,0,94,0,-94
26300,1,0,30,0,-30
26301,0,0,20,0,-20
26302,1,0,110,0,-110
26303,1,1,600,1619,1019
26304,0,0,75,0,-75
26305,0,0,12,0,-12
26306,1,1,39,2192,2153
26307,1,0,109,0,-109
26308,0,0,80,0,-80
26309,0,0,176,0,-176
26310,0,0,118,0,-118
26311,0,0,49,0,-49
26312,0,0,42,0,-42
26313,1,1,125,1436,1311
26314,1,1,814,1241,427
26315,1,1,565,1504,939
26316,1,0,6,0,-6
26317,1,1,642,1493,851
26318,1,0,65,0,-65
26319,1,0,27,0,-27
26320,0,0,0,0,0
26321,1,1,183,1958,1775
26322,0,0,42,0,-42
26323,1,0,28,0,-28
26324,1,0,17,0,-17
26325,0,0,53,0,-53
26326,1,1,1545,1323,-222
26327,1,1,1059,1224,165
26328,1,1,175,1567,1392
26329,0,0,2,0,-2
26330,1,1,219,1256,1037
26331,1,0,5,0,-5
26332,1,1,586,1298,712
26333,1,1,266,1787,1521
26334,0,0,69,0,-69
26335,0,0,11,0,-11
26336,1,1,1317,1825,508
26337,1,1,200,1725,1525
26338,0,0,5,0,-5
26339,1,1,118,1971,1853
26340,1,0,93,0,-93
26341,1,0,122,0,-122
26342,1,0,19,0,-19
26343,1,1,189,1375,1186
26344,0,0,119,0,-119
26345,1,1,450,1307,857
26346,1,1,645,2547,1902
26347,0,0,20,0,-20
26348,0,0,16,0,-16
26349,0,0,166,0,-166
26350,1,0,55,0,-55
26351,1,1,886,1243,357
26352,0,0,22,0,-22
26353,1,1,420,1741,1321
26354,1,0,11,0,-11
26355,1,1,915,1255,340
26356,1,1,82,1284,1202
26357,0,0,30,0,-30
26358,1,1,1001,1322,321
26359,0,0,11,0,-11
26360,1,1,243,1323,1080
26361,0,0,28,0,-28
26362,0,0,75,0,-75
26363,0,0,13,0,-13
26364,0,0,5,0,-5
26365,1,1,1151,1448,297
26366,1,1,2553,1241,-1312
26367,1,0,1,0,-1
26368,1,1,390,1854,1464
26369,1,0,10,0,-10
26370,0,0,10,0,-10
26371,0,0,89,0,-89
26372,0,0,48,0,-48
26373,0,0,18,0,-18
26374,1,0,6,0,-6
26375,1,1,182,2990,2808
26376,1,1,179,1306,1127
26377,1,0,58,0,-58
26378,0,0,15,0,-15
26379,1,0,139,0,-139
26380,1,1,544,1356,812
26381,0,0,19,0,-19
26382,0,0,148,0,-148
26383,1,0,11,0,-11
26384,0,0,101,0,-101
26385,0,0,27,0,-27
26386,1,1,59,1245,1186
26387,1,1,111,1291,1180
26388,1,0,27,0,-27
26389,1,1,958,1547,589
26390,0,0,16,0,-16
26391,0,0,4,0,-4
26392,1,1,1403,2160,757
26393,0,0,6,0,-6
26394,1,1,227,1567,1340
26395,0,0,28,0,-28
26396,1,0,4,0,-4
26397,0,0,120,0,-120
26398,1,1,142,1470,1328
26399,0,0,0,0,0
26400,0,0,12,0,-12
26401,1,0,22,0,-22
26402,0,0,39,0,-39
26403,0,0,105,0,-105
26404,1,0,5,0,-5
26405,1,0,17,0,-17
26406,0,0,5,0,-5
26407,1,1,619,1241,622
26408,0,0,5,0,-5
26409,1,1,869,1466,597
26410,1,0,13,0,-13
26411,1,0,24,0,-24
26412,1,0,40,0,-40
26413,1,1,673,1308,635
26414,0,0,19,0,-19
26415,1,1,92,1327,1235
26416,0,0,18,0,-18
26417,1,1,27,1873,1846
26418,1,0,102,0,-102
26419,1,0,17,0,-17
26420,0,0,111,0,-111
26421,1,0,102,0,-102
26422,1,1,644,1220,576
26423,0,0,14,0,-14
26424,1,1,1005,1895,890
26425,0,0,96,0,-96
26426,0,0,24,0,-24
26427,1,1,354,1496,1142
26428,1,0,181,0,-181
26429,0,0,169,0,-169
26430,1,1,209,1372,1163
26431,0,0,85,0,-85
26432,0,0,8,0,-8
26433,1,0,55,0,-55
26434,1,1,228,1952,1724
26435,1,1,58,1228,1170
26436,1,0,28,0,-28
26437,1,0,27,0,-27
26438,1,1,975,3142,2167
26439,1,0,31,0,-31
26440,0,0,196,0,-196
26441,1,1,691,1307,616
26442,0,0,100,0,-100
26443,0,0,127,0,-127
26444,1,1,757,1502,745
26445,1,1,225,1237,1012
26446,1,0,148,0,-148
26447,1,0,122,0,-122
26448,1,1,238,1206,968
26449,0,0,4,0,-4
26450,0,0,24,0,-24
26451,1,0,35,0,-35
26452,1,1,238,1322,1084
26453,0,0,47,0,-47
26454,1,1,287,1361,1074
26455,1,0,31,0,-31
26456,1,1,177,2777,2600
26457,0,0,75,0,-75
26458,1,0,3,0,-3
26459,1,0,99,0,-99
26460,0,0,66,0,-66
26461,0,0,82,0,-82
26462,1,1,805,1591,786
26463,1,1,367,1268,901
26464,1,0,5,0,-5
26465,0,0,70,0,-70
26466,1,1,48,1234,1186
26467,0,0,50,0,-50
26468,1,1,2864,1355,-1509
26469,1,1,585,1307,722
26470,1,0,215,0,-215
26471,0,0,68,0,-68
26472,0,0,20,0,-20
26473,0,0,6,0,-6
26474,1,0,0,0,0
26475,1,1,147,1270,1123
26476,1,0,64,0,-64
26477,1,0,35,0,-35
26478,0,0,51,0,-51
26479,1,0,121,0,-121
26480,0,0,4,0,-4
26481,1,1,478,1655,1177
26482,1,0,184,0,-184
26483,0,0,3,0,-3
26484,1,0,28,0,-28
26485,1,1,848,1204,356
26486,1,1,101,3424,3323
26487,1,0,30,0,-30
26488,0,0,94,0,-94
26489,1,1,1249,1746,497
26490,1,0,218,0,-218
26491,1,0,228,0,-228
26492,1,1,24,1202,1178
26493,1,0,5,0,-5
26494,1,0,89,0,-89
26495,1,0,20,0,-20
26496,0,0,93,0,-93
26497,0,0,138,0,-138
26498,0,0,80,0,-80
26499,0,0,72,0,-72
26500,0,0,27,0,-27
26501,0,0,21,0,-21
26502,0,0,55,0,-55
26503,0,0,81,0,-81
26504,1,0,12,0,-12
26505,1,0,6,0,-6
26506,1,0,129,0,-129
26507,0,0,1,0,-1
26508,0,0,70,0,-70
26509,0,0,44,0,-44
26510,0,0,1,0,-1
26511,1,1,873,1588,715
26512,0,0,58,0,-58
26513,1,0,4,0,-4
26514,0,0,2,0,-2
26515,0,0,78,0,-78
26516,0,0,46,0,-46
26517,0,0,9,0,-9
26518,1,1,592,1385,793
26519,0,0,4,0,-4
26520,1,1,728,1453,725
26521,0,0,36,0,-36
26522,1,1,705,1260,555
26523,0,0,2,0,-2
26524,0,0,166,0,-166
26525,0,0,55,0,-55
26526,0,0,61,0,-61
26527,0,0,10,0,-10
26528,1,0,50,0,-50
26529,1,1,450,1800,1350
26530,1,1,153,1349,1196
26531,0,0,119,0,-119
26532,1,0,3,0,-3
26533,0,0,70,0,-70
26534,1,1,433,2465,2032
26535,1,0,30,0,-30
26536,1,1,93,1244,1151
26537,1,0,38,0,-38
26538,1,0,9,0,-9
26539,0,0,216,0,-216
26540,0,0,23,0,-23
26541,1,1,374,1677,1303
26542,0,0,19,0,-19
26543,0,0,106,0,-106
26544,0,0,89,0,-89
26545,0,0,21,0,-21
26546,1,0,76,0,-76
26547,1,0,4,0,-4
26548,0,0,25,0,-25
26549,1,0,40,0,-40
26550,1,0,3,0,-3
26551,1,1,961,1970,1009
26552,1,0,40,0,-40
26553,0,0,18,0,-18
26554,0,0,5,0,-5
26555,0,0,39,0,-39
26556,1,0,30,0,-30
26557,1,0,43,0,-43
26558,0,0,103,0,-103
26559,1,1,165,1200,1035
26560,1,1,573,1358,785
26561,1,0,24,0,-24
26562,1,0,33,0,-33
26563,1,0,37,0,-37
26564,1,1,2058,1454,-604
26565,0,0,26,0,-26
26566,0,0,150,0,-150
26567,1,1,283,1520,1237
26568,1,0,10,0,-10
26569,0,0,56,0,-56
26570,1,0,139,0,-139
26571,1,0,88,0,-88
26572,1,0,0,0,0
26573,1,1,51,2342,2291
26574,1,1,14,1547,1533
26575,1,0,27,0,-27
26576,1,0,101,0,-101
26577,1,0,12,0,-12
26578,0,0,24,0,-24
26579,1,1,1405,1367,-38
26580,1,1,129,3227,3098
26581,0,0,51,0,-51
26582,1,1,527,1292,765
26583,1,0,6,0,-6
26584,1,1,45,1279,1234
26585,0,0,16,0,-16
26586,1,1,910,1218,308
26587,0,0,42,0,-42
26588,0,0,44,0,-44
26589,1,0,14,0,-14
26590,0,0,7,0,-7
26591,0,0,115,0,-115
26592,1,1,49,1520,1471
26593,1,1,50,1427,1377
26594,1,0,5,0,-5
26595,0,0,23,0,-23
26596,0,0,21,0,-21
26597,0,0,15,0,-15
26598,1,0,29,0,-29
26599,1,1,479,1243,764
26600,1,1,264,1859,1595
26601,1,1,49,1209,1160
26602,0,0,1,0,-1
26603,1,0,33,0,-33
26604,0,0,60,0,-60
26605,0,0,290,0,-290
26606,1,0,0,0,0
26607,1,1,249,1497,1248
26608,0,0,103,0,-103
26609,0,0,4,0,-4
26610,1,1,232,1298,1066
26611,1,0,12,0,-12
26612,1,0,0,0,0
26613,0,0,24,0,-24
26614,0,0,92,0,-92
26615,1,1,101,1224,1123
26616,1,0,123,0,-123
26617,1,0,20,0,-20
26618,1,1,285,1204,919
26619,1,0,28,0,-28
26620,0,0,84,0,-84
26621,0,0,176,0,-176
26622,0,0,38,0,-38
26623,1,1,459,1228,769
26624,1,0,75,0,-75
26625,0,0,3,0,-3
26626,1,0,3,0,-3
26627,1,0,69,0,-69
26628,1,0,52,0,-52
26629,0,0,106,0,-106
26630,0,0,48,0,-48
26631,1,0,47,0,-47
26632,1,0,11,0,-11
26633,1,1,2119,1666,-453
26634,0,0,25,0,-25
26635,0,0,13,0,-13
26636,1,0,59,0,-59
26637,1,1,1272,1283,11
26638,1,1,521,1700,1179
26639,0,0,16,0,-16
26640,0,0,103,0,-103
26641,1,1,1053,1432,379
26642,1,0,21,0,-21
26643,1,0,100,0,-100
26644,1,1,188,1334,1146
26645,1,1,181,1328,1147
26646,1,0,30,0,-30
26647,0,0,51,0,-51
26648,1,0,13,0,-13
26649,0,0,41,0,-41
26650,0,0,48,0,-48
26651,0,0,33,0,-33
26652,0,0,74,0,-74
26653,1,0,57,0,-57
26654,1,1,138,1565,1427
26655,0,0,32,0,-32
26656,1,1,336,1236,900
26657,1,0,1,0,-1
26658,1,1,518,2193,1675
26659,1,0,34,0,-34
26660,1,0,45,0,-45
26661,1,1,381,1329,948
26662,1,1,494,1593,1099
26663,0,0,46,0,-46
26664,1,1,155,1817,1662
26665,0,0,108,0,-108
26666,0,0,59,0,-59
26667,1,0,54,0,-54
26668,1,1,693,1368,675
26669,1,1,762,1576,814
26670,1,0,48,0,-48
26671,1,1,269,1692,1423
26672,0,0,10,0,-10
26673,0,0,27,0,-27
26674,0,0,14,0,-14
26675,1,1,347,2017,1670
26676,1,1,135,1607,1472
26677,1,0,4,0,-4
26678,0,0,24,0,-24
26679,1,1,228,1280,1052
26680,1,1,2441,1297,-1144
26681,0,0,44,0,-44
26682,1,0,68,0,-68
26683,0,0,0,0,0
26684,1,0,114,0,-114
26685,1,1,669,1587,918
26686,1,0,179,0,-179
26687,0,0,49,0,-49
26688,0,0,47,0,-47
26689,1,1,203,1213,1010
26690,1,0,15,0,-15
26691,0,0,17,0,-17
26692,1,1,473,1373,900
26693,1,1,151,1379,1228
26694,0,0,20,0,-20
26695,1,0,41,0,-41
26696,0,0,9,0,-9
26697,0,0,16,0,-16
26698,0,0,3,0,-3
26699,1,1,347,2143,1796
26700,1,0,5,0,-5
26701,0,0,11,0,-11
26702,1,0,46,0,-46
26703,1,1,474,1612,1138
26704,0,0,9,0,-9
26705,0,0,106,0,-106
26706,1,0,4,0,-4
26707,1,0,7,0,-7
26708,0,0,1,0,-1
26709,1,0,15,0,-15
26710,1,1,828,1656,828
26711,1,1,108,1391,1283
26712,0,0,177,0,-177
26713,1,1,49,1283,1234
26714,0,0,73,0,-73
26715,1,0,84,0,-84
26716,0,0,29,0,-29
26717,0,0,27,0,-27
26718,0,0,86,0,-86
26719,1,1,1023,1279,256
26720,1,1,352,1373,1021
26721,1,0,28,0,-28
26722,1,1,179,1248,1069
26723,0,0,107,0,-107
26724,0,0,107,0,-107
26725,1,0,26,0,-26
26726,1,1,198,1216,1018
26727,1,1,1147,1442,295
26728,1,0,26,0,-26
26729,1,1,433,1430,997
26730,0,0,76,0,-76
26731,0,0,35,0,-35
26732,1,0,242,0,-242
26733,1,1,240,1799,1559
26734,0,0,14,0,-14
26735,1,0,70,0,-70
26736,1,0,100,0,-100
26737,1,0,71,0,-71
26738,1,1,629,1545,916
26739,1,1,247,1458,1211
26740,0,0,86,0,-86
26741,0,0,134,0,-134
26742,1,0,0,0,0
26743,0,0,40,0,-40
26744,1,0,63,0,-63
26745,0,0,203,0,-203
26746,0,0,54,0,-54
26747,1,1,951,1324,373
26748,1,0,5,0,-5
26749,0,0,13,0,-13
26750,1,0,28,0,-28
26751,0,0,16,0,-16
26752,1,0,82,0,-82
26753,0,0,24,0,-24
26754,1,1,184,1416,1232
26755,1,1,528,1223,695
26756,0,0,106,0,-106
26757,1,1,841,1962,1121
26758,1,0,10,0,-10
26759,1,1,451,1414,963
26760,1,0,14,0,-14
26761,0,0,27,0,-27
26762,1,0,29,0,-29
26763,0,0,23,0,-23
26764,1,1,1078,1327,249
26765,1,1,523,1212,689
26766,0,0,15,0,-15
26767,0,0,46,0,-46
26768,1,1,136,1528,1392
26769,1,0,0,0,0
26770,0,0,50,0,-50
26771,1,0,92,0,-92
26772,1,1,741,1264,523
26773,1,0,100,0,-100
26774,1,1,221,1533,1312
26775,0,0,70,0,-70
26776,1,0,8,0,-8
26777,1,1,306,1495,1189
26778,1,0,23,0,-23
26779,1,1,193,1549,1356
26780,0,0,3,0,-3
26781,1,0,1,0,-1
26782,0,0,69,0,-69
26783,0,0,23,0,-23
26784,0,0,113,0,-113
26785,1,0,186,0,-186
26786,1,1,155,1330,1175
26787,1,1,306,1668,1362
26788,1,1,94,1416,1322
26789,0,0,36,0,-36
26790,0,0,15,0,-15
26791,1,0,2,0,-2
26792,0,0,24,0,-24
26793,0,0,102,0,-102
26794,1,0,35,0,-35
26795,1,1,476,1773,1297
26796,1,0,50,0,-50
26797,1,1,681,1974,1293
26798,0,0,133,0,-133
26799,0,0,7,0,-7
26800,1,1,1642,1689,47
26801,0,0,21,0,-21
26802,0,0,49,0,-49
26803,1,1,524,1478,954
26804,1,1,667,3258,2591
26805,0,0,67,0,-67
26806,1,1,420,1404,984
26807,1,1,1273,1564,291
26808,1,0,49,0,-49
26809,1,1,504,1483,979
26810,0,0,22,0,-22
26811,1,0,85,0,-85
26812,0,0,47,0,-47
26813,0,0,25,0,-25
26814,0,0,149,0,-149
26815,1,1,893,2280,1387
26816,1,1,67,1571,1504
26817,0,0,51,0,-51
26818,1,0,53,0,-53
26819,0,0,10,0,-10
26820,1,0,67,0,-67
26821,1,1,325,1341,1016
26822,1,1,644,1245,601
26823,1,0,145,0,-145
26824,0,0,64,0,-64
26825,0,0,23,0,-23
26826,0,0,3,0,-3
26827,0,0,12,0,-12
26828,1,1,357,2217,1860
26829,1,1,166,1361,1195
26830,1,0,151,0,-151
26831,1,0,75,0,-75
26832,0,0,124,0,-124
26833,1,1,641,1409,768
26834,1,0,93,0,-93
26835,0,0,7,0,-7
26836,1,0,73,0,-73
26837,0,0,32,0,-32
26838,0,0,13,0,-13
26839,1,0,53,0,-53
26840,1,0,9,0,-9
26841,1,1,168,1372,1204
26842,1,0,75,0,-75
26843,1,0,97,0,-97
26844,1,1,341,1472,1131
26845,0,0,8,0,-8
26846,1,1,44,1249,1205
26847,1,0,25,0,-25
26848,1,0,107,0,-107
26849,0,0,14,0,-14
26850,1,1,60,1200,1140
26851,1,0,62,0,-62
26852,1,0,37,0,-37
26853,1,1,783,1314,531
26854,1,1,203,2740,2537
26855,1,1,81,1289,1208
26856,1,0,167,0,-167
26857,1,1,1249,1663,414
26858,1,0,26,0,-26
26859,1,0,13,0,-13
26860,1,1,172,1663,1491
26861,1,0,45,0,-45
26862,0,0,89,0,-89
26863,1,0,19,0,-19
26864,1,0,22,0,-22
26865,0,0,64,0,-64
26866,1,1,1107,1478,371
26867,1,1,542,1536,994
26868,1,0,35,0,-35
26869,1,0,129,0,-129
26870,1,1,443,1255,812
26871,1,1,1381,1515,134
26872,0,0,81,0,-81
26873,0,0,86,0,-86
26874,0,0,65,0,-65
26875,1,1,1000,1674,674
26876,1,0,75,0,-75
26877,1,1,577,1352,775
26878,1,1,357,5445,5088
26879,1,0,78,0,-78
26880,1,0,8,0,-8
26881,1,1,517,1458,941
26882,0,0,39,0,-39
26883,1,1,1220,2640,1420
26884,0,0,115,0,-115
26885,1,0,93,0,-93
26886,1,1,263,1262,999
26887,0,0,14,0,-14
26888,1,1,1081,1480,399
26889,1,0,2,0,-2
26890,0,0,219,0,-219
26891,0,0,9,0,-9
26892,1,0,158,0,-158
26893,1,1,1028,1450,422
26894,1,0,22,0,-22
26895,1,1,983,1400,417
26896,0,0,63,0,-63
26897,0,0,97,0,-97
26898,0,0,30,0,-30
26899,1,1,92,2434,2342
26900,0,0,80,0,-80
26901,1,1,386,1330,944
26902,1,1,199,1320,1121
26903,1,0,104,0,-104
26904,1,1,64,2064,2000
26905,0,0,12,0,-12
26906,1,1,330,1436,1106
26907,0,0,58,0,-58
26908,1,1,894,1650,756
26909,0,0,20,0,-20
26910,1,0,58,0,-58
26911,0,0,96,0,-96
26912,1,1,117,1545,1428
26913,0,0,99,0,-99
26914,1,0,89,0,-89
26915,1,0,97,0,-97
26916,1,0,2,0,-2
26917,1,0,0,0,0
26918,0,0,90,0,-90
26919,1,1,517,1316,799
26920,1,0,19,0,-19
26921,1,1,60,1312,1252
26922,1,1,1071,3104,2033
26923,1,1,1270,2193,923
26924,0,0,127,0,-127
26925,1,0,105,0,-105
26926,0,0,4,0,-4
26927,1,0,90,0,-90
26928,0,0,106,0,-106
26929,0,0,160,0,-160
26930,0,0,7,0,-7
26931,0,0,61,0,-61
26932,0,0,47,0,-47
26933,0,0,260,0,-260
26934,1,0,93,0,-93
26935,0,0,0,0,0
26936,1,0,22,0,-22
26937,1,0,2,0,-2
26938,1,1,397,1405,1008
26939,1,1,1269,1468,199
26940,0,0,11,0,-11
26941,0,0,6,0,-6
26942,0,0,0,0,0
26943,0,0,14,0,-14
26944,1,1,161,1685,1524
26945,0,0,96,0,-96
26946,0,0,5,0,-5
26947,0,0,37,0,-37
26948,1,1,960,1330,370
26949,1,0,87,0,-87
26950,1,0,7,0,-7
26951,1,0,82,0,-82
26952,1,0,17,0,-17
26953,0,0,6,0,-6
26954,1,1,1785,1236,-549
26955,1,1,749,1410,661
26956,1,1,423,2251,1828
26957,1,0,28,0,-28
26958,1,1,773,1602,829
26959,0,0,2,0,-2
26960,1,1,1341,2056,715
26961,1,1,161,2572,2411
26962,1,1,321,1460,1139
26963,1,1,1377,1968,591
26964,1,0,97,0,-97
26965,0,0,48,0,-48
26966,1,0,57,0,-57
26967,1,1,887,1531,644
26968,1,1,12,3088,3076
26969,1,0,94,0,-94
26970,0,0,2,0,-2
26971,1,1,235,1400,1165
26972,0,0,11,0,-11
26973,1,1,459,1266,807
26974,1,0,22,0,-22
26975,0,0,14,0,-14
26976,0,0,32,0,-32
26977,1,1,765,1252,487
26978,1,1,221,1480,1259
26979,1,1,35,1207,1172
26980,1,1,584,1978,1394
26981,1,0,24,0,-24
26982,1,0,39,0,-39
26983,0,0,15,0,-15
26984,1,1,1574,1273,-301
26985,1,1,227,1261,1034
26986,1,1,63,1226,1163
26987,1,1,683,2142,1459
26988,1,1,922,1596,674
26989,1,1,958,1289,331
26990,1,0,103,0,-103
26991,1,1,1260,1833,573
26992,1,0,14,0,-14
26993,1,0,1,0,-1
26994,0,0,14,0,-14
26995,1,1,854,1389,535
26996,0,0,27,0,-27
26997,1,0,145,0,-145
26998,1,1,50,1302,1252
26999,1,1,450,1572,1122
27000,1,0,86,0,-86
27001,0,0,131,0,-131
27002,0,0,89,0,-89
27003,1,1,640,1672,1032
27004,0,0,29,0,-29
27005,0,0,7,0,-7
27006,1,1,248,1562,1314
27007,0,0,29,0,-29
27008,1,0,6,0,-6
27009,1,0,37,0,-37
27010,1,1,75,2480,2405
27011,0,0,51,0,-51
27012,1,1,1102,1740,638
27013,0,0,2,0,-2
27014,1,0,3,0,-3
27015,1,0,6,0,-6
27016,1,1,632,2244,1612
27017,1,1,129,1766,1637
27018,0,0,140,0,-140
27019,1,0,45,0,-45
27020,0,0,117,0,-117
27021,1,1,372,1642,1270
27022,0,0,43,0,-43
27023,1,1,622,1383,761
27024,1,0,9,0,-9
27025,0,0,12,0,-12
27026,1,1,337,1399,1062
27027,1,0,62,0,-62
27028,1,0,127,0,-127
27029,0,0,107,0,-107
27030,1,0,12,0,-12
27031,1,0,195,0,-195
27032,1,0,3,0,-3
27033,1,1,68,1527,1459
27034,0,0,28,0,-28
27035,1,0,20,0,-20
27036,1,1,386,1242,856
27037,0,0,4,0,-4
27038,1,0,88,0,-88
27039,1,1,1308,1828,520
27040,0,0,38,0,-38
27041,1,1,281,1542,1261
27042,1,1,440,2982,2542
27043,1,1,511,1280,769
27044,1,0,0,0,0
27045,1,0,107,0,-107
27046,0,0,12,0,-12
27047,1,0,3,0,-3
27048,1,1,289,1897,1608
27049,1,1,242,1269,1027
27050,1,0,45,0,-45
27051,1,1,270,1236,966
27052,0,0,53,0,-53
27053,1,0,144,0,-144
27054,1,0,10,0,-10
27055,0,0,8,0,-8
27056,1,1,469,1633,1164
27057,1,0,45,0,-45
27058,0,0,113,0,-113
27059,1,1,311,1230,919
27060,1,0,104,0,-104
27061,1,1,394,1255,861
27062,0,0,24,0,-24
27063,1,0,7,0,-7
27064,1,1,618,1245,627
27065,1,0,28,0,-28
27066,0,0,51,0,-51
27067,1,1,710,1969,1259
27068,1,1,1071,1620,549
27069,1,1,1175,1515,340
27070,1,0,2,0,-2
27071,1,1,587,1268,681
27072,0,0,19,0,-19
27073,1,1,652,1447,795
27074,1,0,13,0,-13
27075,0,0,20,0,-20
27076,0,0,47,0,-47
27077,0,0,33,0,-33
27078,1,0,0,0,0
27079,0,0,55,0,-55
27080,1,1,664,1341,677
27081,0,0,29,0,-29
27082,1,1,495,1205,710
27083,1,1,332,5583,5251
27084,1,1,1440,1237,-203
27085,0,0,16,0,-16
27086,0,0,137,0,-137
27087,1,0,108,0,-108
27088,0,0,80,0,-80
27089,1,1,589,1728,1139
27090,1,1,383,2030,1647
27091,0,0,84,0,-84
27092,1,1,326,1353,1027
27093,1,1,425,1707,1282
27094,0,0,17,0,-17
27095,1,1,131,1205,1074
27096,1,0,52,0,-52
27097,1,0,59,0,-59
27098,1,1,485,1757,1272
27099,1,0,4,0,-4
27100,0,0,34,0,-34
27101,1,1,201,1205,1004
27102,0,0,5,0,-5
27103,0,0,3,0,-3
27104,1,0,62,0,-62
27105,0,0,31,0,-31
27106,1,0,118,0,-118
27107,0,0,31,0,-31
27108,1,0,123,0,-123
27109,0,0,20,0,-20
27110,0,0,109,0,-109
27111,1,0,94,0,-94
27112,0,0,100,0,-100
27113,1,0,3,0,-3
27114,1,1,692,1286,594
27115,1,0,39,0,-39
27116,1,1,61,1605,1544
27117,1,1,228,1773,1545
27118,0,0,20,0,-20
27119,1,0,30,0,-30
27120,1,1,161,2373,2212
27121,1,1,292,1623,1331
27122,1,1,707,2831,2124
27123,1,1,213,1613,1400
27124,1,0,11,0,-11
27125,1,1,405,1204,799
27126,0,0,91,0,-91
27127,1,0,21,0,-21
27128,0,0,20,0,-20
27129,0,0,14,0,-14
27130,1,0,56,0,-56
27131,0,0,17,0,-17
27132,0,0,20,0,-20
27133,0,0,146,0,-146
27134,1,1,427,1383,956
27135,1,0,76,0,-76
27136,1,0,1,0,-1
27137,1,1,895,1434,539
27138,1,1,433,1324,891
27139,1,1,234,1329,1095
27140,0,0,67,0,-67
27141,1,0,26,0,-26
27142,0,0,199,0,-199
27143,1,0,90,0,-90
27144,0,0,41,0,-41
27145,0,0,33,0,-33
27146,0,0,85,0,-85
27147,1,0,14,0,-14
27148,0,0,91,0,-91
27149,1,1,612,2537,1925
27150,1,1,36,1219,1183
27151,0,0,9,0,-9
27152,1,0,44,0,-44
27153,0,0,8,0,-8
27154,0,0,86,0,-86
27155,1,1,212,1306,1094
27156,1,1,2432,2280,-152
27157,1,0,88,0,-88
27158,0,0,38,0,-38
27159,0,0,54,0,-54
27160,1,0,77,0,-77
27161,1,1,103,1840,1737
27162,1,0,69,0,-69
27163,1,1,97,1332,1235
27164,0,0,55,0,-55
27165,0,0,53,0,-53
27166,0,0,50,0,-50
27167,1,1,795,1244,449
27168,1,0,67,0,-67
27169,1,0,132,0,-132
27170,1,1,773,1358,585
27171,0,0,100,0,-100
27172,1,1,382,1687,1305
27173,1,0,3,0,-3
27174,1,1,458,1316,858
27175,1,1,1458,1325,-133
27176,0,0,70,0,-70
27177,1,1,619,2505,1886
27178,1,0,91,0,-91
27179,0,0,21,0,-21
27180,0,0,2,0,-2
27181,0,0,3,0,-3
27182,1,1,215,1259,1044
27183,1,1,320,1202,882
27184,1,0,141,0,-141
27185,1,1,436,1243,807
27186,1,1,756,1849,1093
27187,1,0,50,0,-50
27188,0,0,39,0,-39
27189,0,0,32,0,-32
27190,1,0,3,0,-3
27191,1,1,630,1235,605
27192,0,0,93,0,-93
27193,0,0,33,0,-33
27194,1,0,5,0,-5
27195,0,0,19,0,-19
27196,1,1,210,1623,1413
27197,1,1,157,1425,1268
27198,1,0,37,0,-37
27199,1,0,32,0,-32
27200,1,0,41,0,-41
27201,1,1,1213,1371,158
27202,1,0,48,0,-48
27203,0,0,12,0,-12
27204,1,1,957,1265,308
27205,0,0,7,0,-7
27206,1,1,134,1745,1611
27207,1,0,17,0,-17
27208,1,1,989,1563,574
27209,1,0,143,0,-143
27210,0,0,130,0,-130
27211,1,0,39,0,-39
27212,1,0,27,0,-27
27213,1,1,1046,1337,291
27214,0,0,22,0,-22
27215,0,0,28,0,-28
27216,1,0,2,0,-2
27217,1,0,65,0,-65
27218,1,1,31,1411,1380
27219,1,0,22,0,-22
27220,1,0,41,0,-41
27221,0,0,2,0,-2
27222,1,0,97,0,-97
27223,0,0,138,0,-138
27224,0,0,21,0,-21
27225,0,0,94,0,-94
27226,1,0,19,0,-19
27227,1,0,18,0,-18
27228,1,1,440,1678,1238
27229,1,1,99,1603,1504
27230,0,0,15,0,-15
27231,0,0,84,0,-84
27232,1,0,0,0,0
27233,0,0,65,0,-65
27234,0,0,22,0,-22
27235,1,1,171,2176,2005
27236,1,1,1228,1661,433
27237,1,0,7,0,-7
27238,1,1,378,1573,1195
27239,0,0,62,0,-62
27240,1,1,181,1610,1429
27241,1,1,1343,1611,268
27242,1,0,1,0,-1
27243,0,0,6,0,-6
27244,1,1,247,1428,1181
27245,1,0,17,0,-17
27246,1,0,144,0,-144
27247,1,1,178,1535,1357
27248,1,0,23,0,-23
27249,0,0,60,0,-60
27250,1,1,209,1263,1054
27251,0,0,58,0,-58
27252,1,0,90,0,-90
27253,1,1,687,1359,672
27254,1,1,94,1270,1176
27255,1,1,1053,1260,207
27256,1,1,388,1293,905
27257,0,0,47,0,-47
27258,0,0,20,0,-20
27259,1,0,13,0,-13
27260,1,1,267,1979,1712
27261,1,0,39,0,-39
27262,1,1,345,1220,875
27263,1,0,46,0,-46
27264,1,1,755,1656,901
27265,1,0,155,0,-155
27266,0,0,45,0,-45
27267,1,0,18,0,-18
27268,1,0,94,0,-94
27269,1,1,152,1851,1699
27270,1,1,88,1342,1254
27271,1,0,4,0,-4
27272,1,0,9,0,-9
27273,1,0,99,0,-99
27274,1,0,12,0,-12
27275,0,0,132,0,-132
27276,0,0,79,0,-79
27277,1,1,526,1918,1392
27278,1,1,185,1871,1686
27279,1,1,147,1472,1325
27280,1,0,40,0,-40
27281,1,1,274,1275,1001
27282,1,0,28,0,-28
27283,1,1,405,1817,1412
27284,0,0,2,0,-2
27285,1,0,43,0,-43
27286,1,1,485,1574,1089
27287,0,0,16,0,-16
27288,1,1,225,1964,1739
27289,1,0,25,0,-25
27290,1,1,564,1229,665
27291,1,0,20,0,-20
27292,0,0,1,0,-1
27293,0,0,64,0,-64
27294,1,1,16,1383,1367
27295,0,0,187,0,-187
27296,0,0,6,0,-6
27297,1,1,133,2894,2761
27298,0,0,11,0,-11
27299,1,1,357,1508,1151
27300,0,0,45,0,-45
27301,1,1,1028,1438,410
27302,0,0,4,0,-4
27303,0,0,172,0,-172
27304,1,0,33,0,-33
27305,1,0,9,0,-9
27306,1,0,3,0,-3
27307,0,0,66,0,-66
27308,1,0,17,0,-17
27309,0,0,28,0,-28
27310,0,0,15,0,-15
27311,0,0,63,0,-63
27312,0,0,2,0,-2
27313,0,0,37,0,-37
27314,0,0,101,0,-101
27315,1,0,34,0,-34
27316,1,1,1120,2131,1011
27317,0,0,26,0,-26
27318,0,0,22,0,-22
27319,1,1,378,1518,1140
27320,1,1,1263,1316,53
27321,1,1,229,1228,999
27322,0,0,3,0,-3
27323,1,1,183,1398,1215
27324,0,0,40,0,-40
27325,1,0,49,0,-49
27326,1,0,60,0,-60
27327,1,1,1148,1268,120
27328,1,0,22,0,-22
27329,0,0,50,0,-50
27330,0,0,27,0,-27
27331,1,1,1402,1231,-171
27332,0,0,42,0,-42
27333,1,0,115,0,-115
27334,1,1,139,1297,1158
27335,0,0,63,0,-63
27336,1,0,0,0,0
27337,1,0,24,0,-24
27338,0,0,65,0,-65
27339,0,0,20,0,-20
27340,0,0,23,0,-23
27341,1,1,550,2228,1678
27342,1,1,251,1746,1495
27343,1,1,159,1491,1332
27344,0,0,88,0,-88
27345,0,0,0,0,0
27346,0,0,139,0,-139
27347,1,0,112,0,-112
27348,0,0,30,0,-30
27349,1,0,34,0,-34
27350,0,0,23,0,-23
27351,1,1,605,3939,3334
27352,1,1,200,2909,2709
27353,1,1,137,1279,1142
27354,0,0,30,0,-30
27355,0,0,3,0,-3
27356,1,1,339,1228,889
27357,0,0,4,0,-4
27358,1,0,118,0,-118
27359,1,1,1799,1892,93
27360,1,0,71,0,-71
27361,1,1,448,1586,1138
27362,1,0,10,0,-10
27363,0,0,15,0,-15
27364,1,0,14,0,-14
27365,0,0,96,0,-96
27366,0,0,21,0,-21
27367,1,0,37,0,-37
27368,0,0,21,0,-21
27369,0,0,56,0,-56
27370,0,0,55,0,-55
27371,1,0,183,0,-183
27372,0,0,34,0,-34
27373,0,0,24,0,-24
27374,0,0,199,0,-199
27375,1,0,106,0,-106
27376,0,0,162,0,-162
27377,1,1,847,1571,724
27378,1,0,33,0,-33
27379,0,0,50,0,-50
27380,0,0,1,0,-1
27381,1,1,1822,1389,-433
27382,1,1,435,1203,768
27383,1,0,26,0,-26
27384,1,0,21,0,-21
27385,1,0,36,0,-36
27386,1,0,91,0,-91
27387,0,0,56,0,-56
27388,0,0,30,0,-30
27389,1,0,82,0,-82
27390,0,0,56,0,-56
27391,0,0,41,0,-41
27392,0,0,48,0,-48
27393,1,1,1271,1399,128
27394,0,0,30,0,-30
27395,0,0,12,0,-12
27396,1,0,79,0,-79
27397,0,0,54,0,-54
27398,1,0,100,0,-100
27399,1,0,8,0,-8
27400,1,0,14,0,-14
27401,1,1,524,1437,913
27402,0,0,100,0,-100
27403,0,0,66,0,-66
27404,0,0,49,0,-49
27405,1,1,240,2028,1788
27406,1,0,20,0,-20
27407,0,0,51,0,-51
27408,1,1,9,1384,1375
27409,1,0,32,0,-32
27410,1,0,103,0,-103
27411,1,1,681,1225,544
27412,1,1,288,1268,980
27413,1,0,45,0,-45
27414,1,1,1512,2954,1442
27415,1,0,12,0,-12
27416,1,1,1857,1218,-639
27417,1,1,60,1257,1197
27418,0,0,34,0,-34
27419,0,0,1,0,-1
27420,0,0,20,0,-20
27421,0,0,51,0,-51
27422,1,1,160,1238,1078
27423,1,0,2,0,-2
27424,1,1,698,1955,1257
27425,0,0,6,0,-6
27426,1,1,240,1701,1461
27427,1,1,1489,1414,-75
27428,0,0,35,0,-35
27429,1,0,21,0,-21
27430,1,0,14,0,-14
27431,1,1,691,1419,728
27432,1,1,650,1644,994
27433,1,1,189,2697,2508
27434,1,0,136,0,-136
27435,1,0,72,0,-72
27436,0,0,25,0,-25
27437,1,0,42,0,-42
27438,0,0,91,0,-91
27439,0,0,0,0,0
27440,1,1,622,1460,838
27441,1,1,621,1373,752
27442,1,1,554,1653,1099
27443,0,0,4,0,-4
27444,1,0,15,0,-15
27445,1,0,14,0,-14
27446,1,1,430,1238,808
27447,1,0,7,0,-7
27448,1,1,439,1203,764
27449,1,1,454,1625,1171
27450,0,0,98,0,-98
27451,1,0,44,0,-44
27452,1,1,529,1833,1304
27453,1,0,31,0,-31
27454,1,0,93,0,-93
27455,1,0,34,0,-34
27456,1,1,334,1243,909
27457,1,1,34,1311,1277
27458,1,1,1143,1480,337
27459,1,0,111,0,-111
27460,1,1,538,1507,969
27461,1,1,511,1298,787
27462,0,0,26,0,-26
27463,0,0,5,0,-5
27464,1,0,52,0,-52
27465,1,1,574,1486,912
27466,1,1,1921,1572,-349
27467,0,0,48,0,-48
27468,1,1,1006,1934,928
27469,1,0,110,0,-110
27470,0,0,88,0,-88
27471,1,1,291,1355,1064
27472,0,0,31,0,-31
27473,0,0,11,0,-11
27474,0,0,26,0,-26
27475,0,0,2,0,-2
27476,1,0,51,0,-51
27477,1,0,37,0,-37
27478,0,0,94,0,-94
27479,0,0,100,0,-100
27480,0,0,12,0,-12
27481,1,1,2304,7572,5268
27482,1,1,101,2207,2106
27483,1,0,13,0,-13
27484,0,0,133,0,-133
27485,1,1,228,1936,1708
27486,1,1,442,1239,797
27487,0,0,76,0,-76
27488,1,0,15,0,-15
27489,1,0,26,0,-26
27490,1,0,149,0,-149
27491,0,0,1,0,-1
27492,1,1,276,2524,2248
27493,1,1,1343,2663,1320
27494,1,0,22,0,-22
27495,0,0,59,0,-59
27496,0,0,59,0,-59
27497,1,0,87,0,-87
27498,1,0,71,0,-71
27499,1,0,40,0,-40
27500,1,0,62,0,-62
27501,1,1,1013,1760,747
27502,1,1,1402,1229,-173
27503,0,0,35,0,-35
27504,1,0,30,0,-30
27505,0,0,98,0,-98
27506,0,0,20,0,-20
27507,1,0,131,0,-131
27508,0,0,33,0,-33
27509,0,0,62,0,-62
27510,1,1,51,1512,1461
27511,1,1,699,1216,517
27512,0,0,52,0,-52
27513,1,1,85,1721,1636
27514,0,0,68,0,-68
27515,0,0,23,0,-23
27516,0,0,43,0,-43
27517,1,1,1874,1378,-496
27518,0,0,65,0,-65
27519,1,0,76,0,-76
27520,0,0,4,0,-4
27521,1,0,14,0,-14
27522,1,0,154,0,-154
27523,0,0,81,0,-81
27524,0,0,9,0,-9
27525,1,0,48,0,-48
27526,0,0,8,0,-8
27527,1,1,766,1750,984
27528,0,0,19,0,-19
27529,1,1,197,1233,1036
27530,1,1,356,1231,875
27531,1,0,18,0,-18
27532,1,0,102,0,-102
27533,1,1,346,1222,876
27534,0,0,1,0,-1
27535,1,1,93,1747,1654
27536,0,0,17,0,-17
27537,1,0,81,0,-81
27538,1,1,143,1669,1526
27539,0,0,24,0,-24
27540,1,1,829,1319,490
27541,1,0,31,0,-31
27542,0,0,44,0,-44
27543,0,0,78,0,-78
27544,1,1,88,1622,1534
27545,0,0,73,0,-73
27546,1,0,22,0,-22
27547,1,1,902,1680,778
27548,0,0,15,0,-15
27549,1,1,412,1344,932
27550,0,0,70,0,-70
27551,0,0,55,0,-55
27552,1,0,17,0,-17
27553,1,1,81,1271,1190
27554,0,0,13,0,-13
27555,1,1,1003,1351,348
27556,0,0,8,0,-8
27557,0,0,230,0,-230
27558,1,1,964,1308,344
27559,0,0,44,0,-44
27560,1,1,197,1537,1340
27561,1,0,58,0,-58
27562,1,0,43,0,-43
27563,1,1,858,1414,556
27564,0,0,40,0,-40
27565,0,0,19,0,-19
27566,0,0,43,0,-43
27567,0,0,16,0,-16
27568,1,1,632,1504,872
27569,1,0,40,0,-40
27570,1,1,2324,1314,-1010
27571,1,0,108,0,-108
27572,1,1,1837,1988,151
27573,1,1,397,1501,1104
27574,1,1,580,1230,650
27575,1,1,139,3616,3477
27576,0,0,1,0,-1
27577,0,0,14,0,-14
27578,1,1,929,1277,348
27579,0,0,40,0,-40
27580,1,1,1787,2344,557
27581,1,1,155,1372,1217
27582,1,0,63,0,-63
27583,0,0,106,0,-106
27584,0,0,142,0,-142
27585,0,0,8,0,-8
27586,1,0,51,0,-51
27587,1,1,1542,1983,441
27588,0,0,493,0,-493
27589,1,0,29,0,-29
27590,1,0,2,0,-2
27591,1,1,167,1209,1042
27592,0,0,54,0,-54
27593,1,0,92,0,-92
27594,1,0,12,0,-12
27595,1,1,1888,1427,-461
27596,1,0,33,0,-33
27597,1,1,182,2656,2474
27598,1,0,22,0,-22
27599,1,1,712,1397,685
27600,1,0,171,0,-171
27601,0,0,28,0,-28
27602,1,0,4,0,-4
27603,0,0,2,0,-2
27604,1,0,14,0,-14
27605,1,1,449,1690,1241
27606,1,0,68,0,-68
27607,0,0,131,0,-131
27608,1,0,24,0,-24
27609,0,0,49,0,-49
27610,1,1,109,1270,1161
27611,1,1,168,1480,1312
27612,1,1,740,1544,804
27613,0,0,38,0,-38
27614,0,0,75,0,-75
27615,1,0,35,0,-35
27616,1,1,304,1936,1632
27617,0,0,83,0,-83
27618,0,0,27,0,-27
27619,1,0,123,0,-123
27620,1,0,13,0,-13
27621,1,1,1139,1341,202
27622,1,1,460,1224,764
27623,1,1,598,1223,625
27624,1,1,442,1350,908
27625,1,1,127,5100,4973
27626,1,1,141,1633,1492
27627,0,0,50,0,-50
27628,0,0,32,0,-32
27629,0,0,7,0,-7
27630,1,1,726,2045,1319
27631,0,0,238,0,-238
27632,1,1,989,2576,1587
27633,1,0,79,0,-79
27634,1,0,40,0,-40
27635,1,0,7,0,-7
27636,0,0,10,0,-10
27637,1,0,60,0,-60
27638,0,0,12,0,-12
27639,0,0,37,0,-37
27640,1,0,15,0,-15
27641,1,1,357,1919,1562
27642,1,0,61,0,-61
27643,1,1,1384,1719,335
27644,0,0,75,0,-75
27645,0,0,72,0,-72
27646,1,1,105,1230,1125
27647,1,0,44,0,-44
27648,1,1,117,1405,1288
27649,1,0,66,0,-66
27650,0,0,24,0,-24
27651,0,0,1,0,-1
27652,1,0,141,0,-141
27653,1,0,17,0,-17
27654,1,1,544,1454,910
27655,1,1,196,1250,1054
27656,1,0,27,0,-27
27657,1,0,27,0,-27
27658,0,0,68,0,-68
27659,1,1,207,1532,1325
27660,0,0,160,0,-160
27661,1,0,2,0,-2
27662,1,1,1525,1275,-250
27663,1,0,54,0,-54
27664,1,1,423,1302,879
27665,1,0,15,0,-15
27666,0,0,54,0,-54
27667,1,1,183,1246,1063
27668,1,0,39,0,-39
27669,0,0,2,0,-2
27670,1,1,475,1801,1326
27671,1,1,177,1233,1056
27672,1,0,82,0,-82
27673,1,1,201,1802,1601
27674,0,0,172,0,-172
27675,0,0,136,0,-136
27676,0,0,44,0,-44
27677,1,1,613,1358,745
27678,1,0,2,0,-2
27679,1,1,630,1377,747
27680,1,0,28,0,-28
27681,1,0,4,0,-4
27682,1,0,250,0,-250
27683,0,0,90,0,-90
27684,1,0,6,0,-6
27685,1,1,451,1654,1203
27686,1,0,57,0,-57
27687,1,1,607,1250,643
27688,1,0,128,0,-128
27689,1,1,553,2067,1514
27690,1,0,89,0,-89
27691,1,1,490,1478,988
27692,1,1,433,1526,1093
27693,1,0,43,0,-43
27694,1,1,718,1729,1011
27695,1,1,366,2257,1891
27696,1,0,139,0,-139
27697,1,1,243,1651,1408
27698,0,0,1,0,-1
27699,0,0,8,0,-8
27700,0,0,0,0,0
27701,0,0,34,0,-34
27702,1,1,250,1932,1682
27703,0,0,41,0,-41
27704,1,1,579,1371,792
27705,1,0,0,0,0
27706,0,0,59,0,-59
27707,1,1,584,1469,885
27708,1,0,371,0,-371
27709,1,0,11,0,-11
27710,1,0,26,0,-26
27711,1,0,87,0,-87
27712,1,0,31,0,-31
27713,1,1,69,2291,2222
27714,1,0,0,0,0
27715,0,0,8,0,-8
27716,0,0,96,0,-96
27717,1,1,1117,1223,106
27718,0,0,133,0,-133
27719,1,0,65,0,-65
27720,1,1,805,1464,659
27721,1,0,8,0,-8
27722,0,0,35,0,-35
27723,1,0,133,0,-133
27724,0,0,53,0,-53
27725,1,1,189,1273,1084
27726,0,0,31,0,-31
27727,1,0,116,0,-116
27728,1,0,11,0,-11
27729,1,1,179,2238,2059
27730,1,0,24,0,-24
27731,0,0,122,0,-122
27732,1,1,529,1517,988
27733,1,0,171,0,-171
27734,0,0,22,0,-22
27735,0,0,14,0,-14
27736,0,0,79,0,-79
27737,0,0,18,0,-18
27738,0,0,83,0,-83
27739,1,1,416,1315,899
27740,0,0,86,0,-86
27741,0,0,19,0,-19
27742,1,1,60,1413,1353
27743,0,0,38,0,-38
27744,1,0,19,0,-19
27745,1,1,40,1893,1853
27746,0,0,31,0,-31
27747,1,0,31,0,-31
27748,1,1,438,2044,1606
27749,1,0,4,0,-4
27750,1,1,148,1210,1062
27751,0,0,21,0,-21
27752,0,0,14,0,-14
27753,1,0,67,0,-67
27754,0,0,68,0,-68
27755,0,0,110,0,-110
27756,0,0,75,0,-75
27757,0,0,0,0,0
27758,1,1,880,1442,562
27759,0,0,7,0,-7
27760,0,0,148,0,-148
27761,1,0,5,0,-5
27762,0,0,164,0,-164
27763,1,1,1095,1209,114
27764,1,0,108,0,-108
27765,0,0,83,0,-83
27766,1,1,1303,1912,609
27767,0,0,1,0,-1
27768,1,1,687,1549,862
27769,0,0,11,0,-11
27770,1,0,138,0,-138
27771,1,1,734,1889,1155
27772,0,0,145,0,-145
27773,1,1,1065,1531,466
27774,0,0,10,0,-10
27775,1,0,28,0,-28
27776,1,0,25,0,-25
27777,0,0,27,0,-27
27778,1,1,679,1376,697
27779,0,0,75,0,-75
27780,1,0,17,0,-17
27781,0,0,152,0,-152
27782,0,0,37,0,-37
27783,0,0,137,0,-137
27784,0,0,49,0,-49
27785,1,1,258,1351,1093
27786,1,0,40,0,-40
27787,0,0,4,0,-4
27788,0,0,80,0,-80
27789,1,1,146,2093,1947
27790,1,1,636,1566,930
27791,1,0,2,0,-2
27792,1,1,200,1267,1067
27793,1,0,4,0,-4
27794,1,1,384,2176,1792
27795,0,0,68,0,-68
27796,1,0,7,0,-7
27797,1,0,39,0,-39
27798,1,1,447,1457,1010
27799,0,0,26,0,-26
27800,1,1,605,1981,1376
27801,0,0,29,0,-29
27802,0,0,98,0,-98
27803,0,0,35,0,-35
27804,1,0,13,0,-13
27805,0,0,33,0,-33
27806,0,0,88,0,-88
27807,1,0,112,0,-112
27808,1,1,382,2724,2342
27809,1,1,758,1224,466
27810,1,0,73,0,-73
27811,0,0,147,0,-147
27812,1,1,155,2038,1883
27813,1,1,85,1998,1913
27814,0,0,1,0,-1
27815,0,0,66,0,-66
27816,0,0,7,0,-7
27817,0,0,18,0,-18
27818,1,0,31,0,-31
27819,1,1,90,1521,1431
27820,1,1,86,1423,1337
27821,1,1,406,1332,926
27822,1,0,47,0,-47
27823,0,0,4,0,-4
27824,0,0,88,0,-88
27825,1,0,20,0,-20
27826,1,1,904,1441,537
27827,0,0,143,0,-143
27828,1,0,94,0,-94
27829,0,0,43,0,-43
27830,1,0,11,0,-11
27831,1,1,34,1674,1640
27832,0,0,165,0,-165
27833,0,0,45,0,-45
27834,0,0,62,0,-62
27835,1,0,106,0,-106
27836,1,0,55,0,-55
27837,1,0,112,0,-112
27838,0,0,69,0,-69
27839,0,0,24,0,-24
27840,0,0,4,0,-4
27841,0,0,7,0,-7
27842,0,0,62,0,-62
27843,0,0,23,0,-23
27844,0,0,54,0,-54
27845,0,0,27,0,-27
27846,0,0,9,0,-9
27847,1,1,239,1598,1359
27848,1,1,387,1238,851
27849,1,0,47,0,-47
27850,0,0,9,0,-9
27851,0,0,5,0,-5
27852,1,0,24,0,-24
27853,1,1,1590,1677,87
27854,0,0,79,0,-79
27855,0,0,84,0,-84
27856,1,1,173,1927,1754
27857,1,1,935,1892,957
27858,0,0,45,0,-45
27859,1,0,16,0,-16
27860,1,0,13,0,-13
27861,0,0,27,0,-27
27862,1,0,91,0,-91
27863,1,0,71,0,-71
27864,1,1,1117,1614,497
27865,1,0,11,0,-11
27866,1,0,35,0,-35
27867,0,0,51,0,-51
27868,1,1,1200,1762,562
27869,1,0,8,0,-8
27870,1,0,0,0,0
27871,0,0,80,0,-80
27872,1,0,23,0,-23
27873,1,0,16,0,-16
27874,0,0,0,0,0
27875,1,0,3,0,-3
27876,1,0,45,0,-45
27877,0,0,41,0,-41
27878,1,0,72,0,-72
27879,1,0,63,0,-63
27880,1,1,963,2164,1201
27881,0,0,94,0,-94
27882,1,1,273,1227,954
27883,1,1,503,2203,1700
27884,0,0,43,0,-43
27885,1,0,10,0,-10
27886,1,1,162,1548,1386
27887,1,1,190,1662,1472
27888,0,0,5,0,-5
27889,1,0,9,0,-9
27890,0,0,6,0,-6
27891,0,0,18,0,-18
27892,0,0,23,0,-23
27893,0,0,5,0,-5
27894,1,1,396,1202,806
27895,0,0,10,0,-10
27896,0,0,34,0,-34
27897,0,0,125,0,-125
27898,1,1,335,1331,996
27899,0,0,72,0,-72
27900,1,1,458,1229,771
27901,1,0,10,0,-10
27902,1,1,1304,1323,19
27903,1,1,502,1471,969
27904,0,0,61,0,-61
27905,0,0,8,0,-8
27906,1,0,93,0,-93
27907,0,0,62,0,-62
27908,1,0,22,0,-22
27909,1,0,7,0,-7
27910,1,0,42,0,-42
27911,0,0,98,0,-98
27912,1,0,14,0,-14
27913,1,1,100,3589,3489
27914,0,0,31,0,-31
27915,0,0,19,0,-19
27916,1,0,2,0,-2
27917,0,0,71,0,-71
27918,1,1,395,1242,847
27919,1,0,132,0,-132
27920,1,1,36,1502,1466
27921,1,1,1242,1979,737
27922,1,0,4,0,-4
27923,0,0,107,0,-107
27924,1,1,1212,1954,742
27925,1,1,127,1260,1133
27926,0,0,90,0,-90
27927,1,0,4,0,-4
27928,1,1,195,1887,1692
27929,0,0,49,0,-49
27930,0,0,1,0,-1
27931,1,1,395,1237,842
27932,1,0,2,0,-2
27933,1,0,28,0,-28
27934,1,0,2,0,-2
27935,0,0,4,0,-4
27936,0,0,0,0,0
27937,1,0,150,0,-150
27938,0,0,0,0,0
27939,0,0,142,0,-142
27940,1,1,160,1867,1707
27941,0,0,12,0,-12
27942,1,0,8,0,-8
27943,1,1,26,1295,1269
27944,0,0,92,0,-92
27945,0,0,41,0,-41
27946,1,1,66,1311,1245
27947,0,0,30,0,-30
27948,1,1,1359,1767,408
27949,1,0,33,0,-33
27950,0,0,78,0,-78
27951,0,0,30,0,-30
27952,0,0,60,0,-60
27953,1,0,30,0,-30
27954,0,0,15,0,-15
27955,1,1,1338,1280,-58
27956,1,0,84,0,-84
27957,0,0,26,0,-26
27958,1,1,395,1400,1005
27959,1,1,82,1744,1662
27960,1,1,226,3519,3293
27961,1,0,78,0,-78
27962,1,1,1842,1516,-326
27963,0,0,338,0,-338
27964,1,1,182,1399,1217
27965,0,0,37,0,-37
27966,1,0,3,0,-3
27967,1,0,13,0,-13
27968,1,1,235,1406,1171
27969,1,1,179,1342,1163
27970,1,1,554,1507,953
27971,0,0,114,0,-114
27972,0,0,61,0,-61
27973,1,1,2278,1317,-961
27974,1,0,7,0,-7
27975,1,0,38,0,-38
27976,0,0,36,0,-36
27977,1,0,13,0,-13
27978,1,1,133,1363,1230
27979,0,0,77,0,-77
27980,1,1,338,1801,1463
27981,1,1,169,1226,1057
27982,1,0,74,0,-74
27983,1,1,142,1679,1537
27984,1,0,22,0,-22
27985,1,0,17,0,-17
27986,1,0,36,0,-36
27987,1,0,219,0,-219
27988,1,1,175,1832,1657
27989,1,0,88,0,-88
27990,1,1,368,2534,2166
27991,0,0,56,0,-56
27992,1,0,73,0,-73
27993,0,0,51,0,-51
27994,0,0,150,0,-150
27995,1,1,1034,1305,271
27996,1,0,22,0,-22
27997,1,0,53,0,-53
27998,1,1,228,1495,1267
27999,0,0,62,0,-62
28000,0,0,33,0,-33
28001,0,0,3,0,-3
28002,1,1,302,1227,925
28003,1,0,4,0,-4
28004,1,0,26,0,-26
28005,0,0,74,0,-74
28006,0,0,73,0,-73
28007,1,1,215,1866,1651
28008,1,0,78,0,-78
28009,1,1,460,1200,740
28010,0,0,54,0,-54
28011,0,0,58,0,-58
28012,0,0,141,0,-141
28013,0,0,85,0,-85
28014,0,0,7,0,-7
28015,0,0,8,0,-8
28016,0,0,39,0,-39
28017,1,0,54,0,-54
28018,0,0,196,0,-196
28019,1,1,480,1493,1013
28020,1,1,223,1462,1239
28021,1,1,237,1398,1161
28022,1,0,99,0,-99
28023,1,0,196,0,-196
28024,1,0,33,0,-33
28025,1,1,388,1594,1206
28026,1,0,58,0,-58
28027,1,0,98,0,-98
28028,0,0,177,0,-177
28029,1,0,14,0,-14
28030,0,0,42,0,-42
28031,1,1,743,1262,519
28032,0,0,43,0,-43
28033,1,0,44,0,-44
28034,1,1,402,1826,1424
28035,1,1,443,1492,1049
28036,1,0,11,0,-11
28037,1,0,7,0,-7
28038,1,1,116,1968,1852
28039,0,0,45,0,-45
28040,0,0,33,0,-33
28041,1,0,33,0,-33
28042,0,0,80,0,-80
28043,1,1,566,1699,1133
28044,1,1,297,1504,1207
28045,0,0,38,0,-38
28046,1,1,196,1297,1101
28047,1,1,1742,1256,-486
28048,1,0,41,0,-41
28049,1,1,172,1449,1277
28050,0,0,22,0,-22
28051,1,0,35,0,-35
28052,1,1,739,1244,505
28053,1,1,552,2412,1860
28054,0,0,30,0,-30
28055,1,1,1743,1272,-471
28056,1,1,1394,1286,-108
28057,0,0,95,0,-95
28058,0,0,62,0,-62
28059,0,0,22,0,-22
28060,1,0,3,0,-3
28061,0,0,3,0,-3
28062,1,1,1741,1490,-251
28063,1,1,1718,1708,-10
28064,0,0,1,0,-1
28065,1,0,124,0,-124
28066,1,0,11,0,-11
28067,1,1,377,1610,1233
28068,0,0,26,0,-26
28069,1,1,246,2149,1903
28070,1,1,282,1281,999
28071,1,1,240,1225,985
28072,0,0,20,0,-20
28073,0,0,27,0,-27
28074,1,1,671,1243,572
28075,1,0,5,0,-5
28076,1,1,876,1467,591
28077,1,1,198,1480,1282
28078,0,0,14,0,-14
28079,1,0,2,0,-2
28080,1,1,104,1208,1104
28081,0,0,45,0,-45
28082,1,0,121,0,-121
28083,1,0,41,0,-41
28084,0,0,91,0,-91
28085,1,0,1,0,-1
28086,0,0,83,0,-83
28087,1,0,13,0,-13
28088,1,0,9,0,-9
28089,0,0,15,0,-15
28090,1,1,264,2251,1987
28091,1,0,40,0,-40
28092,1,1,74,1339,1265
28093,1,1,210,1397,1187
28094,0,0,21,0,-21
28095,1,1,376,1205,829
28096,0,0,31,0,-31
28097,1,0,21,0,-21
28098,1,0,4,0,-4
28099,1,1,1215,1591,376
28100,1,1,75,2068,1993
28101,0,0,65,0,-65
28102,1,1,146,1491,1345
28103,1,0,6,0,-6
28104,0,0,17,0,-17
28105,1,1,940,1384,444
28106,0,0,63,0,-63
28107,1,0,5,0,-5
28108,0,0,183,0,-183
28109,1,1,566,1438,872
28110,0,0,67,0,-67
28111,0,0,42,0,-42
28112,1,0,50,0,-50
28113,1,0,123,0,-123
28114,1,0,27,0,-27
28115,0,0,11,0,-11
28116,0,0,37,0,-37
28117,1,0,94,0,-94
28118,1,1,283,1922,1639
28119,0,0,52,0,-52
28120,1,0,52,0,-52
28121,0,0,29,0,-29
28122,1,1,1680,1229,-451
28123,1,1,286,1687,1401
28124,0,0,14,0,-14
28125,0,0,64,0,-64
28126,1,1,100,1217,1117
28127,1,0,14,0,-14
28128,1,1,804,1466,662
28129,1,1,262,1474,1212
28130,1,1,693,2604,1911
28131,0,0,7,0,-7
28132,1,0,9,0,-9
28133,0,0,18,0,-18
28134,0,0,28,0,-28
28135,1,0,152,0,-152
28136,0,0,9,0,-9
28137,1,0,7,0,-7
28138,1,1,197,1361,1164
28139,0,0,20,0,-20
28140,1,1,387,2948,2561
28141,1,1,236,2083,1847
28142,1,0,47,0,-47
28143,0,0,37,0,-37
28144,0,0,156,0,-156
28145,0,0,161,0,-161
28146,0,0,20,0,-20
28147,1,1,479,1308,829
28148,1,1,122,1529,1407
28149,0,0,126,0,-126
28150,1,0,33,0,-33
28151,0,0,20,0,-20
28152,1,1,2643,1487,-1156
28153,1,0,73,0,-73
28154,1,1,34,1817,1783
28155,0,0,80,0,-80
28156,0,0,95,0,-95
28157,1,0,18,0,-18
28158,1,0,38,0,-38
28159,1,0,15,0,-15
28160,1,0,8,0,-8
28161,1,0,59,0,-59
28162,0,0,54,0,-54
28163,0,0,55,0,-55
28164,1,0,58,0,-58
28165,0,0,0,0,0
28166,0,0,104,0,-104
28167,1,0,31,0,-31
28168,1,1,828,2383,1555
28169,1,1,64,1253,1189
28170,1,0,36,0,-36
28171,1,1,73,1257,1184
28172,1,1,307,1269,962
28173,1,1,1859,1441,-418
28174,1,1,283,1346,1063
28175,1,0,131,0,-131
28176,0,0,34,0,-34
28177,1,0,32,0,-32
28178,0,0,107,0,-107
28179,1,1,441,1233,792
28180,0,0,54,0,-54
28181,0,0,11,0,-11
28182,0,0,101,0,-101
28183,1,0,40,0,-40
28184,0,0,156,0,-156
28185,0,0,27,0,-27
28186,1,1,510,1207,697
28187,0,0,20,0,-20
28188,1,0,21,0,-21
28189,1,0,12,0,-12
28190,0,0,22,0,-22
28191,1,1,2490,1670,-820
28192,1,0,53,0,-53
28193,0,0,6,0,-6
28194,1,1,331,1492,1161
28195,0,0,109,0,-109
28196,0,0,16,0,-16
28197,1,1,654,1767,1113
28198,1,0,47,0,-47
28199,1,1,947,1300,353
28200,0,0,19,0,-19
28201,1,0,0,0,0
28202,0,0,27,0,-27
28203,1,1,1088,1371,283
28204,1,0,9,0,-9
28205,0,0,38,0,-38
28206,1,1,485,2296,1811
28207,0,0,43,0,-43
28208,0,0,98,0,-98
28209,1,0,34,0,-34
28210,0,0,124,0,-124
28211,0,0,49,0,-49
28212,0,0,75,0,-75
28213,1,0,8,0,-8
28214,1,0,115,0,-115
28215,1,0,11,0,-11
28216,1,0,9,0,-9
28217,1,1,327,1305,978
28218,0,0,98,0,-98
28219,1,0,29,0,-29
28220,0,0,216,0,-216
28221,1,0,44,0,-44
28222,1,0,17,0,-17
28223,1,0,26,0,-26
28224,1,1,139,1566,1427
28225,0,0,124,0,-124
28226,1,0,57,0,-57
28227,0,0,1,0,-1
28228,1,0,9,0,-9
28229,0,0,63,0,-63
28230,0,0,86,0,-86
28231,1,1,354,1451,1097
28232,1,1,105,1230,1125
28233,0,0,19,0,-19
28234,0,0,37,0,-37
28235,0,0,39,0,-39
28236,0,0,9,0,-9
28237,1,0,20,0,-20
28238,1,1,54,1290,1236
28239,1,0,111,0,-111
28240,1,0,27,0,-27
28241,1,1,487,1466,979
28242,1,1,608,1431,823
28243,0,0,31,0,-31
28244,1,0,16,0,-16
28245,1,1,36,1585,1549
28246,1,0,15,0,-15
28247,1,1,262,1657,1395
28248,0,0,73,0,-73
28249,0,0,46,0,-46
28250,1,0,46,0,-46
28251,1,1,24,1240,1216
28252,0,0,13,0,-13
28253,1,0,15,0,-15
28254,1,0,21,0,-21
28255,1,0,8,0,-8
28256,1,1,657,1457,800
28257,0,0,6,0,-6
28258,0,0,178,0,-178
28259,1,1,244,2234,1990
28260,0,0,176,0,-176
28261,1,1,779,2085,1306
28262,1,1,1144,1203,59
28263,1,0,80,0,-80
28264,0,0,42,0,-42
28265,1,1,675,1272,597
28266,0,0,131,0,-131
28267,1,1,225,4135,3910
28268,1,1,1347,1371,24
28269,1,1,371,2106,1735
28270,1,1,291,2332,2041
28271,1,0,12,0,-12
28272,1,0,28,0,-28
28273,1,1,113,2722,2609
28274,0,0,7,0,-7
28275,1,1,67,1378,1311
28276,1,1,1141,1204,63
28277,0,0,17,0,-17
28278,1,1,454,1555,1101
28279,0,0,120,0,-120
28280,0,0,8,0,-8
28281,1,1,625,1583,958
28282,1,1,47,1397,1350
28283,1,0,38,0,-38
28284,0,0,80,0,-80
28285,0,0,110,0,-110
28286,0,0,13,0,-13
28287,1,1,1891,1361,-530
28288,1,0,27,0,-27
28289,0,0,20,0,-20
28290,0,0,4,0,-4
28291,0,0,108,0,-108
28292,0,0,148,0,-148
28293,1,0,85,0,-85
28294,1,0,54,0,-54
28295,1,0,4,0,-4
28296,1,0,14,0,-14
28297,1,1,619,1225,606
28298,0,0,28,0,-28
28299,0,0,217,0,-217
28300,0,0,51,0,-51
28301,1,1,531,1345,814
28302,1,0,55,0,-55
28303,1,1,155,1357,1202
28304,0,0,15,0,-15
28305,1,0,22,0,-22
28306,1,0,3,0,-3
28307,0,0,2,0,-2
28308,1,0,34,0,-34
28309,1,0,24,0,-24
28310,1,0,31,0,-31
28311,1,1,163,1589,1426
28312,1,1,742,1621,879
28313,1,0,37,0,-37
28314,1,0,4,0,-4
28315,1,0,6,0,-6
28316,1,0,28,0,-28
28317,0,0,0,0,0
28318,0,0,51,0,-51
28319,0,0,17,0,-17
28320,1,1,363,1223,860
28321,0,0,1,0,-1
28322,1,1,305,2067,1762
28323,1,1,283,1316,1033
28324,1,1,198,1377,1179
28325,0,0,175,0,-175
28326,0,0,44,0,-44
28327,1,0,8,0,-8
28328,1,0,93,0,-93
28329,1,0,61,0,-61
28330,1,0,5,0,-5
28331,1,0,16,0,-16
28332,0,0,3,0,-3
28333,0,0,19,0,-19
28334,1,1,146,1784,1638
28335,1,1,713,5849,5136
28336,0,0,29,0,-29
28337,1,0,33,0,-33
28338,0,0,35,0,-35
28339,1,1,454,3069,2615
28340,0,0,53,0,-53
28341,1,0,34,0,-34
28342,0,0,171,0,-171
28343,0,0,63,0,-63
28344,1,1,202,1561,1359
28345,0,0,19,0,-19
28346,0,0,39,0,-39
28347,1,1,202,1481,1279
28348,1,1,334,1212,878
28349,1,1,685,1217,532
28350,1,1,285,1864,1579
28351,0,0,2,0,-2
28352,0,0,91,0,-91
28353,1,0,15,0,-15
28354,0,0,31,0,-31
28355,0,0,4,0,-4
28356,1,0,14,0,-14
28357,0,0,2,0,-2
28358,1,0,133,0,-133
28359,1,1,249,1514,1265
28360,0,0,12,0,-12
28361,1,0,33,0,-33
28362,1,1,26,1310,1284
28363,1,1,1097,2174,1077
28364,0,0,9,0,-9
28365,1,1,430,1376,946
28366,1,1,301,1521,1220
28367,0,0,16,0,-16
28368,1,0,102,0,-102
28369,1,1,116,1556,1440
28370,0,0,22,0,-22
28371,0,0,54,0,-54
28372,0,0,49,0,-49
28373,1,0,85,0,-85
28374,1,0,36,0,-36
28375,0,0,22,0,-22
28376,0,0,16,0,-16
28377,1,0,33,0,-33
28378,0,0,8,0,-8
28379,0,0,38,0,-38
28380,0,0,16,0,-16
28381,1,0,89,0,-89
28382,1,0,12,0,-12
28383,1,0,21,0,-21
28384,1,0,11,0,-11
28385,1,0,99,0,-99
28386,1,1,548,1509,961
28387,0,0,24,0,-24
28388,1,0,80,0,-80
28389,0,0,22,0,-22
28390,1,1,261,1244,983
28391,1,1,1545,1238,-307
28392,1,0,69,0,-69
28393,0,0,7,0,-7
28394,1,1,601,1234,633
28395,1,0,59,0,-59
28396,0,0,59,0,-59
28397,0,0,61,0,-61
28398,1,0,24,0,-24
28399,1,0,35,0,-35
28400,1,1,194,2831,2637
28401,1,1,990,2064,1074
28402,0,0,40,0,-40
28403,1,1,69,1204,1135
28404,1,1,1037,1435,398
28405,0,0,85,0,-85
28406,1,0,34,0,-34
28407,1,0,57,0,-57
28408,1,0,15,0,-15
28409,0,0,62,0,-62
28410,1,1,384,1604,1220
28411,0,0,82,0,-82
28412,0,0,115,0,-115
28413,0,0,44,0,-44
28414,1,0,105,0,-105
28415,1,0,12,0,-12
28416,1,1,188,1242,1054
28417,1,1,198,3110,2912
28418,0,0,27,0,-27
28419,1,1,1218,1253,35
28420,0,0,57,0,-57
28421,1,1,369,1394,1025
28422,0,0,91,0,-91
28423,1,0,67,0,-67
28424,1,0,20,0,-20
28425,0,0,21,0,-21
28426,1,1,1724,1567,-157
28427,1,0,0,0,0
28428,0,0,22,0,-22
28429,1,1,547,1438,891
28430,1,1,323,1255,932
28431,1,1,530,1778,1248
28432,1,0,52,0,-52
28433,1,1,791,1340,549
28434,1,0,54,0,-54
28435,0,0,28,0,-28
28436,1,1,883,1375,492
28437,0,0,123,0,-123
28438,1,0,2,0,-2
28439,0,0,179,0,-179
28440,1,1,532,1270,738
28441,0,0,44,0,-44
28442,0,0,2,0,-2
28443,0,0,88,0,-88
28444,0,0,43,0,-43
28445,1,1,248,1357,1109
28446,1,0,170,0,-170
28447,1,0,135,0,-135
28448,1,0,3,0,-3
28449,1,1,321,1414,1093
28450,1,1,261,1247,986
28451,1,1,116,1242,1126
28452,0,0,59,0,-59
28453,1,0,57,0,-57
28454,0,0,2,0,-2
28455,0,0,134,0,-134
28456,1,1,1008,1211,203
28457,1,1,431,1283,852
28458,0,0,28,0,-28
28459,0,0,75,0,-75
28460,1,1,140,1550,1410
28461,0,0,6,0,-6
28462,1,0,26,0,-26
28463,1,0,14,0,-14
28464,0,0,9,0,-9
28465,1,1,1274,1625,351
28466,0,0,75,0,-75
28467,0,0,46,0,-46
28468,1,1,204,1595,1391
28469,1,0,14,0,-14
28470,1,0,20,0,-20
28471,1,0,32,0,-32
28472,1,1,149,1316,1167
28473,0,0,31,0,-31
28474,1,0,5,0,-5
28475,1,1,654,1469,815
28476,0,0,53,0,-53
28477,0,0,19,0,-19
28478,1,0,1,0,-1
28479,0,0,45,0,-45
28480,1,0,8,0,-8
28481,0,0,8,0,-8
28482,1,0,68,0,-68
28483,1,0,19,0,-19
28484,1,0,15,0,-15
28485,1,1,62,1332,1270
28486,0,0,35,0,-35
28487,1,0,0,0,0
28488,1,0,100,0,-100
28489,1,0,37,0,-37
28490,1,0,18,0,-18
28491,0,0,5,0,-5
28492,1,0,44,0,-44
28493,0,0,3,0,-3
28494,0,0,42,0,-42
28495,1,0,18,0,-18
28496,1,1,567,1229,662
28497,1,1,1512,2414,902
28498,1,1,402,1509,1107
28499,0,0,35,0,-35
28500,1,0,191,0,-191
28501,1,0,3,0,-3
28502,1,1,862,1320,458
28503,1,0,3,0,-3
28504,0,0,74,0,-74
28505,0,0,132,0,-132
28506,0,0,62,0,-62
28507,0,0,22,0,-22
28508,0,0,40,0,-40
28509,1,1,239,1393,1154
28510,0,0,47,0,-47
28511,1,0,2,0,-2
28512,0,0,198,0,-198
28513,0,0,26,0,-26
28514,1,0,38,0,-38
28515,0,0,260,0,-260
28516,1,0,19,0,-19
28517,0,0,33,0,-33
28518,1,0,3,0,-3
28519,0,0,122,0,-122
28520,0,0,22,0,-22
28521,1,1,1026,1361,335
28522,0,0,41,0,-41
28523,0,0,8,0,-8
28524,0,0,15,0,-15
28525,1,0,62,0,-62
28526,1,0,91,0,-91
28527,1,1,785,1213,428
28528,1,0,61,0,-61
28529,0,0,12,0,-12
28530,1,0,34,0,-34
28531,1,0,44,0,-44
28532,1,1,329,1689,1360
28533,1,1,1287,1913,626
28534,1,0,12,0,-12
28535,1,1,1025,1388,363
28536,1,1,107,1384,1277
28537,1,0,50,0,-50
28538,1,1,334,1250,916
28539,0,0,35,0,-35
28540,1,1,327,2743,2416
28541,1,1,2042,1343,-699
28542,1,1,310,1310,1000
28543,1,0,7,0,-7
28544,1,1,667,1208,541
28545,1,0,17,0,-17
28546,1,1,883,1472,589
28547,0,0,28,0,-28
28548,1,1,288,1230,942
28549,0,0,68,0,-68
28550,0,0,70,0,-70
28551,0,0,6,0,-6
28552,1,0,20,0,-20
28553,1,0,51,0,-51
28554,1,0,71,0,-71
28555,1,0,136,0,-136
28556,0,0,13,0,-13
28557,0,0,199,0,-199
28558,1,1,506,3127,2621
28559,1,0,67,0,-67
28560,1,1,214,1546,1332
28561,1,1,1272,1468,196
28562,1,1,297,2242,1945
28563,1,1,1243,1243,0
28564,0,0,70,0,-70
28565,1,0,33,0,-33
28566,0,0,28,0,-28
28567,1,0,21,0,-21
28568,1,0,46,0,-46
28569,1,0,21,0,-21
28570,1,1,280,1461,1181
28571,1,1,1149,1439,290
28572,1,0,1,0,-1
28573,1,1,112,1214,1102
28574,1,1,96,1249,1153
28575,0,0,18,0,-18
28576,1,1,462,1277,815
28577,1,0,115,0,-115
28578,1,0,52,0,-52
28579,1,0,105,0,-105
28580,1,1,566,1242,676
28581,1,0,94,0,-94
28582,0,0,78,0,-78
28583,1,1,719,1447,728
28584,1,0,0,0,0
28585,0,0,38,0,-38
28586,1,0,50,0,-50
28587,0,0,7,0,-7
28588,0,0,20,0,-20
28589,0,0,331,0,-331
28590,0,0,42,0,-42
28591,1,0,23,0,-23
28592,1,0,48,0,-48
28593,1,0,3,0,-3
28594,1,0,93,0,-93
28595,1,1,186,1740,1554
28596,0,0,16,0,-16
28597,0,0,11,0,-11
28598,1,0,10,0,-10
28599,1,1,504,1456,952
28600,0,0,110,0,-110
28601,1,1,135,1234,1099
28602,1,0,134,0,-134
28603,1,1,1060,2955,1895
28604,0,0,88,0,-88
28605,0,0,121,0,-121
28606,1,0,15,0,-15
28607,0,0,12,0,-12
28608,0,0,43,0,-43
28609,1,1,164,1303,1139
28610,0,0,67,0,-67
28611,1,0,5,0,-5
28612,0,0,34,0,-34
28613,1,0,36,0,-36
28614,1,1,1542,1271,-271
28615,1,0,2,0,-2
28616,1,0,101,0,-101
28617,1,1,127,1654,1527
28618,1,1,608,1250,642
28619,0,0,26,0,-26
28620,1,0,65,0,-65
28621,1,1,382,1336,954
28622,0,0,39,0,-39
28623,0,0,107,0,-107
28624,1,0,21,0,-21
28625,0,0,80,0,-80
28626,0,0,75,0,-75
28627,0,0,138,0,-138
28628,1,1,552,1527,975
28629,1,1,190,1614,1424
28630,1,1,112,3553,3441
28631,1,1,376,1392,1016
28632,0,0,120,0,-120
28633,1,1,1536,2200,664
28634,1,1,2301,1334,-967
28635,0,0,39,0,-39
28636,0,0,21,0,-21
28637,1,0,20,0,-20
28638,0,0,14,0,-14
28639,0,0,10,0,-10
28640,0,0,0,0,0
28641,1,0,1,0,-1
28642,1,1,590,2131,1541
28643,1,0,66,0,-66
28644,1,1,214,1691,1477
28645,1,0,5,0,-5
28646,0,0,27,0,-27
28647,1,0,16,0,-16
28648,1,0,64,0,-64
28649,0,0,9,0,-9
28650,0,0,39,0,-39
28651,1,0,67,0,-67
28652,1,0,53,0,-53
28653,1,0,96,0,-96
28654,1,0,37,0,-37
28655,0,0,144,0,-144
28656,1,1,677,1462,785
28657,1,0,134,0,-134
28658,0,0,59,0,-59
28659,1,0,52,0,-52
28660,1,1,87,2912,2825
28661,1,0,72,0,-72
28662,0,0,75,0,-75
28663,0,0,33,0,-33
28664,0,0,11,0,-11
28665,1,1,544,1763,1219
28666,0,0,17,0,-17
28667,0,0,117,0,-117
28668,0,0,17,0,-17
28669,1,1,390,1531,1141
28670,1,1,512,1360,848
28671,1,1,129,1413,1284
28672,1,0,57,0,-57
